----------------------------------------------------------XXXXXX-------------------------
--------------------------------------------------------XX..K,..X------------------------
------------------------------------------------------XXX.......XXX----------------------
------------------------------------------------------X.,.......,..X---------------------
------------------------------------------------------X.,...E...,..X---------------------
------------------------------------------------------X.,.......,..X---------------------
------------------------------------------------------X.,....E..,..X---------------------
------------------------------------------------------X.X.......XX.X---------------------
------------------------------------------------------X.XX..W..XXX.X---------------------
------------------------------------------------------X,XXXX,,XXXX,X---------------------
------------------------------------------------------X,X.XX,,X.XX,X---------------------
------------------------------------------------------X,X.......XX,X---------------------
---------------------------------------XXXXXXXXXX-----X,X.......XX,X---------------------
-------------------------------------XX..........XX---X,X.......XX,X---------------------
-----------------------------------XXt...,,,,,,....X--X,X.......XX,X-------XXXXXX--------
-----------------------------------XKt.,,......,,..X--X.+.......,+.X------X......X-------
----------------------------------Xttt,..........,..X-XXX.......XXXX-----X........X------
----------------------------------X..,<,,........,..X----X.....X--------X..........X-----
---------------------------------X..,.,,,,,.......,.X----X.....X-------X............X----
---------------------------------X..,.,,.,,,,.....,..X----X...X-------X..............X---
---------------------------------X.,...,,,,,,,,....,.X----X...X------X................X--
---------------------------------X.,...,,,.,,,,,,..,..X----X:X------X..................X-
---------------------------------X.,....,,,,,,,,,,,.,.X--XXX,XXX---X........XX,XX.......X
---------------------------------X.,....,,,,.,,,,,,,,.X--XA,.,.X---XE......X....XX.E....X
---------------------------------X.,.....,,,,,,,,,,,,,.XX.A,..,.X--X......X......XX.....X
-------------XXXXXXXXXXXXX-------X.,.....,,,,,.,,,,,,,,XX..,,,,.X--X......X.A....XX.....X
------------X,............XX-----X..,.....,,,,,....,,,,X.A,,,,,A.X-X......,.....A,,.....X
----------XX...............,X----X..,.....,,,,,.......,XXXX...,..X-X......X...A..,,.....X
---------X,..................XX---X..,,....,,,.,.......XXXX,,,,,,X-X......X......,,..E..X
--------X.....................,XXXX....,,..,,,,,..T......,,...,,,XXX......,..,,,.,,.....X
-------X......................,XE.XXX....,,.,,,,...<....<,,.W.,,,,:,..E..W+A.,K,A,,...E.X
-------X......................,X....XXXX...,,,,,,........,,...,,,XXX......X..,,,.,,.....X
------X........................X.......XXX...,,,,....W.XXXX,,,,..X-X......X...A..,,.....X
-----X........................WX..........XXX.,,,,....XX..,,,,,..X-X......X......,,.....X
----X,...................XXXXXXX,,...........XXXXX...XXX.A,...,A.X-X......,.....A,,.E...X
----X....................XHXHXHX.,.............,.X.<.XXE..A,,,,..X-X......X.A....XX.....X
---X.....................X.H.HXXW,.............,,X,,,XX.X..,..,.X--X......XX....X-X.....X
--X,.....................XH.H.HX.,..E....E...........XXHX.A,.,..XXXXE......XXX,X-X......X
-X,......................X.H.HXX,,............E......XX..XXX,XXXX..X........XX,XX.......X
-X.........H.............XH.H.HX.......XXXXXXXXXXXXXXXX..XX...X-X.H.X..................X-
X,..............XXX,,,,XAX.H.HXX,,,,...XXXXXXXXXXXXXXXXAXX.....XX...,X.......E........X--
X...............X-X....XXX....XX...,...X.........E,...,.X,..W..,XX,,..XX.............X---
X...............XXX.E.,.E,E....,E.E,.,HX....XXXXXXX,,,XX,,.....,,XX....XX..........XX----
X...............,....,...,,,,,,,,XXXXXXX....X-XXXXX,,,X:,,.....,,.:.....XX........X------
X...............,...,.........XX.XXXXXXX,,+,XXX.EE,.T,X.,.,...,.,.X.E....XX......X-------
X...............,..,..........XX.XXE.E,,,,.,,XXXXXX,,,X..,.,,,.,..X.......XXX,,,X--------
X...............,.,...,,,,,,,,.,.XX...,,,,E,,X----X,,.X...,...,...X........XH,HHX--------
X...............XX....,......,.,.XXE.E,,,,.,,X----X,,,X....,,,....X..E....EXX,,,X--------
X...............XX....,......,.,.XX...,,,,.,,XXXXXX,,,X...........X........XX.W.X--------
X...............XX....,......,.,.XXE.E,,,,.,,XX.EE,T.,X,.........,X........XX,,,X--------
X...............XX....,......,.,.XX...,,,E.,,XXXXXX,,,X,.........,X........XX...X--------
X...............,,....,......,.,.XXE.E,,,,.,,X----X,,.X,.....E...,X........XX,,,X--------
X..............E,,....,......,.,,XXXXXXX....XX----X,,,X,.........,X........+L...X--------
X...............,,....,......,.,.X-----X....XXXXXXX,,,X.,.......,.X...E....XX,,,X--------
X...............,,,,..,......,.,,X-----X....,XX.EE,..TX.,.......,.XXXXXXXXXXX,,,XX-------
X..............E,,.,..,......,.,.X-----X.E.EXXXXXXX,,,X.,...E...,.XX.H.,..X......X-------
X...............,,,,..,......,.,,X-----X....X-----X,,.X.,.......,.XX,,,,H.X....:.X-------
X...............,,.,..,......,.,.XXXXXXX,,.,XX----X,,,X..,.....,..XX.H.,..X..E...X-------
X......H........XX,,..,......,.,,XXH.H,,,,.,,XXXXXX,,,X..,.....,..XX,,,,,,X......X-------
X...............XX.,..,......,.,.XX...,,,,E,,XX.EE,.T,X..,.....,.EXX.H.,H.X......X-------
X...............XX,,..,E.....,.,,XXH.H,,,,.,,XXXXXX,,EX.E,.....,..XX,,,,,,X...:..X-------
X...............XX.,..,,,,,,,,.,.XX...,,,,.,,X-XXXX...X...,...,...XX.H.,H.X....E.X-------
X...............XX,,XX........XX,XXH.H,,,,.,,XXX..,...X:..,...,...:X,,,,,,X,,....X-------
X...............XX.,XX........XX.XX...,,,,.,,XX.E.,...XX..,...,E.XX....,..,.,....X-------
-X..............XX,,,,,,,,,,,,,,,XXH.H,,,,.,,XX...,..,.XX.,.E.,.XX.....,..,.,....X-------
-X..............XX.,.,.,.,.,.,.,.XXXXXXX...EXXX...,..,E.X..,.,..X......,..,.,....X-------
--X.............XXXX,,,,,,,,,XXXXXH....XE...X-X...,.,....X.,:,.X.......,..,.,..E.X-------
---X................E..............E...X....X-XE..,.,....,XX,XX........,..,.,....X-------
----X.....................E..........E.X....X-X...,,E..,,..,H,.........,..,E,....X-------
----X..................................X....X-X...,,.,,....,H,........:,..,.,..E.X-------
-----X.........................E......,X....X-XXXXXX,...E.:,H,:........,E.,.,.:..X-------
------X.................E.............,X.E..XXXXXXXXXXXXXXXX,XXXXX.....,..,.,.E..X-------
-------X..................H......E....,X.......,..,..,..,,.+.,,.XX..:..,..,E,....X-------
-------X..............................,X.......,.H,.H,.H,,,+H,,HXX.....,..,.,....X-------
--------X,............................,XXXXXXXXXXXXXXXXXXXXX,XXXXX.....,..,.,.E..X-------
---------XX,........................,,,X------------------XX,XXX-X....:,..,.,....X-------
-----------XX,......E.............,,,..X----------------XX,....,XX.:...,..,.,....X-------
-------------XX,................,,,....X----------------X,......XXE....,..,.,....X-------
---------------XXXXXXXXXXXXXXXXX,......X---------------X,.......,XXXXXXX,,X.,..E.X-------
-------------------------------X.......X---------------X,.......,XX....,..E.,.:..X-------
-------------------------------X.E.....X---------------X,.......,XX....,....,....X-------
-------------------------------X.......X---------------X,.......,XX....,,,,,,....X-------
-------------------------------XXX,,LXXX---------------X.,......,XX.:.E........:.X-------
--------------------------------XX,,,XX-----------------X.,....,X-XE.............X-------
--------------------------------XX...XX------------------X,....X--XXXXXXXXXXXXXXXX-------
--------------------------------XX.E.XX------------------X.,,,,X-------------------------
---------------------------------X...X--------------------XXtXX--------------------------
----------------------------------X.X----------------------XTX---------------------------
----------------------------------X>-----------------------XXX---------------------------
