--------------------------------------------------------------------------------------------------------------------------------------------------------------------------------------------------------------------XXXXXXX-------
--------------------------------------------------------------------------------------------------------------------------------------------------------------------------------------------------------------------X.....X-------
--------------------------------------------------------------------------------------------------------------------------------------------------------------------------------------------------------------------X.....X-------
--------------------------------------------------------------------------------------------------------------------------------------------------------------------------------------------------------------------X.....X-------
--------------------------------------------------------------------------------------------------------------------------------------------------------------------------------------------------------------------X.....X-------
--------------------------------------------------------------------------------------------------------------------------------------------------------------------------------------------------------------------X..T..X-------
--------------------------------------------------------------------------------------------------------------------------------------------------------------------------------------------------------------------XXX...X-------
-----------------------------------------------------------------------------------------------------------------------------------------------------------------------------------------------------------------------X.:.X-X----
------------------------------------------------------------------------------------------------------------------------------------------------------------------------------------------------------------------------X...X.X---
-------------------------------------------------------------------------------------------------------------------------------------------------------------------------------------------------------------------------X.,,,.X--
-------------------------------------------------------------------------------------------------------------------------------------------------------------------------------------------------------XXXXXXXXXXXXXXXXXXXX,..E.X-
------------------------------------------------------------------------------------------------------------------------------------------------------------------------------------------------------X,.,..,.,E,.,.,......,,E,,.X
-----------------------------------------------------------------------------------------------------------------------------------------------------------------------------------------------------X..,,,,,,,,,,,.,........,.KX-
-----------------------------------------------------------------------------------------------------------------------------------------------------------------------------------------------------X.,...........,,..A.....,.X--
----------------------------------------------------------------------------------------------------------------------------------------------------------------------XXXXXXXXXXXXX-----------------X,,,............,.........X---
----------------------------------------------------------------------------------------------------------------------------------------------------------------------X,.........,X-----------------X..,......A...............X---
----------------------------------------------------------------------------------------------------------------------------------------------------------------------X.,.......,.X-----------------X.,.......................X---
----------------------------------------------------------------------------------------------------------------------------------------------------------------------X..,.....,..X-----------------X.,...E..............E....X---
--------------------------------------------------------------------------------------------------------------------------XXXXXXXXXXXXXXXXXXXXX-----------------------X...XXXXX...X-----------------X,,.......................X---
--------------------------------------------------------------------------------------------------------------------------X...................X-------XXXXX-----------X...X---X...X-----------------XE,.........E.............X---
--------------------------------------------------------------------------------------------------------------------------X.........:........:X---XXXXX,,,XXXXX-------X...X---X...X-----------------X.,............E..........X---
--------------------------------------------------------------------------------------------------------------------------X...................X---X...........X-------X...X---X...X-----------------X.,..............A........X---
--------------------------------------------------------------------------------------------------------------------------X.....:.<.<<<.......X---X...........X-------X...X---X...X-----------------X,,....E..............XXXXX---
--------------------------------------------------------------------------------------------------------------------------X...................X---X...........X-------X...X---X...X----------------X..,..A..............XX--------
-----------------------------------------------------------------------------------------------------------------------XX-X.........W.........X---X...........X-------X...X---X...X-XXXXXXX:XXXXXXX.E.B,...............X----------
-----------------------------------------------------------------------------------------------------------------------XX-X...................X---X...........,XX-----XXX,X---X,XXXX..:.+...,X,:..+....,..............X-----------
-----------------------------------------------------------------------------------------------------------------------XX-X:........T........:XXXXX...........,..XXXXXXX,,,XXX,,,XX.....+..,,X,...+.....,,,.,,,,......XXXXX-------
-----------------------------------------------------------------------------------------------------------------------XXXX,,,,,,,,,,,,,,,,,,,XXtt,...........,A.,.,.,.,..A,.,...,,.....+..,.+,...+....A..,.B.B,.,,,..,...X-------
------------------------------------------------------------------------------------------------------------------------XX,...................,t.t,...........,..,.,.,.,:..,.,...,,:....+..,.+,...+.......,.,B.,.,A,..,.HEX-------
--------------------------------------------------------------------------------------------------------------------------X,,,,,,,,,.,,,,,,,,,XXtt,...........,..,.,.,.,...,.,...,,.....+..,.+,...+.......,.B,B,.,,,..,...X-------
--------------------------------------------------------------------------------------------------------------------------X:..T...:,.,:......:XXXXX...........,..XXXXXXXX,XX+XX,XXX.....+..,,X,...+A....,,,...........XXXXX-------
--------------------------------------------------------------------------------------------------------------------------X........,.,........X---X...........,XX-----X...XX.XX...XX....+..:,X,:..+...B.,..............X----------
--------------------------------------------------------------------------------------------------------------------------X........,.,........X---X...........X-------X...XX.XX...X-XXXXXXXXXXXXXXX.E..,................XX--------
--------------------------------------------------------------------------------------------------------------------------X........,.,....:...X---X...........X-------X...XX,XX...X----------------X...,..................XXX-----
--------------------------------------------------------------------------------------------------------------------------X........,.,........X---X...........X-------X.:.XX..,...X-----------------X,,......................XX---
--------------------------------------------------------------------------------------------------------------------------X.:......,.,........X---X...........X-------X...XX..,...X-----------------X.,.......................X---
--------------------------------------------------------------------------------------------------------------------------X........,.,........X---XXXXX,,,XXXXX-------X...XX..,...X-----------------X.,.........E.........E...X---
--------------------------------------------------------------------------------------------------------------------------X........,.,........X-------XXXXX-----------X.A.XXXXX...X-----------------XE,.......................X---
--------------------------------------------------------------------------------------------------------------------------X........,.,...:....X-----------------------X...XXXXX...X-----------------X,,....................A..X---
--------------------------------------------------------------------------------------------------------------------------X........,.,........X-----------------------X..,.....,..X-----------------X.,.......................X---
--------------------------------------------------------------------------------------------------------------------------X........,.,........X-----------------------X.,.A.A.W.,.X-----------------X.,..E....................X---
--------------------------------------------------------------------------------------------------------------------------X.......:,.,:.......X-----------------------X,.........,X-----------------X.,,......................X---
--------------------------------------------------------------------------------------------------------------------------XXXXXXXXXX,XXXXXXXXXX-----------------------XXXXXXXXXXXXX-----------------X,.,............,.........X---
----------------------------------------------------------------------------------------------------------------------------------XXtXX-------------------------------------------------------------X...,,,,,,,,,,,,,..E.A...,.XX-
----------------------------------------------------------------------------------------------------------------------------------Xt.tX--------------------------------------------------------------XX.,.,.,.,.,.,E,.......,.,,.X
----------------------------------------------------------------------------------------------------------------------------------XtttX----------------------------------------------------------------XX,..,.,.,.,.,......,.E..X-
----------------------------------------------------------------------------------------------------------------------------------X,,,X------------------------------------------------------------------XXXXXXXXXXXXXXXXXX.,,E.X-
----------------------------------------------------------------------------------------------------------------------------------X...X------------------------------------------------------------------------------------XX.XX--
----------------------------------------------------------------------------------------------------------------------------------X...X--------------------------------------------------------------------------------------XX---
-----------------------------------------------------------------------------------------------------------------------XXXXXXX----X...X-------------------------------------------------------------------------------------------
------------------------------------------------------------------------------------------------------------------XXXXX.......XXXXX...X-------------------------------------------------------------------------------------------
--------------------------------------------------------------------------------------------------------------XXXX..E..HE...E..,,.....X-------------------------------------------------------------------------------------------
-------------------------------------------------------------------------------------------------------------X...E.............,,.....X-------------------------------------------------------------------------------------------
-----------------------------------------------------------------------------------------------------------XX.E.........B...B..,,E....X-------------------------------------------------------------------------------------------
----------------------------------------------------------------------------------------------------------X........B..E....E...,,.....X-------------------------------------------------------------------------------------------
---------------------------------------------------------------------------------------------------------X..H...H.H....XXXXXXX.XX.....X-------------------------------------------------------------------------------------------
---------------------------------------------------------------------------------------------------------X..........XXX-------XXX.....X-------------------------------------------------------------------------------------------
---------------------------------------------------------------------------------------------------------X........XX------------X.....X-------------------------------------------------------------------------------------------
----------------------------------------------------------------------------------------------------------X.E...XX--------------X.....X-------------------------------------------------------------------------------------------
----------------------------------------------------------------------------------------------------------X.....X---------------X...E.X-------------------------------------------------------------------------------------------
----------------------------------------------------------------------------------------------------------X.....X---------------XXX...X-------------------------------------------------------------------------------------------
---------------------------------------------------------------------------------------------XXXXXXXXX----XW.H.HX-----------------X...X-------------------------------------------------------------------------------------------
--------------------------------------------------------------------------------------------X...H...E.XX---X....X-XXXXXXXXXXXXXXXXX,,,XXXXXXXXXXXXXXXXX---------------------------------------------------------------------------
--------------------------------------------------------------------------------------------X...........XX-X.:..X-XH..............,...,.............A.X---------------------------------------------------------------------------
-------------------------------------------------------------------------------------------X..E.E.........XXXXXXX-X.............A.,...,....E..........X---------------------------------------------------------------------------
------------------------------------------------------------------------------------------X................XX-----X.........E.....,...,.......A.......X---------------------------------------------------------------------------
-----------------------------------------------------------------------------------------X..E.........E......XX---X.E...........A.,...,A............E.X---------------------------------------------------------------------------
-----------------------XXXXXXX-----------------------------------------------------------X.....................X--X...............,...,...............X---------------------------------------------------------------------------
-----------------------X.....X----------------------------------------------------------X.E...:...:.....H......X--X....,,,,,,,,,,,,,,,,,,,,,,,,,,,....X---------------------------------------------------------------------------
-----------------------X.E..E.X--------------------------------------------------------X......,,,,,............X--X....,......................A..,....X---------------------------------------------------------------------------
-----------------------X......X--------------------------------------------------------XE.:.,,.....,,:......E..X--X....,A........................,....X---------------------------------------------------------------------------
-----------------------X.......X-------------------------------------------------------X...,.....H...,.........X--X....,.........................,....X---------------------------------------------------------------------------
-----------------------XE......X-------------------------------------------------------X:.,H..E.......,:.......X--X....,.........................,.E..X---------------------------------------------------------------------------
----------------------X......E.X-------------------------------------------------------X.,.....,,,.....,.......X--X....,.........................,....X---------------------------------------------------------------------------
----------------------X.E......X-------------------------------------------------------X,,....,...,.E..,.......X--X....,...................E.....,....X---------------------------------------------------------------------------
----------------------X........X-----------------------------------------------------XX,.,...,.....,...,.......X--X..E.,.........................,..A.X---------------------------------------------------------------------------
----------------------X........X-------------------------------------------------XXXX,E,.,.,,......,...,..E.....X-X....,..........,,,,...........,....X---------------------------------------------------------------------------
--------------XXXXXXXXX,,,,,,,,X-------------------------XXXXXXXXXXXXXXXXXXXXXXXX,.,.,.,.,,........,...,........XXX....,.........H,...,W.........,....X---------------------------------------------------------------------------
--------XXXXXX.................X-------------------------X...........,.,.,.,.,.,.,.H.,.,.,..E......,H.E,........,L,....,.........,.,,..,.........,....X---------------------------------------------------------------------------
------XX.......................X-------------------------X...........,.,.,.,.,.,.,.,.,.,.,.......E.,...,........,L,...H,..E......,.,.,.,.........H....X---------------------------------------------------------------------------
----XX......XX......XX.........X-------------------------X........E..,.,.,.,.,.,.,.,.,.,.,..E......,...,E.....H.,L,....,.........,.,W,.,.........,..E.X---------------------------------------------------------------------------
--XX.......X-X.....X--X........X-XXXXXXXXXXXXX-----------X.......XXXXXXXXXXXXXXXXXX,.,.,.,,........,...,........XXX....,.........,.,,..,.........,....X---------------------------------------------------------------------------
XX.........X-X.....X--X........X-X..XX..,....X-----------X....E..X-----------------XX,E,.,.,,....H.,...,..E.....X-X....,.........,....,..........,....X---------------------------------------------------------------------------
X...XX......XX......XX.........X-X..XXEXX....X-----------X.......X-------------------XX,.,...,.....,...,........X-X....,.........H,,,,.H.........,....X---------------------------------------------------------------------------
X..X-X.........................X-X..XX.XX....XXX-------XXX..E....X---------------------X,,....,...,.E..,.......X--X....,.........................,....X---------------------------------------------------------------------------
X..X-X.........................X-X..XX.XX....X.X-------X.X.......X---------------------X:,.....,,,.....:.......X--X.E..,.........................,.A..X---------------------------------------------------------------------------
X...XX.........................X-X..XX.XX....X.XX------X.,.......X---------------------X..,...E.......,........X--X....,.........................,....X---------------------------------------------------------------------------
X........,,,,,,,,,,,...........X-X..XX,XXH.XXX...XXXXXX..,.......X---------------------X..:,......H..:.........X--X....,....................E....,....X---------------------------------------------------------------------------
X........,,,,,,,,,,,...........X-X,,XX.XX,,X-X...........,.......X---------------------XE...,,.....,,.......E..X--X....,.........E...............,....X---------------------------------------------------------------------------
X........,,,,,,,,,,,...........XXX:.......:XXX...........X...E...X---------------------X......:,,,:............X--X....,A...............:......A,,....X---------------------------------------------------------------------------
X........,,,,,,,,,,,.....XX....,.,.........,.,...........X.......X----------------------X.E....................X--X....,,..........A...........,,,..:.X---------------------------------------------------------------------------
X........,,,,>>>,,,,.....X-X...,.,.........,.,.....,,,,,,,.......X----------------------X.......E............XX---X......,,..................,,.......X---------------------------------------------------------------------------
X........,,,,>.>,,,,.....X-X...,.,.........,.,.....,,,,,,,.......X-----------------------X..E.........E.....X-----X........,,..............,,.........X---------------------------------------------------------------------------
X........,,,,>>>,,,,.....XX....,.,.........,.,.....,,,,,,X.E..E..XXXAX--------------------X................X------X..........,,.,,.....,.,,...........X---------------------------------------------------------------------------
X........,,,,,,,,,,,...........,.,.........,.,...........X.......+...X---------------------X..E.H.H......XX-------XA..E........,,,,,,,,,,...E...W...E.X---------------------------------------------------------------------------
X........,,,,,,,,,,,...........XXX:.......:XXX...........X.......+.W.X---------------------X............X---------X........E...A.,.....,.A..........H.X---XXXX--------------------------------------------------------------------
X........,,,,,,,,,,,...........X-X,,XX.XX,,X-X...........,...E...+..AX----------------------X.........XX----------XX.............,.....,.............XXXXX.t.X--------------------------------------------------------------------
X...XX.........................X-X.AXX,XX..X-X...XXXXXX..,.......XXXXX-----------------------XXXXXXXXX--------------XXXX.........,.....,.........XXXXXX....ttXX-----XXXXXXX-------------------------------------------------------
X..X-X.........................X-X..XX.XX..X-X.XX------X.X.......X------------------------------------------------------XXXX.....,.....,.....XXXX---X..........XXXXX.....:.XX-----------------------------------------------------
X..X-X.........................X-X.AXX.XX..X-X.X-------X.X.......X----------------------------------------------------------XXXX.,.....,.XXXX------X....E..A.................XXXXXX-----------------------------------------------
X...XX......XX......XX.........X-X.....XX..X-XXX-------XXX.......X--------------------------------------------------------------XX,,,,,XX---------X...:...............E..........:.XX---------------------------------------------
X..........X-X.....X--X........X-X....EXX..X-------------XXXXXXXXX---------------------------------------------------------------X.....X-----------:X......:......XXX................X--------------------------------------------
XX.........X-X.....X--X........X-X.....XX..X-------------------------------------------------------------------------------------X.....X-------------XX.....XXXXXX---X...............X--------------------------------------------
--XX........XX......XX.........X-XXXXXXXXXXX-------------------------------------------------------------------------------------:..A.:X---------------XXXXX---------X.....A...E..E..X--------------------------------------------
----XX.........................X------------------------------------------------------------------------------------------------X.......X------------------XXXXX------X...............X-------------------------------------------
------XX.......................X------------------------------------------------------------------------------------------------X.......X---------------XXX.:...XXXX--X...........E...X-------------------------------------------
--------XXXXXX.................X------------------------------------------------------------------------------------------------X,,,,,,,X-------------XX..........:.XX-X..E...........X-------------------------------------------
--------------XXXXXXXXX,,,,,,,,X------------------------------------------------------------------------------------------------X.......:X------------:...............X.......:.XX....X-------------------------------------------
----------------------X..E.....X-------------------------------------------------------------------------------------------------X........XX---------X..........A......,,....XXX--XX.:X-------------------------------------------
----------------------X.E......X-------------------------------------------------------------------------------------------------:...A..,,..XX-------X....E..............,.XX-------XXX-------------------------------------------
----------------------X..E.....X-------------------------------------------------------------------------------------------------X....,,....:.XXX---X.....................X-------------------------------------------------------
----------------------X.E..EE..X--------------------------------------------------------------------------------------------------X.,,.........,.XX-X..........E....E....:X-------------------------------------------------------
----------------------X........X--------------------------------------------------------------------------------------------------X,......A....,:..X:......A..............X-------------------------------------------------------
-----------------------X.......X---------------------------------------------------------------------------------------------------XX:.........,...,......................X-------------------------------------------------------
-----------------------X.......X-----------------------------------------------------------------------------------------------------XX.......,....,....................A..X------------------------------------------------------
-----------------------X......X--------------------------------------------------------------------------------------------------------XXX:...,..A.,.A.....................X------------------------------------------------------
-----------------------X......X------------------------------------------------------------------------------------------------------------XXXXX:.,............:.X....E....X------------------------------------------------------
-----------------------XXXXXXX------------------------------------------------------------------------------------------------------------------XX,.....E......XX-X:.......X------------------------------------------------------
--------------------------------------------------------------------------------------------------------------------------------------------------X............X---X......:X------------------------------------------------------
--------------------------------------------------------------------------------------------------------------------------------------------------X............X----X......X------------------------------------------------------
--------------------------------------------------------------------------------------------------------------------------------------------------X:....A.......X----X.....X------------------------------------------------------
--------------------------------------------------------------------------------------------------------------------------------------------------X...A.........X-----X:...X------------------------------------------------------
--------------------------------------------------------------------------------------------------------------------------------------------------X.............X------XXXXX------------------------------------------------------
---------------------------------------------------------------------------------------------------------------------------------------------------X............X-----------------------------------------------------------------
---------------------------------------------------------------------------------------------------------------------------------------------------X.....E..W.:.X-----------------------------------------------------------------
---------------------------------------------------------------------------------------------------------------------------------------------------X.............X----------------------------------------------------------------
---------------------------------------------------------------------------------------------------------------------------------------------------XX............X----------------------------------------------------------------
-----------------------------------------------------------------------------------------------------------------------------------------------------XX.:.......:X----------------------------------------------------------------
-------------------------------------------------------------------------------------------------------------------------------------------------------XXXXXXXXX------------------------------------------------------------------
----------------------------------------------------------------------------------------------------------------------------------------------------------------------------------------------------------------------------------
