--------------------------------------------------------------------------XXX-XXXXXXX------------------------------------------------------------------
--------------------------------------------------------------------------X:X-X:,H,:X------------------------------------------------------------------
------------------------------------------------------------------------XXX.XXX.,,,.XXX----------------------------------------------------------------
------------------------------------------------------------------------X:...........:X----------------------------------------------------------------
------------------------------------------------------------------------XXX.E....A..XXX----------------------------------------------------------------
--------------------------------------------------------------------------X.........X------------------------------------------------------------------
------------------------------------------------------------------------XXX...ttt...XXX----------------------------------------------------------------
------------------------------------------------------------------------X:....tTt....:X----------------------------------------------------------------
------------------------------------------------------------------------XXX...ttt...XXX----------------------------------------------------------------
--------------------------------------------------------------------------X.E.......X------------------------------------------------------------------
------------------------------------------------------------------------XXX.......,,X---XXXXX----------------------------------------------------------
------------------------------------------------------------------------X:........,..X-X.,.:X----------------------------------------------------------
------------------------------------------------------------------------XXX.XXX.XXX...X...,.X----------------------------------------------------------
--------------------------------------------------------------------------X:X-X:X--X.,.....,X----------------------------------------------------------
--------------------------------------------------------------------------XXX-XXX---X.,,,...XXX--------------------------------------------------------
-----------------------------------------------------------------------------------X..,W,..,...X-------------------------------------------------------
------------------------------------------------------------------------XXXXXXXXX-X...,,,.,...,,X--------XXXXX-----XXXXX-----XXXXX-----XXXXX-----------
------------------------------------------------------------------------XW..,.tTX-X,.....,...,...X------X.....X---X.....X---X.....X---X.....X----------
------------------------------------------------------------------------X....,ttX-X.,...,.:.,...,,X----X...E...X-X...E...X-X...E...X-X...E...X---------
------------------------------------------------------------------------X.....,.X-X:.,.,...,...,...X---X.......X-X.......X-X.......X-X..A....X---------
------------------------------------------------------------------------X......,X-XXXXX...,...,...,,X--X.A...E.X-X.E...H.X-X.E...A.X-X.....E.X---------
------------------------------------------------------------------------XH..:...X-----X..,...,...,...X-X..,,,..X-X..,,,..X-X..,,,..X-X..,,,..X---------
------------------------------------------------------------------------X.......X-----X.,...,...,...,,XX.,,,,,.X-X.,,,,,.X-X.,,,,,.X-X.,,,,,.X---------
-----------------------------------------------------------------------X.........X-----X,..,...,...,..X-X,.:.,X---X,.:.,X---X,.:.,X---X,.:.,X----------
----------------------------------------------------------------------X..A......A.X-----X.,...,...,.,,XXX.,,,.XXXXX.,,,.XXXXX.,,,.XXXXX.,,,.XXXXX------
----------------------------------------------------------------------XA.........AX------X,..,...,.,.............................................X-----
----------------------------------------------------------------------X,,,,,,,,,,,X-------X.,...,.,...............................................X----
---------------------------------------------------------------------X.............X-------X,..,.,.................................................X---
------------------------------------XX------------------------------X,,,,,,,,,,,,,,,X-------X.,.,...,,,,,,,,,,,,,,,,,,,,,,,,,,,,,,,,,,,,,,,,,,,,,...X--
-----------------------------------X..XXXX-------------------------X.................X-------X,.,...,...........................................,...X--
----------------------------------X.......XXXX--------------------X,,,,,,,,,,,,,,,,,,,X-------XXX...,.E,,,,,,,,,,,,,,,,,,,,,,,,,,,,,,,,,,,,,,,,.,.E.X--
---------------------------------X............XXX----------------X.....................X-XXXXXXXX...,.,......................................A,.,...X--
--------------------------------Xtttttt..........XXXX-----------X,,,,,,,,,,,,,,,,,,,,,,,XXH.A.HXX...,.,...XXX.......XXX.......XXX.......XXX...,.,...X--
-------------------------------X.......ttttttttttttt.XXXX-------XA.....................AXXA....XX...,.,..X...X.....X---X.....X---X.....X---X..,.,..X---
------------------------------XttttttttttttttttttttttttttXX-----X,,,,,,,,,,,,,,,,,,,,,,,XX..E.AXX...,.,.X.....X...X-----X...X-----X...X-----X.,.,.X----
------------------------------X.........t.......t.......t.X----X.........................,,....XX...,.,HX.....X.A.X-----X.A.X-----X.A.X-----XA,.,.X----
------------------------------X.E.E.E.E.t.E.E.E.t.E...E.t.X---X...........................,,.AHXX...,.,.X.....X...X-XXX-X...X-XXX-X...X-XXX-X.,.,.X----
------------------------------X.........t.......t.......t.X--X.............................,XXXXX...,.,..X.:.X.....X.:.X.....X.:.X.....X.:.X..,.,.X----
------------------------------X.E.E.E.E.t.E.E.E.t...E...t.XXX...............................X---X...,.,...XXX.......,,,.......,,,.......,,,...,.,..XX--
------------------------------X.........t.......t.......t.,,,,B............................BX---X...,.,......................................A,.,..,X--
------------------------------X.E.E.E.E.t.E.E.E.t.E...E.t.,,,,...................E..........X--XX...,.,,,,,,,,,,,,,,,,,,,,,,,,,,,,,,,,,,,,,,,,,.,..,X--
------------------------------X.........t.......t.......t.,,,,..............................X--:X...,...........................................,..,X--
------------------------------X.E.E.E.E.t.E.E.E.t...E...t.,,,,........E...,,,,,.............X---X...,,,,,,,,,,,,,,,,,,,,,,,,,,,,,,,,,,,,,,,,,,,,:..,X--
------------------------------X.........t.......t.......t.,,,,............,.A.,............BX----X.................................................,X--
------------------------------X.E.E.E.E.t.E.E.E.t.E...E.t.,,,,B...,,,....,.....,....,,,.....X-----X................................................,X--
------------------------------X.........t.......t.......t.XXX....,...,...,.....,...,...,....X------X......................................:....:.:.,X--
------------------------------XttttttttttttttttttttttttttXXXX...,.,,,.,.,.......,.,.,,,.,...XXX---XXX.,,,,,,,,,,,,,,,,,,,,,,,,,,,,,,,,,,,,,,,,,....,X--
-------------------------------X.......ttttttttttttt.XXXX-X,,...,.,T,.,.,A..W..A,.,.,T,.,...,,X-XX.X,.,.....................................:.,...<,X--
-------------------XXXXX--------Xtttttt..........XXXX-----X.,,..,.,,,.,.,.......,.,.,,,.,..,,.X-XtAL,.,.,,,,,,,,,,,,,,,,,,,,,,,,,,,,,,,,,:,,,.,....,XXX
-------------------XH.HX---------X............XXX--------X.:,,...,...,..,.......,..,...,...,,:.XX.t,,.,.,.E.:...............................,.,W:.<,,<X
-------------------X.A.X----------X.......XXXX----------XX...XX...,,,....,.....,....,,,...XX...XXtt,,.,.,,,,,,,,,,,,,,,,,,,,,,,,,,,,,,,,,,,,,.,....,XXX
-------------------XEAEX-----------X..XXXX--------------X,...XX..........,..A..,..........XX...XXXAX,.,.......................................:...<,X--
-------------------XHAHX------------XX------------------X,.:.XX...........,,,,,...........XX.:.X--XXX.,,,,,,,,,,,,,,,,,,,,,,,,,,,,,,,,,,,,,:,,,.:..,X--
-------------------XE.EX--------------------------------X,...XX...........................XX...X---X...............................................,X--
-------------------X,,,X--------------------------------XX...XX...........................XX...X--X..........................................:....:,X--
---XXXXXX--------XXX,,,XXXX-------XXXXXX-----------------X.:.,,...........................,,.:.X-X.................................................,X--
--X.,,,.X---XXXXX...,t,....XXXX---X.,,,.X----------------X..,,.............................,,..XX...,,,,,,,,,,,,,,,,,,,,,,,,,,,,,,,,,,,,,,,,,,,,,..,X--
-X..,E,:.XXX,,..E...,.,..E...,,XXX.:,E,..X----------------X.,,.....E.......................,,.XXX...,...........................................,..,X--
-X,,,,,,,XX,,,,,,,,,,,,,,,,,,,,XXX,,,,,,,X----------------XXX...........,,,,,,,,,,.....E....XXX:X...,.,,,,,,,,,,,,,,,,,,,,,,,,,,,,,,,,,,,,,,,,,.,..,X--
-XE,,,,,,,.........,,,,,.........,,,,,,E,X------------------X.........,,,,,,,,,,,.,,........XXXXX...,.,......................................A,.,..,X--
-X,,,...,,.......................,...,,,,X------------------X.......XX.,,,,,,,,,,,.XX.......XXEXX...,.,...XXX.......,,,.......,,,.......,,,...,.,..XX--
-X.:,.E.,,.......,,,,,,+,,.......,.E.,,:.X-------------XX---X.H.....XX.,,,,,,,,,,,.XX.......XX.XX...,.,..,XXXX.....X.:.X.....X.:.X.....X.:.X..,.,..X---
-XX.,...,,.....,,......+..,,,,...,...,,.XX------------X..XX-X.......XX..,+++++++,..XX.......XXEXX...,.,.,,.HX-X...X-XXX-X...X-XXX-X...X-XXX-X.,.,.X----
---XX,,,,,...,,.......A.+.....,..,,,,,XX-------------X.H.,,XXX........,,,E.....E,.,,.......XXX.XX...,.,H,,EAX-X.A.X-----X.A.X-----X.A.X-----XA,.,.X----
----X.......,......,,,,,+,....,,......X-------------X...,...X-X.........,,,,,,,,,,........XX..EXX...,.,.,,..X-X...X-----X...X-----X...X-----X.,.,.X----
---X.......,...A.,,.......,,,,..,.....X------------X...,..E.X--X.B.B.......,A,.......B.B.XX.H..XX...,.,..,.AXX.....X---X.....X---X.....X---X..,.,..X---
-XXX..E...,....,,............,A..,....X-----------X...,.E.,,X---XXXXXX.....,.,......XXXXXX.....XX...,.,...XXX.......XXX.......XXX.......XXX...,.,...X--
-E.,.....,....,...............,...,...X----------X...,...,...X--------XX...,A,....XX-----X,..E.XX...,.,......................................A,.,...X--
-X.,.....,.T.,.................,..,...X----------X..,.E.,.....XXXXX-----X,X,,,X,XX--XXXXXX,,...XX...,.E,,,,,,,,,,,,,,,,,,,,,,,,,,,,,,,,,,,,,,,,.,.E.X--
XE,.....,...,...................,..,..X---------X...,...,..........X----X.X...X.X--X.AAAAA.,,.HXX...,...........................................,...X--
X.,.....,...,...................,A.,..X--------X...,.E.,............X---X,XX,XX,X-X.H..:....,,.XX...,,,,,,,,,,,,,,,,,,,,,,,,,,,,,,,,,,,,,,,,,,,,,...X--
XE,....,.A.,.....................,..,.X--------X...,...,............X---XEXXKXXEX-X.........XXXX.,.................................................X---
X.,....,...,.....................,..,,XXXXXXXXX...,...,.....,,,,,,,.X---X.XXXXX.X-X....T....XXX...,...............................................X----
X.,....,..,...........,,,.........,...+.....XX+...,.E.,.....,.....,.X---X.X---X.X-X,,.....,.,LL....,.............................................X-----
X.,,,,.,..,,,,,,,,,,,,,,A,........,...+.....,,+...,...,.....,.,,,.,.XXX-X.XXXXX.X-X,,,,,,,,.,LL,....XXXXX.,,,.XXXXX.,,,.XXXXX.,,,.XXXXX.,,,.XXXXX------
XE,,.,.,E.,T.........,>>,,........,...+.....,,+...,...,..A..,.,T,.,.,HX-X.,AHA,.X-X..,,,,,..,LL....X----X,.:.,X---X,.:.,X---X,.:.,X---X,.:.,X----------
X.,,,,.,..,,,,,,,,,,,,,,A,........,...+.....,,+...,...,.....,.,,,.,.XXX-XXXXXXXXX-X.........XXXXXXX----X.,,,,,.X-X.,,,,,.X-X.,,,,,.X-X.,,,,,.X---------
X.,....,..,...........,,,.........,...+.....XX+...,.E.,.....,.....,.X-------------X.........X----------X..,,,..X-X..,,,..X-X..,,,..X-X..,,,..X---------
XE,....,...,.....................,..,,XXXXXXXXX...,...,.....,,,,,,,.X-----------XXX,,,,,,,,,XXXXXXX----X.E...H.X-X.....E.X-XH....E.X-X.H...E.X---------
X.,....,.A.,.....................,..,.X--------X..,...,.............X----------X..........,........X---X.......X-X.H.....X-X.......X-X.......X---------
XE,.....,..,.....................,.,..X--------X...,...,............X-------XXX...........,,,,,,,,,.X--X...E...X-X...E...X-X...E...X-X...E...X---------
X.,.....,...,...................,..,..X---------X..,.E.,...........X--------XA,....................,.X--X.....X---X.....X---X.....X---X.....X----------
X..,.....,...,.................,..,...X----------X..,...,.....X,,XX-----XXXXX.,.....................,.X--XXXXX-----XXXXX-----XXXXX-----XXXXX-----------
-E.,.....,....,...............,...,...X----------X...,E..,...XX..X-----X.E.E,A,.....................,.X------------------------------------------------
-XXX..E...,....,,............,...,....X-----------X...,.E.,,X-X..X----X...XXX.,.......E..............,.X-----------------------------------------------
---X.......,.....,,.......,,,,..,.....X------------X...,....X-XE.X----XE.X--X:,......................,.X-----------------------------------------------
----X.......,......,,,,,+,....,,......X-------------X...,.E.X-X..X----X.X---XXX.......................,.X----------------------------------------------
---XX,,,,,...,,...A.....+.....,..,,,,,XX-------------X.H.,,XX-X..X----XEX------X......................,.X----------------------------------------------
-XX.,,,,,,.....,,....A.+..,,,,...,,,,,,.XX------------X..XX---XE.X----X.X-------X.......ttt...........,.X----------------------------------------------
-X.:,...,,.......,,,,,,+,,.......,...,,:.X-------------XX-----X..X----X.X-------X.......t.t...E.......,.X----------------------------------------------
-X,,,.E.,,.......................,.E.,,,,X--------------------XXXX----XEX-------X.......ttt...........,.XXX--------------------------------------------
-XE,,...,,.........,,,,,.........,...,,E,X----------------------------X.X-------X.....................,.,EX--------------------------------------------
-X,,,,,,,X,,,,,,,,,,,,,,,,,,,,,,,X,,,,,,,X----------------------------X.X-------X.H...................,.,.X--------------------------------------------
-X..,,,:.XXX,....E..,.,.......,XXX.:,,,..X----------------------------XEX---X---X.....................,.,EX--------------------------------------------
--X.,E,.X---XXXXX...,t,..E.XXXX---X.,E,.X-----------------------------X.X--X.XX-XXXXX,,,,.............,.,.X--------------------------------------------
---XXXXXX--------XXX,,,XXXX-------XXXXXX------------------------------XEXXX.E..X----X...,.............,.,EX--------------------------------------------
-------------------X,,,X----------------------------------------------X.X.E..,,X----X.E.,.....,,,,,...,.XXX--------------------------------------------
-------------------XEHEX----------------------------------------------X,....,,,XX---X...,.....,A...,.,.X-----------------------------------------------
-------------------XHAHX----------------------------------------------XE..,,,....X--XXXXX.....,.....,.X------------------------------------------------
-------------------XEAEX--------------------------------------------XX...XX.......XXXXXXX.....,..A...X-------------------------------------------------
-------------------X.A.X--------------------------------------------X....XX.......+,..:XXXXXXXX.....X--------------------------------------------------
-------------------XH.HX--------------------------------------------X.E..XX.......+,...XXXXX--X....AX--------------------------------------------------
-------------------XXXXX--------------------------------------------X....XX..E....+,E......XXXX+++++X--------------------------------------------------
--------------------------------------------------------------------X....XX:.......+,.......LL+.....X--------------------------------------------------
--------------------------------------------------------------------X.E..X-X.......+,..E....LL+.E..EX--------------------------------------------------
--------------------------------------------------------------------X....XXX+......+,.......LL+.....X--------------------------------------------------
--------------------------------------------------------------------X.E..XKX+...E..+,......XXXX..E..X--------------------------------------------------
--------------------------------------------------------------------X....X-X.......+,E..E..X---X...X---------------------------------------------------
--------------------------------------------------------------------X....XX:.......+,......X----X+X----------------------------------------------------
--------------------------------------------------------------------X....XX.......+,......X-----X+X----------------------------------------------------
--------------------------------------------------------------------X.E..XX..E....+,..XXXX----XXX.XXXX-------------------------------------------------
--------------------------------------------------------------------X....XX.......+,:X------XX........XX-----------------------------------------------
--------------------------------------------------------------------X....XX.......XXX-----XX...,,,,,....X----------------------------------------------
---------------------------------------------------------------------XXE..,,,....X-------X..,,,.A.A.,,,..X---------------------------------------------
-----------------------------------------------------------------------X....,,,XX-------X.,,........A..,,.X--------------------------------------------
------------------------------------------------------------------------XE...,,X-------X.,...............,.X-------------------------------------------
-------------------------------------------------------------------------XXE...X------X.,.................,.X------------------------------------------
---------------------------------------------------------------------------X.XX-------X.,.................,.X------------------------------------------
----------------------------------------------------------------------------X--------X.,...E....,,,....E...,.X-----------------------------------------
-------------------------------------------------------------------------------------X.,.......,.K.,.......,.X-----------------------------------------
-----------------------------------------------------------------------------------XXE,.......,,,,,,,.......,,XX---------------------------------------
-----------------------------------------------------------------------------------X,.,.....................,E,X---------------------------------------
-----------------------------------------------------------------------------------X,.:,.........:.........:..,X---------------------------------------
-----------------------------------------------------------------------------------X,H,,...................,,H,X---------------------------------------
-----------------------------------------------------------------------------------XX,,........XX,X.........,,XX---------------------------------------
------------------------------------------------------------------------------------X.,.........,.,.........,.X----------------------------------------
-------------------------------------------------------------------------------------X.,........,.,........,.X-----------------------------------------
-------------------------------------------------------------------------------------X.,........,.,........,.X-----------------------------------------
--------------------------------------------------------------------------------------X,,,......,E,.......,,X------------------------------------------
---------------------------------------------------------------------------------------X..,,....,.,.....,,.X-------------------------------------------
----------------------------------------------------------------------------------------X.E.,...,.,...,,E.X--------------------------------------------
-----------------------------------------------------------------------------------------X.,.,..,E,..,.,.X---------------------------------------------
------------------------------------------------------------------------------------------XXE.+,,.,,+.E.X----------------------------------------------
--------------------------------------------------------------------------------------------XX+..E..+.XX-----------------------------------------------
----------------------------------------------------------------------------------------------XXX.XXXX-------------------------------------------------
------------------------------------------------------------------------------------------------X:-----------------------------------------------------
