------------------------------------------------------------------------------------XXXXXXXXX------------------
------------------------------------------------------------------------------------XH.::..:X------------------
------------------------------------------------------------------------------------X.....H.X------------------
------------------------------------------------------------------------------------X:.::.:.X------------------
----------------------XXXXXXXXXXXXXXX-----------------------------------------------X.....W.X------------------
----------------------X...,.........X-----------------------------------------------X:.:.:.:X------------------
----------------------X...,.........X-----------------------------------------------X.......X------------------
----------------------X...,.........X----------------------------------XXXXXXXXXXXXXX,,,,,,,XXXXXXXXXXXXX------
--------------XXXXXXXXX...XXXXXXX,,,X----------------------------------X,,,,,,,,,,,,,,,,,,,,,,,,,,,,,,,,X------
--------------X...,...,...X-----X...X----------------------------------X,.......,.......................X------
--------------X...,.A.,...X-----X.H.X---------------------XXXXX---XXXXXX,.......,.......................X------
--------------X...,...,...X-----X...X---------------------X...X---X...:,,.......,.......................X------
--XXXXXXXXXXXXX...XXXXXXXXX---XXX,,,XXX-------------------XH..X---X....,,...XXXXX,,,XX,,,,,,,,,,,,,,,...XXXXXXX
--X...,...,.A.,...X---------XX.........XX-----------------X...X---X...:,,...X---X:.:XX,.............,...,..:.:X
--X...,.H.,.E.,...X--------X.:........:..X----------------X:.:X---X:.:XX,...X-X:X,,,XX,.............,...,...A.X
--X...,...,...,...X------XX....:..........XX-----------XXXX,,,XXXXX,,,XX,...X-X....:XX,.....E.......,...,.H::.X
--X...XXXXX,,,XXXXX-----X.:.................X----------X,,,,,,,,,,,,,,,,,...XXX.....XX,...,,,,,,,...,...,..:..X
--X...X---X...X--------X....................X----------X,.......,...........,:,.....XX,...,..:.,,...,...,...:.X
--X.E.X---X...X-------X...........:....:....XXXXX------X,.......,........T..,.,.....XX,...,.XXX,,...,...XXXXXXX
--X...X---X...X------X......................,...X------X,.......,...........,:,.....,:,..E,:X-:,,E..,...X------
--X+++X---X...X-----X.:.:...................,.A.X-XXXXXX,...XXXXXXX,,,XXXXXXXXX.....,:,...,.XXX,,...,...X------
--X+++X---X...X----X........................,...X-X....:,...X-----X:.:X-------X..:..,,,...,,,:,,,...,...X------
--X>>>X---X,,,XXXXX...........:.......:.....XXXXX-X.A..,,...XXXXX-X,,,XXXXXXXXX,XXXXXX,...,,,E,,,...,...X------
--X...X---X...,...,.........................X-----X...:,,...,:..X-X.......,.....X----X,.............,...X------
--XXXXX---X...,.A.,..............:..........X-----XXXXXX,...,...X-X.......,H..XXXXXXXX,.T...........,...X------
----------X...,...,........:...............:X----------X,...,:..X-X.......,..X--X.:.XX,.............,...X------
----------X...XXXXX.........................XXXXXXXXXXXX,...XXX.XXX.....A.XXX---X...XXXXXXXXX,,,XXXX,...XXXXXXX
----------X...X---X:.............................+,....,,...X-X.,.,......:X-----X...X-------:..:X--X,...,..:.:X
----------X...X---X.....:........................+,....,,...X-XXX.XXXXXXXXX-X::X:,,:X:X:X-XXX,,,XKXX,...,....:X
----------X...X---X..............................+,....,,...X---X.X---------X...........X-:.....H.XX,...,..:..X
----------X...XXXXX.........................XXXXXXXXXXXX,...X-XXX,X:X-XXXXXXX...........XXX...H...XX,,,,,.:..:X
----------X...,...,..........:........:.....X----------X,...X-XH..A.X-X.,<t.,...........,.t.......:,,...,.....X
----------X...,.H.,.............:..........:X----------X,,,,X-X.....X-Xt,ttt,...........XXX.....H.,,,...XXXXXXX
----------X...,...,.........................X----------X,...X-X.....X-X<t.<.t...........X-X.......,:,...X------
----------X,,,XXXXX...................:.....XXXXX-XXXXXX,...X-X.....X-Xt,tttt...........X-X.......XX,...X------
----------X...X----X..............:.........,...X-X...:,,...X-X....:X-X.,<t.,...........X-X:.....:XX,...X------
----------X...X-----X.:.....................,.H.X-XH...,,...X-X::,XXX-XXXXXXX...........X-XXX,:,XXXX,...X------
----------X...X------X...:..:...........:...,...X-X...:,,...XXX,,,XXXXXXXXX-X...........XXXXX:,,XXXX,...X------
----------X...X-------X.....................XXXXX-X.W..,,...,,,,,,,,,,,,,,X-XXX+++++++XXXX,,,,,,,,,,,...XXXXXXX
----------X...X--------X............:.......X-----X...:,,.............,.T.X---X+++++++X--X,T............,:.A..X
----------X,,,XXXXXXX---X.:.................X-----XXXXXX,.............,...XXXXXX,,,,XXXXXX,.............,:..A.X
----------X.....,...X----X................XX-----------X,.............,...,:.TXX,...X-XH,:,.............,.....X
----------X.A...,...X-----XX...:......:..X-------------X,...XXX,,,XXXX,...XXX.XX,...X-XAXX,,,,XXXXX,,,XXXXX.A.X
----------X.....,...X-------X..........XX--------------X,...X-X::.X--X,...X-XH:,,...X-X.XX,...X---X::.X---X.E.X
----------XXXXXXX...XXXXXXXXXXXXX,,,XXX----------------X,...X-X,,,X:XX,...X-X.XX,...XXX,XX,...X---X...XXXXX.A.X
----------------X...,.E.,...X---X...X------------------X,...X-X...A.XX,...X-XAXX,...,:..:,,...X---X.........H.X
----------------X...,.H.,...X---X.A.X-------------XXXXXX,...X-X.....XX,...X:X.XX,...XXX,XX,...XX:XX..W.E.H.E..X
----------------X...,...,...X---X...X-------------XH..:,,...X-X.....:,,...,...:,,...X-X:XX,...,...,...........X
----------------XXXXXXXXX...XXXXX,,,X-------------X:...,,...X-X.....,,,...XXX:XX,...X-X.XX,...,...XXXXXXXXXXXXX
------------------------X...,.......X-------------X...:,,...X-X.....:,,...XXX,XX,...XXX,XX,...,..:X------------
------------------------X...,.......X---XXX-------X....,,,,,XXX.....XX,...,,,,,,,,,,,,,,,,,...,..:X------------
------------------------X...,.......X---X.X-------X...:,,...,:,....:XX,...,...............,...,...X------------
------------------------XXXXXXXXXXXXX-XXXtXXX-----X::.XX,...,.,,XXXXXX,...,...E.......E...,...,..:X------------
--------------------------------------X.....X--XXXX,,,XX,...,:..X----X,...,...............,...,...X------------
------------------------XXXXXXXXXXXXX-X.....XXXX,,,,,,,,,...,.,,XXXXXX,...XXXXXXX,,,XXXXXX,...XXXXX------------
------------------------X...........X-X.....t.XX,...........,:,...H.XX,...X-----X:.:X----X,...X----------------
------------------------X.E...E.HE..X-X.....XXXX,...........XXX.....XX,...XXXXXXX,,,XXXXXX,...X----------------
------------------------X...........X-X.....X--X,...........X-X:....XX,...,:,...........:,,...X----------------
------------------------X,,,,,,,,,,,X-X.....XXXX,...XXX,,,XXX-X:....XX,...,.,.H.......A.,,,...X----------------
------------------------X...........X-X.....t.XX,...X-X:.:X---X.....,:,...,:,...........:,,...X----------------
------------------------X.E...E..E..X-XXX,XXXXXX,...XXX,,,XXXXX.....,,,...XXX:XXXXX:XXXXXX,...X----------------
------------------------X...........X---X.X----X,...,:,.....,.,.....,:,...XXX,XXXXX,XXXXXX,...X----------------
------------------------X,,,,,,,,,,,X---X.X----X,...,.,.....XXX.....XX,,,,,,,,,,,,,,,,,,,,,...X----------------
------------------------X...........X---X.X----X,...,:,.....X-X.....XX,...,...............,...X----------------
------------------------X.........E.X---X.X---XX,...XXXXXXXXX-X:,:XXXX,,,,XXX,XXXXX,XXXXXX,,,,X----------------
------------------------X...........X---X.XXXXX:,...XXXXXXXXXXX,,,XXXX,...X-X.X---X.X----X,...X----------------
------------------------X,,,,,,,,,,,X---X.XX,,,,,...,,,,,,,,,,,,,,,,,,,...X-X,XXXXX.XXXXXX,...X----------------
----------------------XX...:.....:..X---X.XX,...,...,.................,...X-X...t:,.,,,,XX,...X----------------
---------------------X........H......X--X.XX,...,...,.................,...XXX...XXX,XXX,XX,...X----------------
-------------------XX....:........:..X--X.XX,...,...,.................,...,:,...X-X.X-X.XX,...X----------------
------------------X....H.....:........XXX.XX,...,,,,,,,,,,,,,,,,,,,,,,,...,:,...X-XHX-X+XX,...X----------------
------------------X..:.....:...:......++..XX,...,.....................,...,.,...X-X.X-X.XX,...X----------------
------------------X..............:....XXXXXX,...,.....E.....E..E...T..,...XXX...XXXXXXX.XX,...X----------------
------------------X..:.,,,,,,,,,:...:.X----X,...,........E............,...X-X...,.HXXH..:,,...X----------------
------------------X...::XXX,,,XXX...:.X--XXX,...,...,,,,,,,,,,,,,,,...,...X-X...,,XXX,,,,,,...X----------------
------------------X....,X......XX.....X--X,,,...,...,..::....::...,...,...X-X...,.X-X...:,,...X----------------
------------------X....,X.E..EHXX.:...X--X,,,...,..E,.XXXXX,XXXXX,,E..,...X-XXXXX.X-X...XX,...X----------------
------------------X....,,......,,......X-X,,,...,...,:X,,,,....X:,,...,...X-----X.X-X...XX,...X----------------
------------------X...:,,......,,.:.,,,,XX,,,...,..E,.X,,,,..E.XX:,...,,,,X-XXXXX,XXX...XX,,,,XXXXXXX----------
------------------X....,,......,,...,...,L,,,...,...,:X,,K,....XX,,E..,...X-XA....,.,...XX,...,..:W.X----------
------XXXXXXXXXXXXX.H..,,.tKt..,,...,.T.,L,,,...,...,.X,,,,.tttXX,,...,...XXX.....XXX...XX,...,..:..X----------
------X:.W.W.W.:t.X....,,.tTt.E,,...,...,L,,,...,..E,:X.....tTtXK,,E..,...,:,.....X-X...:,,...,.....X----------
------X........,,tX...:,X.ttt..XX...,,XXXX,,,...,...,.X.....tttXX,,...,...,:,...A.X-X...:,,...,..:..X----------
------XHA..A......X....,XXX,,,XXX...:.X--X,,,...,.E.,:XXXXX,XXXX:,,E..,...,.,.....X-X...,,,...,.....X----------
------XXXXXXXXXXXXX....:XXX,,,XX:....X---X,,,...,...,.XXXXX,XXXXX,,...,...XXXXX:,:X-X:,:XX,...XXXXXXX----------
------------------X................:.X---X,,,...,...,.,:,:,.,:,:,.,...,...XXXXX,,,XXX,,,XX,...X----------------
------XXXXXXXXXXXXXX.:...:..........X----XXX,...,...,,,,,,,,,,,,,,,...,...,,,,,,,,,,,,,,,,,...X----------------
------X:.W.W.W.:t.XX................X------X,...,.....E.E....E.E......,.......................X----------------
------XH.......,,tX-X...H.....:.....X-XXXXXX,...,.....................,.......................X----------------
------X.A..A......X-X......:.....:.X--X:.:.,,...,.....................,.......................X----------------
------XXXXXXXXXXXXX--X.......H.....X--X..:.,,...,,,,,,,,,,,,,,,,,,,,,,,,,,,,XXXXX,,,,,XXXXXXXXX----------------
---------------------X:..........:X---X:...,,.............................,:X---X.....X------------------------
XXXXX-XXXXXXXXXXXXX---X,,,,,,,,,,,X---X..:.,,,,...........................XXX---X:....X------------------------
XA.AX-X:.W.W.W.:t.X---X...........X---XK...,,:,.......E...................X-----X.:..:X------------------------
X...X-X.A......,,tX---X.E.........X---X..:.,,,,,,,XXX,,,,,,,,,E,XXXXXXXXXXX-----XW..H.X------------------------
X..HX-XH...A......X---X...........X---XW..........X-:..........:X---------------X.....X------------------------
X...X-XXXXXXXXXXXXX---X,,,,,,,,,,,X---X...........X-:,E,,,,,,E,:X-XXXXXXXXXXXXX-XXXXXXX------------------------
XW..X-----------------X...........X---X..:.::.:.:.X-:..........:X-HWWWWWAAAAH.X--------------------------------
X...XXXXXXXXXXXXXXX---X.E...E...E.X---XA..........X-XXXXXLLLXXXXX-XXXXXXX.....X--------------------------------
XW..,++T.W.W.W.:t.X---X...........X---X..H.:.:.::.X-----X...X-----------X++++HX--------------------------------
X...XXX..A.....,,tX---X,,,,,,,,,,,X---XXXXXXXXXXXXX---XXX,,,XXX---------X+++++XXXXX----------------------------
XW.WX-H....A......X---X...........X-------------------X.......X---------XE........X----------------------------
XXXXX-XXXXXXXXXXXXX---X.E.H.E...E.X-----------XXXXX---X.......X---XXXXX-XXXXXXXXX.XXXXXXXXXXX------------------
----------------------X...........X-----------X:.:X---X.......X---X:.:X---------X.,E........X------------------
----------------------XXXXXXXXXXXXX-----XXXXXXX,,,XXXXX.......XXXXX,,,XXXXXXX---X.XXX,,,XXX.X------------------
----------------------------------------X.....,.......,.......,.......,.....X---X.X-X:H:X-X.X------------------
----------------------------------------X.XXXXX,XXXXXXX.......XXXXXXX,XXXXX.X-XXX.X-XXXXX-X.X-XXXXXXX----------
----------------------------------------X.X---X.X-----X.......X-----X.X---X.X-X:,.X-------X.X-X.....X----------
----------------------------------------X.X---X.X-----XXX,,,XXX-----X.X---X.X-XH,.X-----XXX.X-X.....X----------
----------------------------------------X.X---X.X-------X:.:X-------X.X---X.X-X:,.X-----X:,.X-X.....X----------
----------------------------------------X.XXXXX.XXXXXXX-XXXXX-XXXXXXX.XXXXX.X-XXX.X-----X.,.X-X....:X----------
----------------------------------------X..E.E,.,..E..X-------X..E..,.,EE...X---X.X-----X:,.X-X.....X----------
----------------------------------------X,XXXXX.XXXXX.X-------X.XXXXX.XXXXX,X---X.XXXXX-XXX.XXX....:X----------
----------------------------------------X.X---X.X---XEX-------XEX---X.X---X.X---X.,..EX---X.++,.....X----------
----------------------------------------X.XXX-X.X---X.X-XXXXX-X.X---X.X---X.X---X.XXX.X---X.XXX.....X----------
----------------------------------------X.,:X-X.X---X.X-X:H:X-X.X---X.X---X.X---X.X-X.X---X.X-X.....X----------
----------------------------------------X.,.X-X.XXXXX,XXX,,,XXX,XXXXX.X---X.XXXXX,X-X.XXXXX.X-X....:X----------
----------------------------------------X.,:X-X.......................X---X.,E....X-X.,.....X-X.....X----------
----------------------------------------X.XXX-XXX,,,XXXXX:,,XXXXX,,,XXX-XXX.XXXXX.X-X.XXX,,,X-X....:X----------
----------------------------------------X.X-----X:.:X---X..:X---X:.:X---X:,.X---X.X-X.X-X:.:X-X.....X----------
----------------------------------------X.XXXXX-XXXXX---XXXXX---XXXXX---X.,.X---X.X-X.X-XXXXX-X.....X----------
----------------------------------------X.,..EX-------------------------X:,.X---X.X-X.X-------X.....X----------
--------------------------------------XXX.XXX.XXXXX-----XXXXXXXXXXX-----XXX.X---X.XXX.X-------X,,,,,X----------
--------------------------------------X:,.X-XE.E.EX-----XE.E..E..EX-------X.X---X.,..EX-------X.....X----------
--------------------------------------X.,.X-XXXXX.X-----X.XXXXXXX.X-XXXXX-X.X-XXX.XXXXX-------X.....X----------
--------------------------------------X:,.X-----X.X-----X.X-----X.X-X...X-X.X-XH,.X-----------XH.E..X----------
--------------------------------------XXX.XXXXXXX,XXXXXXX,XXXXXXX,XXX,,,XXX.X-X.,.X-----------X.....X----------
----------------------------------------X...................................X-X:,.X-----------XH.A.AX----------
----------------------------------------XXXXX,,,XXXXX,,:XXXXX,,,XXXXXXXXX,XXX-XXX.X-----------XXXXXXX----------
--------------------------------------------X:H:X---X:..X---X:H.X-------X.X-----X.X----------------------------
--------------------------------------------XXXXX---XXXXX---XXXXX-------XEX-----X.X----------------------------
------------------------------------------------------------------------X.X-----X.X----------------------------
------------------------------------------------------------------------X.XXXXXXX.X----------------------------
------------------------------------------------------------------------X.....E...X----------------------------
------------------------------------------------------------------------XXXXXXXXXXX----------------------------
