XXXXXXXXXXXXXXXXXXXXXXXXXXXXXXXXXXXXXXXXXXXXXXXXXXXXXXXXXXXXXXXXXXXXXXXXXXXXX
XW.....:.......++..E..:.H..++......H........+E..H.........EL+...............X
X.,,,,,,,,,,,,,++E...HA...E++.,,,,,.,,,,,,,.+.....:..HA....L+.,,,.,,,.,,,,,.X
X.,...........,++..........++.,...,.,.....,.+..............L+.,.,.,.,.,...,.X
XE,...........,XXXXXXXXXXXXXX.,...,.,.....,.XXXXXXXXXXXX++XXX.,.,.,.,.,...,.X
X.,.......E...,X------------X.,...,.,.....,.X...............X.,.,.,.,.,...,.X
X.,....E......,X--XXXXXXXXX-X:,...,.,.E...,.X.XXXXXXXXXXXXX.X.,.,.,.,H,...,:X
XH,.E.........,X--X.......X-X.,...,.,E....,.X.XE.........:X.X.,.,.,.,E,...,.X
X.,.....E.....,X--X....E..X-X.,...,.,.....,.X.X.,,,,,,,,,.X.XE,.,.,.,.,...,.X
X.,...........,X--X.......X-X.,...,.,.....,.X.X.,.......,.X.X.,.,.,.,.,...,.X
X.,...........,X--X..E....X-X.,...,.,.....,.X.X.,.,,,,,.,.X.X.,.,.,.,.,...,.X
X.,...........,X--XE....E.X-XE,...,.,.....,.X.X.,.,...,.,.X.X.,.,.,.,.,...,.X
X.,,,,,,,,,,,,,X--X.......X-X.,,,,,.,,,,,,,.XXX.,.,E..,.,.X.X.,,,.,,,E,,,,,.X
X..............X--X.......X-X...............,...,.,...,.:.X.XXXXXXXXXXXXX+++X
X+++XXXXXXXXXXXX--X.......X-X+++XXXXXXXXXXXXXXX.,.,...,.,.X.............X+++X
X.E.X-------------X,,,,,,,X-X...X.............X.,.,...,.,.X.............X...X
X...X-XXXXXXXXXXXXX,,,,,,,X-X.E.X.XXXXXXXXXXXXX.,.,...,.,WXXXXXXXXXXXXX.X.E.X
X...X-X:..................X-X...X.X.............,.,...,.,....E........X.X...X
XH..XXX.,,,,,..H..........X-X.:.X.X.,,,,,,,,,,,,,.,.E.,.,,,,,,,,,,,,,.X.XH..X
X...+...,...,...A....W....X-X...X.X.,.............,...,.............,.X.XA..X
XA..+...,...,.....AAA.....+-X...X.XK,.............,...,.............,.X.X...X
X...+...,...,.............+-X...X.X.,.............,...,.............,.X.X.:.X
X...XXX.,,,,,.............X-X...X.X.,,,,,,,,,,,,,.,E..,.,,,,,,,,,,,,,.X.X...X
X...X-X...................X-X...X.X......W......,.,...,.,.A.AA.A.A.A..X.X...X
XE..X-XXXXXXXXXXXXX,,,,,,,X-X.E.X.XXXXXXXXXXXXX.,.,...,.,.XXXXXXXXXXXXX.X.E.X
X+++XXXXXXXXXXXX--X.E.....X-X+++X.............X.,.,...,.,.X......H......X+++X
X..............X--X.......X-X+++XXXXXXXXXXXXX.X.,.,,,,,.,.X.XXXXXXXXXXXXX+++X
X.......:......X--XE.E..E.X-X...............X.X.,.......,.X.X...............X
X.,,,,,,,.,,,,,X--X...E...X-XE,,,.,,,,,.,,,.X.X.,,,,,,,,:.X.X.,,,,,,,,,.,,,.X
X.,.....,.,...,X--X.......X-X.,.,.,...,.,.,.X.X...........X.X.,.......,.,.,.X
X.,.....,.,...,X--XXXXXXXXX-X.,.,.,...,.,.,.X.XXXXXXXXXXXXX.X.,,,,,,,,,.,.,.X
X.,..E..,.,.E.,X------------X.,.,.,.E.,.,.,.X...............X......E....,.,.X
X.,,,,,,,.,...,XXXXXXXXXXXXXX.,.,.,...E.,.,.XXXXXXXXXXXXXXXXX.,,,.A..HA.,.,.X
XE.......H,...,L+E....:....++.,.,.,...,.,.,.+.E......A.....++.,.,.....A.,.,.X
X.,,,,,,,.,,,,,L+...H.A...E++.,.,.,...,.,.,.+...A.H:......E++.,.,A.:..A.,.,EX
X.,...E.,......L+..........++.,.,.,E..,.,.,.+..............++.,.,A..E.A.,.,.X
X.,.....,E,,,,,XXXXXXXXXXXXXX.,.,.,...,.,.,.XXXXXXXXXXXXXXXXX.,.,..A....,,,.X
X.,..E..,.,...,X------------X.,.,.,...,.,.,.X---------------X.,.,...........X
X.,.....,.,...,X--XXXXXXXXX-X.,.,.,...,.,.,.X-XXXXXXXXXXXXX-X.,.,.,,,,,,,,,.X
X.,.....,.,...,X--X.......X-X.,.,.,...,.,.,.X-X:.........:X-X.,.,.,.......,.X
X.,,,,,,,.,,,,,X--X.,,,,,.X-X.,,,:,,,,,.,,,.X-X.,,,,,,,,,.X-X.,,,.,,,,,,,,,.X
X+++XXXXXXXXXXXX--XE,...E.X-XXXXXXXXXXXXXLLLX-X.,.......,.X-X...............X
X+++X-------------X.,...,.X-------------X+++X-X.,.,,,,,.,.X-XXXXXXXXXXXXX+++X
X...X-------------X.,...,.X-------------X...X-X.,.,EEE,.,.X-------------X.E.X
X.E.XXXAXAAAX:XXXXX.,...,.XXXXXXXXXXXXX-X...X-X.,.,,,,,.,.XXXXXXXXXXXXX-X...X
X...XX...........W..,...,.......E.....X-X...X-X.,.......,E............X-X...X
X...XX..,,,,,,,,,,,,,...,,,,,,,,,,,,,.XXX...X-X.,,,,,,,,,...H.,,,,,,,.X-X...X
X...XX..,E..........................,..++...X-X.....:.........,.....,.X-X...X
X...XX..,.,,,,,,,,,,,,,,,,,,,,,,,,,.,..++E..X-X.,,,,,,,,,.,,,,,.,,,.,.X-X.A.X
X:..XX..,E,.......................,.,..++...X-X.,.......,.,.....,.,.,.X-X:..X
X...XX..,.,.......................,.,.XXX...X-X.,.,,,,,.,.,.,,,,,E,.,.X-X...X
XA..XX..,E,.......................,.,.X-X:..X-X.,.,EEE,.,.,.,E.E..,.,.X-X.H.X
X...XX..,.,,,,,,,,,,,,,,,,,,,,,,,,,.,.X-X...X-X.,.,,,,,.,.,.,,,,,,,.,.X-X...X
X.H.XX..,...........................,.X-X...X-X.,.......,.,.........,.X-X...X
X...XX..,,,,,,,,,,,,,,,,,,,,,,,,,,,,,.X-X...X-X.,,,,,,,,,.,,,,,,,,,,,.X-X...X
X...XX................................X-X...X-XH.........A....E..E....X-X...X
X.E.XXXXXXXXXXXXXXXXXXXXXXXXXXXXXXXXXXX-X...X-X.,,,,,,,,,.XXXXXXXXXXXXX-X.E.X
X+++X-----------------------------------X+++X-X.,,,,,,,,,.X-XXXXXXXXXXXXX+++X
X+++XXXXXXXXXXXXXXXXXXXXXXXXXXXXXXXXXXXXX+++X-X.,,E.E.E,,WX-X........E......X
X..<...........++E....H....L................X-X.,,,,,,,,,.X-X.:.............X
X..............++.........EL..,,,,,,,,,.,,,.X-X.,,,,,,,,,.X-X.,,,,,,,.,,,,,.X
X..............++..........L..,.......,.,.,.X-X...........X-X.,.....,.,...,.X
X..<.<.........XXXXXX+++XXXX..,,,,,,,,,.,.,.X-XXXXXXX...XXX-X.,.....,.,...,.X
X..........:...X----X...X--X...........:,.,.X-------X+++X---X.,.....,.,...,.X
X..<...........X--XXX...XXXX..,,,.,,,,,.,.,.XXXXXXXXX+++XXXXX.,.....,.,E..,.X
X,,,,,,,,,,,,,,X--+:.....:XXE.,.,.,E..,.,.,.+........:.....++.,.E.E.H.,...,.X
X..............X--+.......XX..,.,.,...,.,.,.+E..AH....A...E++.,.....,.,...,.X
X.....:........X--X....E..XXA.,.,.,...,.,.,.+..............++.,.....,.,...,.X
X..............X--X..H.E..XX..,.,.,,,,,.,,,.XXXXXXXXXXXXXXXXX.,.....,.,...,.X
X..............X--X.......XXA.,.,...........X---------------X.,.....,E,...,.X
X........H..:..X--X.AA.A..XXA.,.,.,,,,,,,,,.X-XXXXXXXXXXXXX-X.,.....,.,...,.X
X..............X--X.......XXA.,.,.,.......,.X-X:...E......X-X.,.....,.,...,.X
X.............:X--X,,,,,,,XX..,,,.,,,,,,,,,.X-X.,,,,,,,,,.X-X.,,,,,,,.,,,,,.X
X..............X--X.......XX................X-X.,.......,.X-XXXXXXXXXXXXX+++X
X+++XXXXXXXXXXXX--X.,,,,,.XXXXXXXXXXXXXXX+++X-X.,.,,,,,E,.X-------------X+++X
X.E.X-------------XE,...,.X-------------X...X-X.,.,...,.,.X-------------X.E.X
X...X-XXXXXXXXXXXXX.,...,.XXXXXXXXXXXXX-X...X-X.,.,...,.,.XXXXEXXXXXXXX-X...X
X...X-X:.......,:...,...,..:,........:X-X...X-X.,.,...,.,............:X-X...X
X...X-X.....E..,..,,,...,,,,,....E....X-X...X-X.,.,...,.,,,,,,,,,,,,,.X-X...X
X.:.X-X..E.....,..,.......,,,......E..X-X...X-X.,.,...,.............,.X-X...X
X...X-X..H.....,..,...EE..,,,....E....X-X...X-X.,.,...,..HH.....,,,.,.X-X:..X
X.A.X-X....:...,..,.E.....,,,.E.......X-XW..X-X.,.,...,.....H...,K,.,.X-XH..X
X...X-X........,..,.......,,,.........X-X...X-X.,.,...,.........,,,.,.X-X...X
X...X-X...E..E.,..,.......,,,.........X-X...X-X.,.,...,...H.........,.X-XA..X
X...X-X........,:.,,,...,,,,,..E..E...X-X...X-X.,.,...,.,,,,,E,,,,,,,.X-X...X
X.H.X-X:.......,....,...,.:,,........:X-X...X-X.,.,...,.,.XXXXXXXXXXXXX-X...X
X.E.X-XXXXXXXXXXXXX.,...,.XXXXXXXXXXXXX-X...X-X.,.,...,.,.X-------------X.E.X
X+++X-------------X.,...,.X-------------X+++X-X.,.,...,.,.XXXXXXXXXXXXXXXLLLX
X+++XXXXXXXXXXXXX-X.,...,.XXXXXXXXXXXXXXX+++X-X.,.,,,,,.,W.,................X
X..............:X-X.,...,.XX................X-X.,.......,.XX................X
X.,,,,,,,,,,,,,.X-XW,,,,,.XX..,,,,,.,,,,,,,.X-X.,,,,,,,,,.XX..,,,,,,,.,,,,,.X
X.,...........,.X-X...W...XX..,..E,.,...E.,.X-X:.A.AA.A...XX..,.....,.,...,.X
X.,...........,.X-X++XXXX++X..,.E.,.,..E..,.X-XXXXXXXXXXXXXX..,.....,E,...,.X
X.,...........,.X----------X..,EE.,.,.E.E.,.X--------------X..,.....,.,...,.X
X.,,,,,,,,,,,,,.XXXXXXXXXXXX..,...,.,,....,.XXXXXXXXXXXXXXXX..,.E...,.,...,.X
X.H....:....E...+...A......L..,.,,.:..,,,.,.+....:.AH.....EL..,.....,.,...,.X
XE...AA..AA.....+E...H....EL..,,..,.,,...,,.+E.............L..,,,,E,:.,.E.,.X
X...............+..........L.E..,,,.,.,,,...+..............L.H........,...,.X
X.,,,,,,,,,,,,,.XXXXXXXXXXXX..,,..,.,....,,.XXXXXXXXXXXXXXXX..,,,,,,,.,...,.X
X.,...E.......,.X----------X..,EE.,.,E.E..,.X--------------X..,.....,.,...,.X
X.,...........,.X-XXXXXXXXXX..,E.E,.,.E.E.,.X-XXXXXHXXXXXXXX..,.....,.,...,.X
X.,...........,.X-:......:XX..,...,.,.....,.X-X..........:XX..,.....,.,...,.X
X.,,,,,,,,,,,,,.X-X.,,,,,.XX..,,,,,.,,,,,,,.X-X.,,,,,,,,,.XX..,,,,,,,E,,,,,.X
X...............X-X.,...,.XX................X-E.,.......,.X+++XEXXXXXXXXX+++X
X+++XXXXXXXXXXXXX-X.,...,.XX+++XXXXXXXXXXXXXX-X.,.,,,,,.,.X-------------X+++X
X...X-------------X.,...,.XX...X--------------X.,.,,,,,.,.X-------------X..EX
X.E.X-:XXXXXXXXXXXX.,...,.XX...X--XXXXXXXXXXXXX.,.,,.,,.,:XXXXXXXXXXXXX-XH..X
X...X-X.....W....E..,...,.XX.E.X--X:.AAA.A.AA...,E,,,,,.,.............X-X...X
X.:.X-X.,,,,,,,,,,,,,...,.XX...XXXX.,,,,,,,,,,,,,.,...,.,,,,,,,,,,,,,.X-XAE.X
X...X-XK,...............,.XX.A.++...,.............,...,.............H.X-X:..X
XA..X-X.,,,,,,,,,,,,,...,.XX...++.W.,,,,,,,,,,,,,.,...,.,,,,,,,,,,,,,.X-X...X
X...X-X:............,...,WXX...++............W..,.,,,,,E,.............X-X...X
X.E.X-XXXXXXXXXXXXX.,...,.XX...XXXXXXXXXXXXXXX..,.,,.,,.,.XXXXXXXXXXXXX-XE..X
X+++X-------------X.,...,.XX+++XXXXXXXXXXXXX-X..,.,,,,,.,.X-------------XLLLX
X+++XXXXXXXXXXXXXXX.,...,.XX...............X-X..,E,...,.,.X-XXXXXXXXHXXXX+++X
X...............,.:.,...,.XX...............X-X..,.,...,.,.X-X:..............X
X.,,,,A.,,,,,,,.XXX.,...,.XX..,,,,,,,,,,,,,X-X..,.,...,.H.X-X.,,,,,,,,,,,,,.X
X.,...,.,.....,.X-X.,...,.XXE.,...........,X-X..,.,,,,,.,.X-X.,...........,.X
X.,...A.,.....,.X-X.,...,.XX..,...E.......,X-X..,.,,.,,.,.X-X.,...........,.X
X.,...,A,.E...,.X-X.,...,.XX..,........E..,X-X..,E,,,,,.,.X-A.,.E.........,.X
X.,...,.,.....,.X-X.,...,.XX.:,,,,........,X-X..,.,,,,,.,.X-X.,.....E.....,.X
X.,...,A,.....,.X-X.,...,.XX....A.A,,,,,..,X-X..,....E..,.X-XA,...........:.X
X.,...,.,,,,,,,.X-X.,,,,,:XX..,,,...A.A.,,,X-X..,,,,,,,,,.X-X.,........E..,.X
XE,...,:........X-X.......XX..,..,,,,,,....X-X...........:X-XA,...........,.X
X.,...,.,,,,,,,.X-XXXXXXXXXX..,....E...,,,.X-XXXXXXXXXXXXXX-X.,.E.........E.X
X.,...,.,..E..,.X----------X..,.E........,.X----------------XA,...........,.X
X.,E..,.,.....,.XXXXXXXXXXXX..,......E...,.XXXXXXXXXXXXXXXXXX.,...........,.X
X.,...,.,.....,.+.........EL..,..........,.++............H.L+.,...........,.X
X.,,,,,.,,,,,,,.+E...H:A...L..,,,,,,,,,,,,.++E...:.A..H...EL+.,,,,,,,,,,,,,.X
X...............+..........L...............++..............L+...............X
X++XXXXXXXXXXXXXXXXXXXXXXXXXXXXXXXXXXXXXXXXXXXXXXXXXXXXXXXXXXXXXXXXXXXXX>>>>>
