------------------------------------------------XEXXXXXXX-------------------------------------------------
------------------------------------------------X......EX-------------------------------------------------
------------------------------------XXXXXXXXXXXXX.......XXXXXXXXXXEXX-------------------------------------
------------------------------------XE..........,.......,...........X-------------------------------------
------------------------------------X.XXXXXXXXXXX.......XXXXXXXXXXX.X-------------------------------------
------------------------------------X.X---------X.......X---------X.X-------------------------------------
------------------------------------X.X---------XXXLLLXXX---------X.X-------------------------------------
------------------------------------X.X----------XXLLLXX----------X.X-------------------------------------
------------------------------------X.X---XXXXXXXX,,,,,XXXXXXXX---X.X-------------------------------------
------------------------------------X.X---XE.................EX---X.X-------------------------------------
------------------------------------X.X---X...................X---X.X-------------------------------------
------------------------------------X.X---X...................X---X.X-------------------------------------
------------------------------------X.X---X...................X---X.X-------------------------------------
------------------------------------X.X---X........E..........X---X.X-------------------------------------
----------------------------------XXX,XXX-X...................X-XEX,XXX-----------------------------------
----------------------------------E....EXXX...................XXX....EX-----------------------------------
----------------------------------X.....XX,...............E...,XX.....X-----------------------------------
----------------------------------X.....LL,...................,LL...E.X-----------------------------------
----------------------------------X..E..LL,..E................,LL.E...X-----------------------------------
----------------------------------X.....LL,...................,LL.....X-----------------------------------
----------------------------------X.....XX,...................,XX..E..X-----------------------------------
----------------------------------XE...EXXX...................XXX.....X-----------------------------------
----------------------------------XXX,XXX-X...................X-XXX,XXX-----------------------------------
------------------------------------X.X---X...................X---XEX-------------------------------------
------------------------------------X.X---X.E.................X---X.X-------------------------------------
------------------------------------X.X---X.........,,,.......X---X.X-------------------------------------
------------------------------------X.X---X.........,T,.......X---X.X-------------------------------------
------------------------------------X.X---X.........,,,.......X---X.X-------------------------------------
------------------------------------X.X---XXXXXXXXXXXXXXXXXXXXX---XEX-------------------------------------
------------------------------------X.X---------------------------X.X-------------------------------------
------------------------------------XEX---------------------------X.X-------------------------------------
------------------------------------X.X---------------------------X.X-------------------------------------
------------------------------------X.XXXXXXXXXXXXXXXXXXXXXXXXXXXXXEX-------------------------------------
------------------------------------X.........E....ttt............E.X-------------------------------------
------------------------------------X...E........K.t.t....E...E.....X-------------------------------------
------------------------------------X..............ttt..............X-------------------------------------
------------------------------------XXXXXXXXXXXXXXXXXXXXXXXXXXXXXXXXX----------------->>>-----------------
--------------------------------------------------------------------------------------XLX-----------------
--------------------------------------------------------------------------------------XLX-----------------
--------------------------------------------------------------------------------------X:X-----------------
--------------------------------------------------------------------------------------X,X-----------------
--------------------------------------------------------------------------------------XLX-----------------
---------------------------------------XXXXXXXXXXXXXXXXXXXXXXXXXXXX-------------------XEX-----------------
---------------------------------------XW...........,,,,,,,,,.,,,AX-------------------X,X-----------------
---------------------------------------X............,T,,T,,T,.,T,.X-------------------XLX-----------------
---------------------------------------X............,,,,,,,,,.,,,.X-------------------XEX-----------------
--------------XXXXXXXXX----------------X..........................X----------------XEXX,XXXX--------------
--------------X.....E.X----------------X.,,,,,,,,,,,,,,,,,,,,,,,,.X----------------X......EX--------------
--XXXXXXXXXXXXX.......XXXXXXXEXXXXXXX--X.,,,,,,,,,,,,,,,,,,,,,,,,.X--XXXXXXXXXXXXXXX.......XXXEXXXXXXXEX--
--XE....E...E.,.E..E..,..........E..X--X.,,<.....<.....<......<,,.X--XE............,...E...,...........X--
--X.XXXXXXXXXXX.......XXXXXXXXXXX...X--X.,,....................,,.X--X...XXXXXXXXXXX.......XXXXXXXXXXX.X--
--X.X---------X.......X---------X...X--X.,,...W.....W......W...,,.X--X...X---------XE.....EX---------X.X--
--X.X---------XXXLLLXXX---------X...X--X.,,....................,,.X--XE..X---------XXXLLLXXX---------X.X--
--X.X----------XXLLLXX----------X...X--X.,,....................,,.X--X...X----------XXLLLXX----------X.X--
--X.X---XXXXXXXX,,,,,XXXXXXXX---XE..X--X.,,....................,,.X--X...X---XXXXXXXX,,,,,XXXXXXXX---X.X--
--X.X---X...................X---X...X--X.,,....................,,.X--X...X---XE.................EX---X.X--
--X.X---X...................X---X...X--X.,,....................,,.X--X...X---X...................X---X.X--
--E.X---X.E.........E.......X---X...X--X.,,....................,,.X--XE..X---X...................X---X.X--
--X.X---X...................X---X...X--X.,,....................,,.X--X...X---X...................X---X.X--
--X.X---X...................X---X...X--X.,,....................,,.X--X...X---X...................X---X.X--
XXX,XXX-X...E...............X---X...X--X.,,....................,,.X--X...X---X...................X-XXX,XXX
XE....XXX.......E...........X---X.K.X--X.,,....................,,.X--X...X---X...................XXXE...EX
X.....XX,...................X---X...X--X.,,....................,,.X--X...X---X...................,XX.....X
X.....LL,................,,,X---XtttX--X.,,....................,,.X--XtttX---X,,,................,LL.....X
X.....LL,................,T,X---Xt.tX--X.,,....................,,.X--Xt.tX---X,T,.......E........,LLE.E.EX
X.....LL,.E..............,,,X---XtttX--X.,,....................,,.X--XtttX---X,,,................,LL.....X
XE....XX,...................X---X...X--X.,,....................,,.X--X...X---X...................,XX....EX
X.....XXX...................X---X...X--X.,,....................,,.X--X...X---X...................XXXE....X
XXX,XXX-X.........E.........X---XE..X--X.,,....................,,.X--X...X---X...................X-XXX,XXX
--X.X---X...................X---X...X--X.,,....................,,.X--X...X---X...................X---X.X--
--X.X---X...................X---X...X--X.,,....................,,.X--X...X---X...................X---X.X--
--X.X---X.E........E........X---X...X--X.,,..E......E.......E..,,.X--XE..X---X...................X---X.X--
--X.X---X...................X---X..EX--X.,,....................,,.X--X...X---X...................X---X.X--
--X.X---X...................X---X...X--X.,,....................,,.X--X...X---XE.................EX---X.X--
--X.X---XXXXXXXX,,,,,XXXXXXXX---X...X--X.,,....................,,.X--X...X---XXXXXXXX,,,,,XXXXXXXX---X.X--
--X.X----------XXLLLXX----------X...X--X.,,....................,,.X--X...X----------XXLLLXX----------X.X--
--X.X---------XXXLLLXXX---------X...X--X.,,....................,,.X--X...X---------XEXLLLXXX---------X.X--
--X.X---------X.E..E..X---------X...X--X.,,....................,,.X--X...X---------X......EX---------X.X--
--X.XXXXXXXXXXX.......XXXXXXXXXXE...X--X.,,....................,,.X--X...XXXXXXXXXXX.......XXXXXXXXXXXEX--
--XE....E.....,.......,..E..........X--X.,,....................,,.X--XE............,..E....,..E........X--
--XXXXXXXXXXXXX.......XXXXXXXXXXXXXXX--X.,,A.A................W,,.X--XXXXXXXXXXXXXXX.......XXXXXXXXXXXXX--
--------------X.....E.X----------------X.,,,,,,,,,,,,,,,,,,,,,,,,.X----------------XE.....EX--------------
--------------XXXXXXXXX----------------X.,,,,,,,,,,,,,,,,,,,,,,,,.X----------------XXXXXXXXX--------------
---------------------------------------X..........................X---------------------------------------
---------------------------------------X..........................X---------------------------------------
---------------------------------------X..........................X---------------------------------------
---------------------------------------X..........................X---------------------------------------
---------------------------------------X........ttt.ttt.ttt.ttt...X---------------------------------------
---------------------------------------X........t.t.t.t.t.t.t.t...X---------------------------------------
---------------------------------------XW.......ttt.ttt.ttt.ttt..WX---------------------------------------
---------------------------------------XXXXXXXXXXXXXXXXXXXXXXXXXXXX---------------------------------------
----------------------------------------------------------------------------------------------------------
----------------------------------------------------------------------------------------------------------
------------------------------------XXXXXXXXXXXXXXXXXXXXXXXXXXXXXXXXX-------------------------------------
------------------------------------X..............ttt....E.......E.X-------------------------------------
------------------------------------XE....E........t.tK.............X-------------------------------------
------------------------------------X..............ttt..............X-------------------------------------
------------------------------------X.XXXXXXXXXXXXXXXXXXXXXXXXXXXXX.X-------------------------------------
------------------------------------X.X---------------------------X.X-------------------------------------
------------------------------------X.X---------------------------X.X-------------------------------------
------------------------------------X.X---------------------------X.X-------------------------------------
------------------------------------X.X---XXXXXXXXXXXXXXXXXXXXX---X.X-------------------------------------
------------------------------------X.X---X........,,,........X---X.X-------------------------------------
------------------------------------X.X---X........,T,........X---X.X-------------------------------------
------------------------------------X.X---X........,,,........X---X.X-------------------------------------
------------------------------------X.X---X...................X---X.X-------------------------------------
------------------------------------X.X---X...................X---X.X-------------------------------------
----------------------------------XXX,XXX-X...................X-XXX,XXX-----------------------------------
----------------------------------X.....XXX...................XXX...E.X-----------------------------------
----------------------------------XE....XX,...................,XX.....X-----------------------------------
----------------------------------X.....++,...................,++.....X-----------------------------------
----------------------------------X.....++,...................,++.....X-----------------------------------
----------------------------------X.....++,...................,++.....X-----------------------------------
----------------------------------X.....XX,...................,XX...E.X-----------------------------------
----------------------------------XE....XXX.........E.........XXX.....X-----------------------------------
----------------------------------XXX,XXX-X...................X-XXX,XXX-----------------------------------
------------------------------------X.X---X...................X---X.X-------------------------------------
------------------------------------XEX---X...................X---X.X-------------------------------------
------------------------------------X.X---X...................X---X.X-------------------------------------
------------------------------------X.X---X...................X---X.X-------------------------------------
------------------------------------X.X---X...................X---X.X-------------------------------------
------------------------------------X.X---XXXXXXXX,,,,,XXXXXXXX---X.X-------------------------------------
------------------------------------X.X----------XX+++XX----------X.X-------------------------------------
------------------------------------X.X---------XXX+++XXX---------X.X-------------------------------------
------------------------------------X.X---------X.....E.X---------X.X-------------------------------------
------------------------------------X.XXXXXXXXXXXE......XXXXXXXXXXX.X-------------------------------------
------------------------------------X...E.......,.......,.....E.....X-------------------------------------
------------------------------------XXXXXXXXXXXXXE....E.XXXXXXXXXXXXX-------------------------------------
------------------------------------------------X.......X-------------------------------------------------
------------------------------------------------XXXXXXXXX-------------------------------------------------
