----------------------------------------------------------------------------XX>>XXX------------------------------------------------------
----------------------------------------------------------------------------X,,,,,X------------------------------------------------------
----------------------------------------------------------------------------X.....X------------------------------------------------------
----------------------------------------------------------------------------X...E.X------------------------------------------------------
----------------------------------------------------------------------------X.....XXX----------------------------------------------------
----------------------------------------------------------------------------X.E...,WX----------------------------------------------------
----------------------------------------------------------------------------X.....XXX----------------------------------------------------
----------------------------------------------------------------------------X...E.X------------------------------------------------------
----------------------------------------------------------------------------X.....X------------------------------------------------------
----------------------------------------------------------------------------X.....X------------------------------------------------------
XXXXXXXXXXXXXXXXXXXXXXXXXXXXXXXXXXXXXXXXXXXXXXXXXXXXXXXXXXXXXXXXXXXXXXXXXXXXX,,,,,XXXXXXXXXXXXXXXXXXXXXXXXXXXXXXXXXXXXXXXXXXXXXXX--------
X..............................,...........................................:,.....,:.............,..............................X--------
X............................,,..A........A...............A.................,,,,,,,..........A....,,............................X--------
X............A.A.A..........,.......................................................................,...........................X--------
X....A.A.A.................,.........................................................................,.............W....A.A.A...X--------
X............A.A.A........,...........................................................................,.........................X--------
X....A.A.A...............,..................................................:..........................,,...............A.A.A...X--------
X......................,,................................................................................,......................X--------
X....A.A.A............,.................................E.................................................,.............A.A.A...X--------
X....................,.....................................................................................,....................X--------
X...................,.......................................................................................,..........A.A.A....X--------
X.................,,.........................................................................................,,.................X--------
X...W............,.............................................................................................,.......A.A.A....X--------
X...............,...............................................................................................,...............X--------
X..............,.................................................................................................,..............X--------
X............,,...................................................................................................,,............X--------
X...........,.......................................................................................................,...........X--------
X..........,.........................................................................................................,..........X--------
X.........,...........................................................................................................,.........X--------
X........,.............................................................................................................,,.......X--------
X......,,.....................,,,,,,,,,,,,,,,,,,,,,,,,,,,,,,,,,,,,,,,,,,,,,,,,,,,,,,,,,,,,,,,,,,,,,,,,,,,,,,.............,......X--------
X.....,.......................,,,,,........................................................................,..............,.....X--------
X....,........................,,,,,.....................................................................H..,...............,....X--------
X...,.........................,,,,,.....A....H.........H......A.......H......A.......H..........A..........,................,...X--------
X.,,..............................,..H............A........................................................,.................,,.X--------
X,................................,........................................................................,...................,X--------
X.................................,........................................................................,....................X--------
X..A..............................,....,,,,,,,,,,,,,,,,,,,,,,,,,,,,,,,,,,,,,,,,,,,,,,,,,,,,,,,,,,,,,,,,.A..,..................A.X--------
X.................................,.A..,..........................................................,,,,,....,....................X--------
X.................................,....,..........................................................,,,,,....,....................X--------
X...................:.............,....,....................,,,...............,...................,,,,,....,....................X--------
X.................................,....,....................,.,...............,,..................,,,,,....,....................X--------
X.................................,....,....................,..,..............,.,.....................,....,....................X--------
X.................................,....,....................,..,..............,..,....................,.H..,....................X--------
X.................................,....,....................,...,,,,,,,,,,,,,,,...,...................,....,....................X--------
X.................................,..H.,....................,......................,..................,....,....................X--------
X.................................,....,....................,...........:...........,.................,....,....................X--------
X.................................,....,....................,......................,..................,....,....................X--------
X.................................,....,....................,...,,,,,,,,,,,,,,,...,...................,....,..XXXXXXXXXX........X--------
X.................................,....,....................,...,.............,..,....................,....,..X--------X........X--------
X.................................,....,....................,..,..............,.,.....................,.A..,..X--------X........X--------
X.................................,....,.....:.:.:..::.:....,..,..............,,......................,....,..X--------X........X--------
X.................................,..A.,....,,,,,,,,,,,,,...,,,...............,.......................,....,..X--------X........X--------
X.................................,....,....,::.::::.:::,.............................................,....,..X--------X........X--------
X.................................,....,....,:,,,,,,,,,:,.............................................,....,..X---XXXXXX........X--------
X.................................,....,....,:,H,:.:,H,:,.............................................,....,..X---X.............X--------
X.................................,....,....,:,,,,,,,,,:,...XXXXXXXXXXXXXXXXXXXXXXXXXXXXXXXXX.........,....,..X---X,,,,,,,,,,,,,X--------
X.................................,....,....,.,H,:.:,H,.,...X-------------------------------X.........,....,..X---X,,,,,,,,,....X--------
X.................................,....,....,:,,,,,,,,,:,...X-------------------------------X.........,.H..,..X---X,,W,,...,....X--------
X.................................,....,....,:,.,:.:,.,:,...X-------------------------------X.........,....,..X---X,ttt,.W.,....X--------
X.................................,..H.,....,:,.,,,,,.,:,...X-------------------------------X.........,....,..X---X,,K,,...,....X--------
X..:..............................,....,....,:,.,:.:,.,:,...X-----------------------------XX,.........,....,..X---X,,,,,,,,,....X--------
X.................................,....,....,.,.,,,,,.,.,...X---------------------------XX.W,.........,....,..X---X,............X--------
X:.:..............................,.:..,....,:,.,:.:,.,:,...X-------------------------XX..E.,.........,....,..X---X,............X--------
X,,,,,,,,,,,,,,,,,,,,.............,....,....,:,.,,,,,.,:,...X------------------------XE.E...,.........,.A..,..X---X,............X--------
XH.,,:,:,:,:,:,:,:,:,.............,....,....,:,.,:.:,.,:,...X------------------------X.....:,.........,....,..X---X,............X--------
X..,,.,.,.,.,.,.,.,.,.............,..A.,....,:,.,,,,,.,:,...X-XXXXX-XXXXXXXXXXXXXXXXX,E.E...,:........,....,..X---X,............X--------
X..,,:,:,:,:,:,:,:,:,.............,....,....,.,.,:.:,.,.,...X-X.<.XXX,,,,,,,,,,,,,,,X,......,,,..:....,....,..X---X,,,,.........XXXXXXXXX
X,,,,,,,,,,,,,,,,,,,,.............,....,....,:,.,,,,,.,:,...X-X<T<,+,:.:.:.:.:.:.:+:,,E.E.E.,H,.......,....,..X---X,tT,.:.......,E,.E:..X
XH.:..............................,....,....,:,.,:.:,.,:,...X-X.<.XXX,,,,,,,,,,,,,,,X,..E.E.,,,.......,....,..X---X,,,,.........XXXXXX..X
X.................................,....,....,:,.,,,,,.,:,...X-XXXXX-XXXXXXXXXXXXXXXXX,E.....,:........,....,..X---X,............X----XXXX
X..:..............................,....,....,:,.......,:,...X-----------------------X,..E.E.,.........,....,..X---X,............X--------
X.................................,....,....,.,.......,.,...X------------------------XE.....,.........,....,..X---X,............X--------
X.................................,....,....,:,.......,:,...X------------------------XX...E.,.........,.H..,..X---X,............X--------
X.................................,....,....,:,...A...,:,...X--------------------------XX...,.........,....,..X---X,,,,,,,,,....X--------
X.................................,..H.,....,:,.......,:,...X----------------------------XX.,.........,....,..X---X,,......,....X--------
X.................................,....,....,:,.......,:,...X------------------------------XX.........,....,..X---X,,.T....,....X--------
X.................................,....,....,.,.......,.,...X-------------------------------X.........,....,..X---X,,.....E,....X--------
X.................................,....,....,:,.......,:,...X-------------------------------X.........,....,..X---X,,,,,,,,,....X--------
X...............A.................,....,....,:,.......,:,...X-------------------------------X.........,....,..X---X,............X--------
X.................................,....,....,:,.......,:,...XXXXXXXXXXXXXXXXXXXXXXXXXXXXXXXXX.........,.A..,..X---X,,,,,,,,,,,,,X--------
X...:.............................,..A.,....,:,:..K..:,:,.............................................,....,..X---X.............X--------
X.................................,....,....,.,,,,,,,,,.,.............................................,....,..X---X.............X--------
X.................................,....,....,::.::::.:::,.............................................,....,..X---X.............X--------
X.................................,....,....,,,,,,,,,,,,,.............................................,....,..X---XXXXXXXXXXXXX.X--------
X.................................,....,...............................................XXXXXXXXX......,....,..X---------------X.X--------
X.................................,....,...........,,,...............,.................XXXXXXXXX......,....,..X---------------X.X--------
X.................................,....,...........,.,...............,,........,,,,,,,,:X...EX.X......,....,..X---------------X.X--------
X.................................,....,...........,..,..............,.,.......,,,,,,,,,L.E..X.X......,.H..,..XXXXXXXXXXXXXXXXX.X--------
X.................................,....,...........,..,..............,..,......,,,,,,,,,L...E..X......,....,....................X--------
X.................................,..H.,...........,...,,,,,,,,,,,,,,,...,.....,,,,,,,,,L.E...EX......,....,....................X--------
X................E................,....,...........,......................,....,,,,,,,,XX..EH..X......,....,....................X--------
X.................................,....,...........,.........:.............,...........:X.....EX......,....,....................X--------
X.................................,....,...........,......................,............XXXXXXXXX......,....,....................X--------
X.................................,....,...........,...,,,,,,,,,,,,,,,...,............................,....,....................X--------
X.................................,....,...........,...,.............,..,.............................,.A..,....................X--------
X.................................,....,...........,..,..............,.,..............................,....,....................X--------
X.................................,..A.,...........,..,..............,,...............................,....,....................X--------
X.A...............................,....,...........,,,...............,................................,....,......:.............X--------
X.................................,....,..............................................................,....,..................A.X--------
X.................................,....,,,,,,,,,,,,,,,,,,,,,,,,,,,,,,,,,,,,,,,,,,,,,,,,,,,,,,,,,,,,,,,,....,....................X--------
X,................................,........................................................................,...................,X--------
X.,,..............................,........................................................................,.................,,.X--------
X...,.............................,.........................................................A.....W.....H..,................,...X--------
X....,............................,.....A....H....A....H.......A......H......A.......H.....................,...............,....X--------
X.....,.......................,,,,,..H.....................................................................,..............,.....X--------
X......,,.....................,,,,,........................................................................,.............,......X--------
X........,....................,,,,,........................................................................,...........,,.......X--------
X.........,...................,,,,,,,,,,,,,,,,,,,,,,,,,,,,,,,,,,,,,,,,,,,,,,,,,,,,,,,,,,,,,,,,,,,,,,,,,,,,,,..........,.........X--------
X..........,.........................................................................................................,..........X--------
X...........,.......................................................................................................,...........X--------
X............,,...................................................................................................,,............X--------
X..............,.................................................................................................,..............X--------
X...............,...............................................................................................,...............X--------
X...W............,.............................................................................................,................X--------
X.................,,.........................................................................................,,.................X--------
X...................,.......................................................................................,...............W...X--------
X....................,.....................................................................................,....................X--------
X.....................,...................................................................................,.....................X--------
X...A.A.A..............,,................................................................................,......................X--------
X...A.A.A................,.............................................................................,,.......................X--------
X............A.AA.........,...........................................................................,...........A.A.A...AA.A..X--------
X...A.A.A..................,.........................................................................,..........................X--------
X............A.AA...........,.....A...........................A................................A....,.............A.A.A...AA.A..X--------
X............................,,...................................................................,,............................X--------
X..............................,.................................................................,........................AA.A..X--------
XXXXXXXXXXXXXXXXXXXXXXXXXXXXXXXXXXXXXXXXXXXXXXXXXXXXXXXXXXXXXXXXXXXXXXXXXXXXXXXXXXXXXXXXXXXXXXXXXXXXXXXXXXXXXXXXXXXXXXXXXXXXXXXXX--------
