XXX-------------------XXX--------------------------------------------
X.X-------------------X.X--------------------------------------------
XHX-------------------X.X--------------------------------------------
X.X-------------------XWX--------------------------------------------
X.X-------------------X.X--------------------------------------------
XEX-------------------X.X--------------------------------------------
X.X-------------------XEX--------------------------------------------
X.X-------------------X.X--------------------------------------------
X.X-------------------X.X--------------------------------------------
X+X-------------------X+X--------------------------------------------
X+XXXXXXXXXXXXXXXXXXXXX+X--------------------------------------------
X..........E....E.......X--------------------------------------------
X.,,,,,,,,,,,,,,,,,,,,,.X--------------------------------------------
X.,..................E,.X--------------------------------------------
X.,E,,,,,,,,,,,,,,,,,.,.X--------------------------------------------
X.,.,E.............E,.,.X--------------------------------------------
X.,.,...,,,,,,,,,...,.,.X--------------------------------------------
X.,.,...,.......,...,.,.X--------------------------------------------
X.,.,...ttt...K.,...,.,.X--------------------------------------------
X.,.,...t.t.....,...,.,.X--------------------------------------------
X.,.,...tt,,,,,,,...,.,.X--------------------------------------------
X.,.,...............,.,.X--------------------------------------------
X.,.,,,,,,,,,,,,,,,,,.,.X--------------------------------------------
X.,...................,.X--------------------------------------------
X.,,,,,,,,,,,,,,,,,,,,,.X--------------------------------------------
X.......................X--------------------------------------------
X.......................X--------------------------------------------
X.......................X--------------------------------------------
XXXXXXXXXXXXXXXXXXX,XXXXX--------------------------------------------
------------------X.X------------------------------------------------
------------------X.X------------------------------------------------
------------------X.X------------------------------------------------
------------------X.X------------------------------------------------
------------------X.X------------------------------------------------
------------------X.X------------------------------------------------
------------------X.X------------------------------------------------
------------------X.X------------------------------------------------
------------------X.X------------------------------------------------
------------------X.X------------------------------------------------
------------------X.X------------------------------------------------
------------------X.X------------------------------------------------
------------------XLX------------------------------------------------
----------------XXX,XXX----------------------------------------------
----------------X.....X----------------------------------------------
---------------X.......X---------------------------------------------
---------------X.......X---------------------------------------------
---------------X.......X---------------------------------------------
--------------X.........X--------------------------------------------
--------------X.........X--------------------------------------------
--------------X.........X--------------------------------------------
-------------X...E....E..X-------------------------------------------
-------------X...........X-------------------------------------------
-------------X...........X-------------------------------------------
------------X.............X------------------------------------------
------------X.............X------------------------------------------
------------X.............X------------------------------------------
-----------X...............X-----------------------------------------
-----------X...............X-----------------------------------------
-----------X...............X------XXXXXXXXXXXXXXX--------------------
----------X.................X-----X.............X--------------------
----------X.................X-----X.............X--------------------
---------X...................X----X.............X--------------------
---------X...................X----X.............X--------------------
--------X.....................X---X...,,>>,,....X--------------------
-------X....E.........E........X--X...,,,,,,....X--------------------
-------X.....................E.X--X...,,,,,,....X--------------------
------X.........................X-X...,,...,....X--------------------
------X.........E...............X-X...,,...,....X--------------------
------X...................E.....X-X...,,...,....X--------------------
------X.........................X-X...,,...,....X--------------------
------X.........................X-X...,,...,....X--------------------
------X.........................X-X...,,...,....X--------------------
------X.........................X-X...,,...,....X--------------------
------X..E....................E.X-X...,,,,,,....X--------------------
------X.........................X-X...,,,,,,....X--------------------
------X.........................X-X....:,.:.....X--------------------
------X.........................X-X....:,.:.....X--------------------
------X.........................X-X....:,.:.....X--------------------
------XXXXXXXXXXX,,,,,XXXXXXXXXXX-X....:,.:.....X--------------------
----------------X.....X-----------X....:,.:.....X--------------------
----------------X.....X-----------X....:,.:.....X--------------------
----------------X...H.X-----------X....:,,:.....X--------------------
----------------X.....X-----------XXXXXXXLXXXXXXX--------------------
----------------X.....X-----------------X.X--------------------------
----------------XXX,XXX-----------------X.X--------------------------
------------XX----X.X-------------------X.X--------------------------
--------XXXXXX----XAX-------------------XTX--------------------------
-----XXX-XXX------X.X-------------------X.X--------------------------
-----XXXX---------X.X-----------XXX-----X.X--------------------------
-------X-X--------X:X-----------XHX-----X.X--------------------------
-------X-X--------X.X-----------X.X-----XtX--------------------------
-----XXXX---------X.X-----------X.X-----X.X--------------------------
-----XX--XX-------XAX-----------X.X-----XXX--------------------------
-------XXX-XX-----X.X-----------X.X----------------------------------
----------XX-X----X.XXXXXXXXXXXXX,X---XXXXXXXXXXXXXXXXXXXXXXXXX------
------------XX----X.,...........,.X---X.,.........,.,..,.....EX------
------------------XXXXXXXXXXXXXXX,X---X.XXXXXXXXXXXXXXXXXXXXX,X------
-----XXXXXXXXX------------------X.X---X.X-------------------X.X------
-----XXXXXXXXX------------------X.X---X.X-------------------X.X------
--------------------------------X.X---X.X-------------------X.X------
-----XXX----XX------------------X.X---X.X-------------------X.X------
-----XXXX---XX------------------X.X---X.X-------------------X.X------
-----XX-XX--XX------------------X,XXXXX.XXXXXXX-------------X,XXXXXXX
-----XX--XX-XX------------------X..E........,.X-------------X.......X
-----XX---XXXX------------------XXXXXXX.XXXXX.X-----XXX-----XXXXXXX,X
-----XX----XXX------------------------X.X---X.X-----X<X-----------X.X
--------------------------------------X.X---X.X-----X<X-----------X.X
--------------------------------------X.X---X.X-----X.X-----------X.X
--------------------------------------X.X---X,XXXXXXX.X-----------X.X
--------------------------------------X.X---X......L,TX-----------X.X
----------------------------XXXXXXXXXXX.X---XXXXXXXXX.X-----------X.X
----------------------------X...,...,.,.X-----------X+X-----------XEX
----------------------------X,XXXXXXXXXXX---XXXXXXXXX+XXX---------X.X
----------------------------X,X-------------XT.........EX---------X.X
------XXXXXXXXXXX-----------X.X-------------XXX+XXXXXXXXX---------X.X
------X,,.....,,X-----------X.X---------------X.X-----------------X.X
------X:,.....:,X-----------X.X---------------XEX-XXXXXXXXXXXXXXXXX.X
------X.........X-----------X.X---------------X.X-X.t.........,...,.X
------X.........X-----------XEX---------------X.X-XXXXXXXXXXX,XXXXXXX
------X.........X-----------X.X---------------X+X-----------X.X------
------X.........XXXXXXXXXXXXX.X---XXXXXXXXXXXXX+XXXXXXXXXXX-X.X------
------X.........,...........,.X---X++++++++++++++++++++++,X-X.X------
------X.........XXXXXXXXXXXXXXX---X+....................+,X-X.X------
------X.........X-----------------X+....................+,X-X.X------
------X.........XXXXXX+-----------X+.........,,,,,......+,X-X.X------
------X...............+-----------X+.........,..,,......+,X-X.X------
------X...............XXXXXXX-----X+..E......,.W,,....E.+,X-XEX------
------X...................:,X-----X+.........,,,,,......+,X-X.X------
------X.............E.....,,X-----X+.........,,,,,......+,X-X.X------
------X...................,,X-----X+...........E........+,X-X.X------
------X...................:,X-----X++++++++++++++++++++++,X-X.X------
------X.....................X-----X,,,,,,,,,,,,,,,,,,,,,,,X-X.X------
------X...................:,X-----XXX+XXXXXXXXXXXXXXXXXXXXX-X.X------
------X................:..:,X-------X.X---------------------X.X------
------X...................,,X-------X.X--------XXXXXXXXXXXXXX,XXX----
------X...................,,X-------X.X--------X.H..............X----
------X...................:,X-------X.X--------Xttt...E.........X----
------X.....................X-------X.X--------Xt.t..........A..X----
------X...................:,X-------X.X--------Xttt.............X----
------X.............E.....,,X-------X.X--------X......E.........X----
------X....E..........XXXXXXX-------X.X--------X.H..XXXXXXXXXXXXX----
------X:.......:......X-------------X.X--------X.XXX-----------------
------X,,,,,,,,,XXXXXXX-------XXX---X.X--------XX--------------------
------X.........X-------------X.tX--X.X------------------------------
------XE.E..E..EX------------Xttt.X-X.X-XX---------------------------
------X.........X------------X....X-X+X-XEXXX------------------------
------X....H..E.X-----------X.....XXX+XXX....XX----------------------
------XK.E......X-----------X.....,.....,.....X----------------------
------XXXXXXXXXXX-----------X.....,.....,.....X----------------------
----------------------------X.....,.....,.....X----------------------
----------------------------X.....,.....,.....X----------------------
----------------------------X.....,.....,.....X----------------------
----------------------------X.....,.,,,.,.....X----------------------
----------------------------X,,,,,,.,.,.,,,,,.X----------------------
----------------------------XX,,,,XXX+XXX,,,XXX----------------------
-----------------------------XE.E.X-X+X-XE.EX------------------------
-----------------------------X....X-X.X-X...X------------------------
-----------------------------XE.E.X-X.X-XE.EX------------------------
----------------------XXX----X....X-X.X-X...X------------------------
----------------------XEX----XE.E.X-X.X-XE.EX------------------------
----------------------X.X----X....X-X.X-X...X------------------------
----------------------X.X----X.E.EX-X.X-XE.EX------------------------
----------------------X.X----X....X-X.X-X....X-----------------------
----------------XXXXXXX.X---X.E.E..XX.XX..E.EX-----------------------
----------------X.......X---X.....XXX.XXX.....X----------------------
----------------X.XXXXX.X----X.T.X--X.X--X.E.X-----------------------
----------------X.X---X.X-----XXX---X,X---XXX------------------------
----------------X.X---X.X-----------X,X------------------------------
----------------X.X---X.XXXXXXXXXXXXX,XXXXXXXXXXX--------------------
----------------X.X---X..........H............E.X--------------------
----------------X.X---XXXXXXXXXXXXXXXXX.XXXXXXXXX--------------------
----------------X.X-----XXXXXXXXX-----X.XXXXXXXXXX-------------------
----------------X+X-----X.......X-----X..........X-------------------
------------XXXXX+XXXXX-X.XXXXX.X-----XXXXXXX.XXAX-------------------
------------X.E.....E.X-X.X---X.XXXXXXXXXX--X.XXAX-------------------
------------X...,,,...X-X.X---XE.........X--X.XXAX-------------------
------------X...,.,...X-X.X---XXXXXXXXXX.X--X.XXAX-------------------
------------X...,.,...X-X.XXXXXXXXXXXXXX.X--X.XXAX-------------------
------------X...,.,...X-X....XXH.........X--X.XXXX-------------------
------------X...,.,...X-XXXX.XX.XXXXXXXXXX--X.X----------------------
------------X...,.,...X----X.XX.X---XXXXXXXXX.X----------------------
------------X...,.,...X----X.XX.XXXXX.........X----------------------
------------X...,.,...X----X.XX.......XXXXXXXXX----------------------
------------X...+++...X----X.XXXXXXXX.XXXXXXXXX----------------------
------------X...,.,...X----X.X------X.........X----------------------
------------X...,.,...X----X.X------XXXXXXXXX.X----------------------
------------XXX.,.,.XXXXXXXX.XXXXX-----XXX--X.X----------------------
------------XXX.,A,.XXXX....H....X---XX...XXX.X----------------------
------------XXX.,.,.XXXX.XXX.XXX.X--X.........X----------------------
------------X...,.,...XX.X-X.X-X.X--X.........X----------------------
------------X...,A,...XX.X-X.X-X.X-X..H.....XXX----------------------
------------X...,.,...XX.X-X.X-X.X-X........X------------------------
------------X...,,,...XX.X-X.X-X.X-X........X------------------------
------------X.........XXAX-XHX-XAX-X.......X-------------------------
------------X,,,,,,,,,XXXX-XXX-XXX--X..E...X-------------------------
---------XXXX,,,,,,,,,XXXX-----------XX...X--------------------------
---------X.......H.......X-------------XXX---------------------------
---------X...............X-------------------------------------------
---------X.E...........E.X-------------------------------------------
---------X.......K.......X-------------------------------------------
---------X...............X-------------------------------------------
---------X....W......H...X-------------------------------------------
---------X...............X-------------------------------------------
---------XXXXXXXXXXXXXXXXX-------------------------------------------
