--------------XXXXXX---------------------------------------------------
--------------X..H..X--------------------------------------------------
--------------X.....X---XXXXXXXXXXXXX----------------------------------
--------------X.....X---X,,,,,,,,,,:X----------------------------------
--------------X.....X---X.....,XXX,,X----------------------------------
--------------X..E..X---X.E...,..X,,X----------------------------------
--------------X.....X---X.....,X.XX,X----------------------------------
--------------XX+++XX---X...,XXX.XX,X----------------------------------
XXXXXXXXXX--XXXXLLLXXXX-X..,XX..EXX,X----------------------------------
X........HXX:.XX.:.X..:XX..X:....XXHX----------------------------------
X.XXXXXXX+XX...........XX,XX.....:X,X----------------------------------
X.X-XXXXX,XX..XX...X...XXXX.....XX.AX----------------------------------
X.XX......XX..XX,,,XX.XX:.......X,.,X----------------------------------
X.X.......+...,....,...+......XX,A.AX----------------------------------
XH,,....E.+...,..K.,...+....XXX,...,X----------------------------------
X.X,......+...,....,...+...XX,.A.A.AX----------------------------------
X.XX......XX..X....XX.XXX..X.......,X----------------------------------
X.X-XXXXXXXX..XX,,,XX..X:XX,.A.A.A.AX----------------------------------
X.XXXXXXXX-X...........XXX,H.......,X----------------------------------
X.........XX:....H....:XXH...A.A.A.AX----------------------------------
XXXXXXXX..X-XXXX+++XXXX-XXXXXXXXX,,,X----------------------------------
--------X.X----X+++XXXXXXXXXXXXXX,,,XXXXXXXXXXXXXXXXXXX----------------
XXXXXXXXX.X----X,<.,.t.,......<XX,,,XX,,,,XX,,,,XX,,,,X----------------
XX.....:..X----X,,.,W,,,,,,,,,,XX..,XX,XX,XX,XX,XX...,X----------------
X+,,,,,X,,X----X,,.,.t.,.......XX.:,XX,XX,XX,XX,XX.H.,X----------------
X,,,,,,XX,X----X,,.XXXXXXXXX.A.XX..,,,,XX,,,,XX,,,...,X----------------
XK.E.EEXX.X----X,,.XXXXXXXXX,,,XXXXXXXXXXXXXXXXXXXX,,,X----------------
XXXXXXXXXHX----X,,.,+E.EE.XX,,.X------------------X,,,XX---------------
-------->>X----X,,.XX.....XX,,.X----------------XX,,,,,,XX-------------
---------------X,,.XXE.TE.XX,,.X--------------XX,,...H,.,,XX-----------
---------------X,,.XX.....XX,,.X------------XX,,.....,,...,.X----------
---------------X,,.XXE.EE.XX,,.X-----------X.,..T....,,....,X----------
---------------X,,,XXXX,XXXX,,.X----------X.,,......,.,...T.,X---------
---------------X.,.XXXXXXXXX,,.X----------X.H,,,....,.,.....,X---------
---------------X.A.......,,.,,.X---------X.,..,.,,.,..,......,X--------
---------------X,,,,,,,,,,.,A,.X---------X.,...,..,,..,......,X--------
---------------<.........,,.,,<X--XXXXXXXX,.....,.....,,,.....,XXXXXXXX
---------------XXXXXXXXXXXXXXXXX--Xtttttt,,......,.......,,,,.,,ttttttX
----------------------------------XtEttEt,,.T.....,.W........H,,tEttEtX
----------------------------------Xtttttt,,......,.......,,,,.,,ttttttX
----------------------------------XXXXXXXX,.....,.....,,,.....,XXXXXXXX
-----------------------------------------X,....,..,,..,.......,X-------
-----------------------------------------X.,..,.,,.,..,......,X--------
-----------------------------------------X.,.,,,....,.,......,X--------
------------------------------------------X.H,......,.,...T.,X---------
-------------------------------------------X.,..T....,,....,.X---------
--------------------------------------------X.,,.....,,...,.X----------
--------------------------------------------X,..,,...H,.,,.,X----------
--------------------------------------------X.,,..,,,,,,..,.X----------
--------------------------------------------XtttXXX,,,XXXtttX----------
--------------------------------------------XtEtX-XtttX-XtEtX----------
--------------------------------------------XtttX-XtEtX-XtttX----------
--------------------------------------------XtttX-XtttX-XtttX----------
--------------------------------------------XtEtX-XtttX-XtEtX----------
--------------------------------------------XtttX-XtEtX-XtttX----------
--------------------------------------------XXXXX-XtttX-XXXXX----------
--------------------------------------------------XXXXX----------------
