-------------------------------------------------------------------------------------XXXXXXXXXXXX---------------------------------------------------------------
----------------------------------------------------------------------------------XXX............XX-------------------------------------------------------------
---------------------------------------------------------------------------------X.................X------------------------------------------------------------
--------------------------------------------------------------------------------X...................X-----------------------------------------------------------
-----------------------------------------------------------------------------XXX.....................XXX--------------------------------------------------------
-----------------------------------------------------------------------------X.,.....................,.X--------------------------------------------------------
-----------------------------------------------------------------------------X.,.....................,.X--------------------------------------------------------
-----------------------------------------------------------------------------X,.......................,X--------------------------------------------------------
-----------------------------------------------------------------------------X,.......................,X--------------------------------------------------------
-----------------------------------------------------------------------------X,.......................,X--------------------------------------------------------
-----------------------------------------------------------------------------X,.......................,X--------------------------------------------------------
-----------------------------------------------------------------------------X.,.....................,.X--------------------------------------------------------
-----------------------------------------------------------------------------XXX.....................XXX--------------------------------------------------------
--------------------------------------------------------------------------------X...................X-----------------------------------------------------------
---------------------------------------------------------------------------------X.................X------------------------------------------------------------
----------------------------------------------------------------------------------XXX............XX-------------------------------------------------------------
--------------------------------------------------------------------------------XXXXXXX...A...XXXXXXXX----------------------------------------------------------
-----------------------------------------------------------------------------XXX.........XXX..........XX--------------------------------------------------------
----------------------------------------------------------------------------X...........................X-------------------------------------------------------
---------------------------------------------------------------------------X.............................X------------------------------------------------------
------------------------------------------------------------------------XXX...............................XXX---------------------------------------------------
------------------------------------------------------------------------X.,...............................,.X---------------------------------------------------
------------------------------------------------------------------------X.,...............................,.X---------------------------------------------------
------------------------------------------------------------------------X,.................................,X---------------------------------------------------
------------------------------------------------------------------------X,.................................,X---------------------------------------------------
------------------------------------------------------------------------X,.................................,X---------------------------------------------------
------------------------------------------------------------------------X,.................................,X---------------------------------------------------
------------------------------------------------------------------------X.,...............................,.X---------------------------------------------------
------------------------------------------------------------------------XXX...............................XXX---------------------------------------------------
---------------------------------------------------------------------------X.............................X------------------------------------------------------
----------------------------------------------------------------------------X...........................X-------------------------------------------------------
-----------------------------------------------------------------------------XXX.........+XX..........XX--------------------------------------------------------
--------------------------------------------------------------------------------XXXXXXX...W...XXXXXXXX----------------------------------------------------------
----------------------------------------------------------------------------------XXX............XX-------------------------------------------------------------
------------------------------------------------------------------X>>>X----------X.................X------------------------------------------------------------
-----------------------------------------------------------------XX,,,,X--------X...................X-----------------------------------------------------------
----------------------------------------------------------------XXX,,,,XX----XXX.....................XXX--------------------------------------------------------
-------------------------------------------------------------XXXXXX,,,,XXXXX-X.,.....................,.X--------------------------------------------------------
-------------------------------------------------------------X.,.........,.X-X.,.....................,.X--------------------------------------------------------
-------------------------------------------------------------X.,.........,.X-X,.......................,X--------------------------------------------------------
-------------------------------------------------------------X,...........,X-X,.......................,X--------------------------------------------------------
-------------------------------------------------------------X,...........,X-X,.......................,X--------------------------------------------------------
-------------------------------------------------------------X,...........,X-X,.......................,X--------------------------------------------------------
-------------------------------------------------------------X,...........,X-X.,.....................,.X--------------------------------------------------------
-------------------------------------------------------------X.,.........,.X-XXX.....................XXX--------------------------------------------------------
-------------------------------------------------------------XXX.........XXX----X...................X-----------------------------------------------------------
----------------------------------------------------------------X.......X--------X.................X------------------------------------------------------------
-----------------------------------------------------------------X.....X----------XXX............XX-------------------------------------------------------------
------------------------------------------------------------------X,,,X--------------XXXX,,,XXXXX---------------------------------------------------------------
------------------------------------------------------------------X...X-----------------X...X-------------------------------------------------------------------
--------------------XXXXXXXXX-------------------------------------X...X-----------------X...X-------------------------------------------------------------------
--------------------X..,,,,.X-------------------------------------X...X-----------------X...X-------------------------------------------------------------------
--------------------X,,....,X-------------------------------------X...X-----------------X...X-------------------------------------------------------------------
-------------------X.........X------------------------------------X...X-----------------X...X-------------------------------------------------------------------
------------------X...........X-----------------------------------X...X-----------------X...X-------------------------------------------------------------------
----XXXXXXXXX----X.............X----XXXXXXXXX---------------------X...X-----------------X...X-------------------------------------------------------------------
----X..,,,,.X----X.............X----X..,,,,.X---------------------X...XXXXXXXXXXXXXXXXXXX...X-------------------------------------------------------------------
----X,,....,X----X.............X----X,,....,X---------------------X...XX+++.........+++XX...X-------------------------------------------------------------------
---X.........X--X...............X--X.........X--------------------X...XX+H...........H.XX...X-------------------------------------------------------------------
--X...........X-X...............X-X...........X-------------------X...XXX..............XX...X-------------------------------------------------------------------
-X.............XX...............XX.............X--------------XXXXX...XX...............XX...X-------------------------------------------------------------------
-X.............XX...............XX.............X--------------X...,...XX...E.....E.....XX...X--------------------XXXXXXXXX--------------------------------------
-X.............XX...............XX.............X--------------X.:.,...XX..E...E.....E..XX...X-XXXXX--------------X..,,,,.X--------------------------------------
X...............X...............X...............X-------------X...,...XX...............XX...X-X...X--------------X,,....,X--------------------------------------
X...............X...............X...............X-------------XXXXX+++XX,,,,,,,,,,,,,,,XX,,,X-X.H.X-------------X........XX-------------------------------------
X...............................................X-----------------X,,,XX,,,,,,,,,,,,,,,XX,,,X-X...X------------X.........XXX------------------------------------
X...............................................XXXXXXXXXXXXXXXXXX<...+.................+...<XX,,,XXXXXXXXXXXXX..........XXXX-----------------------------------
X................+.............+................,...............,,...+...................+...,,...............,..........,,,>X----------------------------------
X...............A+.............XW...............,...............,,..+.....................+..,,...............,..........,,,>-----------------------------------
X................+.............X................,...............,,.+.......................+.,,...............,..........,,,XX----------------------------------
X...............................................XXXXXXXXXXXXXXXXXX+.........................+XXXXXXXXXXXXXXXXXX..........,,,X-----------------------------------
X...............................................X-------XXXXXXXXXX...........................XXXXXXXXXX--------X.........XXX------------------------------------
X...............X...............X...............X-------X+++....,,...........................,,....++XX---------X........XX-------XXXXXXXXX---------------------
X...............X...............X...............X-------X+H.....,,...........................,,.....H.X----------X,,....,X--------X..,,,,.X---------------------
X...............X...............X...............X-------XX...E..,,...........................,,.E.....X----------X..,,,,.X--------X,,....,X---------------------
-X.............XX...............XX.............X--------X.......,,...........................,,.......X----------XXXXXXXXX-------X.........X--------------------
-X.............XX...............XX.............X--------X.......,,...........................,,...E...X-------------------------X...........X-------------------
--X...........X-X...............X-X...........X---------X...E...,,...........................,,.......X-----------XXXXXXXXX----X.............X----XXXXXXXXX-----
---X.........X--X...............X--X.........X----------X.......,,...........................,,..E....X-----------X..,,,,.X----X.............X----X..,,,,.X-----
----X,,....,X---X...............X---X,,....,X-----------X.......,,.............E.............,,.......X-----------X,,....,X----X.............X----X,,....,X-----
----X..,,,,.X----X.............X----X..,,,,.X-----------X....E..,,...........................,,.......X----------X.........X--X...............X--X.........X----
----XXXXXXXXX----X.............X----XXXXXXXXX-----------X.......,,...........................,,...E...X---------X...........X-X...............X-X...........X---
------------------X...........X-------------------------X...E...,,...........................,,.......X--------X.............XX...............XX.............X--
-------------------X.........X-------XXXXXXXXX----------X.......,,...........................,,.......X--------X.............XX...............XX.............X--
--------------------X,,....,X--------X..,,,,.X----------XX....E.,,...........................,,..E....X--------X.............XX...............XX.............X--
--------------------X..,,,,.X--------X,,....,X----------X+H.....,,...........................,,.....H.X-------X...............X...............X...............X-
--------------------XXXXXXXXX-------XX........X---------XX......,,...........................,,.......X-------X...............X...............X...............XX
-----------------------------------XXX.........X--------XXXXXXXXXX...........................XXXXXX+++X-------X...............................................,X
----------------------------------XXXX..........XXXXXXXXXXXXXXXXXX+.........................+XXXXXXXXXXXXXXXXXX...............................................,X
---------------------------------->,,,..........,...............+,.+.......................+.,+...............,................X.............+................,X
---------------------------------->,,,..........,...............+,..+.....................+..,+...............,...............:X.............+A...............,X
---------------------------------->,,,..........,...............+,...+...................+...,+...............,................+.............+................,X
----------------------------------X,,,..........XXXXXXXXXXXXX,,,XX<...+.................+...<XXXXXXXXXXXXXXXXXX...............................................,X
-----------------------------------XXX.........X------------X,,,X-X,,,XX,,,,,,,,,,,,,,,XX,,,X-----------------X...............................................,X
------------------------------------XX........X-------------X...X-X+++XX,,,,,,,,,,,,,,,XX,,,XXXXXX------------X...............X...............X...............XX
-------------------------------------X,,....,X--------------X.H.X-X...XX...............XX...,,...X------------X...............X...............X...............X-
-------------------------------------X..,,,,.X--------------X...X-X...XX............E..XX...,,.:.X------------X...............X...............X...............X-
-------------------------------------XXXXXXXXX--------------XXXXX-X...XX..E.....E......XX...,,...X-------------X.............XX...............XX.............X--
------------------------------------------------------------------X...XX.....E....E....XX...XXXXXX-------------X.............XX...............XX.............X--
------------------------------------------------------------------X...XXX..............XX...X-------------------X...........X-X...............X-X...........X---
------------------------------------------------------------------X...XX+H...........H.XX...X--------------------X.........X--X...............X--X.........X----
------------------------------------------------------------------X...XXX..............XX...X---------------------X,,....,X---X...............X---X,,....,X-----
------------------------------------------------------------------X...XXXXXXXXXXXXXXXXXXX...X---------------------X..,,,,.X----X.............X----X..,,,,.X-----
------------------------------------------------------------------X...X-----------------X...X---------------------XXXXXXXXX----X.............X----XXXXXXXXX-----
------------------------------------------------------------------X...X-----------------X...X-----------------------------------X...........X-------------------
------------------------------------------------------------------X...X-----------------X...X------------------------------------X.........X--------------------
------------------------------------------------------------------X...X-----------------X...X-------------------------------------X,,....,X---------------------
------------------------------------------------------------------X...X-----------------X...X-------------------------------------X..,,,,.X---------------------
------------------------------------------------------------------X...X-----------------X...X-------------------------------------XXXXXXXXX---------------------
------------------------------------------------------------------X...X-----------------X...X-------------------------------------------------------------------
---------------------------------------------------------------XXXX,,,XXXXX-------------X,,,X-------------------------------------------------------------------
------------------------------------------------------------XXX............XX----------X.....X------------------------------------------------------------------
-----------------------------------------------------------X.................X--------X.......X-----------------------------------------------------------------
----------------------------------------------------------X...................X----XXX.........XXX--------------------------------------------------------------
-------------------------------------------------------XXX.....................XXX-X.,.........,.X--------------------------------------------------------------
-------------------------------------------------------X.,.....................,.X-X.,.........,.X--------------------------------------------------------------
-------------------------------------------------------X.,.....................,.X-X,...........,X--------------------------------------------------------------
-------------------------------------------------------X,.......................,X-X,...........,X--------------------------------------------------------------
-------------------------------------------------------X,.......................,X-X,...........,X--------------------------------------------------------------
-------------------------------------------------------X,.......................,X-X,...........,X--------------------------------------------------------------
-------------------------------------------------------X,.......................,X-X.,.........,.X--------------------------------------------------------------
-------------------------------------------------------X.,.....................,.X-XXXXXX,,,,XXXXX--------------------------------------------------------------
-------------------------------------------------------XXX.....................XXX----XXX,,,,XX-----------------------------------------------------------------
----------------------------------------------------------X...................X--------XX,,,,X------------------------------------------------------------------
-----------------------------------------------------------X.................X----------XX>>X-------------------------------------------------------------------
------------------------------------------------------------XXX............XX------------X-X--------------------------------------------------------------------
----------------------------------------------------------XXXXXXX...W...XXXXXXXX--------------------------------------------------------------------------------
-------------------------------------------------------XXX.........XX+..........XX------------------------------------------------------------------------------
------------------------------------------------------X...........................X-----------------------------------------------------------------------------
-----------------------------------------------------X.............................X----------------------------------------------------------------------------
--------------------------------------------------XXX...............................XXX-------------------------------------------------------------------------
--------------------------------------------------X.,...............................,.X-------------------------------------------------------------------------
--------------------------------------------------X.,...............................,.X-------------------------------------------------------------------------
--------------------------------------------------X,.................................,X-------------------------------------------------------------------------
--------------------------------------------------X,.................................,X-------------------------------------------------------------------------
--------------------------------------------------X,.................................,X-------------------------------------------------------------------------
--------------------------------------------------X,.................................,X-------------------------------------------------------------------------
--------------------------------------------------X.,...............................,.X-------------------------------------------------------------------------
--------------------------------------------------XXX...............................XXX-------------------------------------------------------------------------
-----------------------------------------------------X.............................X----------------------------------------------------------------------------
------------------------------------------------------X...........................X-----------------------------------------------------------------------------
-------------------------------------------------------XXX.........XXX..........XX------------------------------------------------------------------------------
----------------------------------------------------------XXXXXXX...A...XXXXXXXX--------------------------------------------------------------------------------
------------------------------------------------------------XXX............XX-----------------------------------------------------------------------------------
-----------------------------------------------------------X.................X----------------------------------------------------------------------------------
----------------------------------------------------------X...................X---------------------------------------------------------------------------------
-------------------------------------------------------XXX.....................XXX------------------------------------------------------------------------------
-------------------------------------------------------X.,.....................,.X------------------------------------------------------------------------------
-------------------------------------------------------X.,.....................,.X------------------------------------------------------------------------------
-------------------------------------------------------X,.......................,X------------------------------------------------------------------------------
-------------------------------------------------------X,.......................,X------------------------------------------------------------------------------
-------------------------------------------------------X,.......................,X------------------------------------------------------------------------------
-------------------------------------------------------X,.......................,X------------------------------------------------------------------------------
-------------------------------------------------------X.,.....................,.X------------------------------------------------------------------------------
-------------------------------------------------------XXX.....................XXX------------------------------------------------------------------------------
----------------------------------------------------------X...................X---------------------------------------------------------------------------------
-----------------------------------------------------------X.................X----------------------------------------------------------------------------------
------------------------------------------------------------XXX............XX-----------------------------------------------------------------------------------
---------------------------------------------------------------XX,,,,,,,XXX-------------------------------------------------------------------------------------
----------------------------------------------------------------XXXXXXXXX---------------------------------------------------------------------------------------
