--------------------------------XXXXXXXXXXXXXXXXXXXXXXXXXXXXXXXXXXXXXXXXXXXXXXXXX----------------
--------------------------------X...............................................X----------------
--------------------------------X.A...........................................A.X----------------
--------------------------------X...............................................X----------------
--------------------------------X.........E....E................................X----------------
--------------------------------X.......E...........EE.....E........E...........X----------------
--------------------------------X...............................................X----------------
--------------------------------X.........................................E.....X----------------
--------------------------------X.......,,,,,,,,,...............,,,,,,,,,.......X----------------
--------------------------------X.......,.......,...............,.......,.......X----------------
--------------------------------X.......,.......,...............,.......,.......X----------------
--------------------------------X.......,.......,...............,.......,.......X----------------
--------------------------------X.......,.......,.....E....E....,.......,.E.....X----------------
--------------------------------X.......,.......,...............,.......,.......X----------------
--------------------------------X....E..,.......,....E..........,.......,.......X----------------
--------------------------------X.......,.......,...............,.......,.......X----------------
--------------------------------X.......,,,,,,,,,........E......,,,,,,,,,.......X----------------
--------------------------------X...............................................X----------------
--------------------------------X.......................................E.......X----------------
--------------------------------X.......E........................E...E..E.......X----------------
--------------------------------X...............E...............................X----------------
--------------------------------X...............................................X----------------
--------------------------------X...............................................X----------------
--------------------------------X.............E.................................X----------------
--------------------------------X...T...................A............E..........X----------------
--------------------------------X................................E..............X----------------
--------------------------------X...............................................X----------------
--------------------------------X...............................................X----------------
--------------------------------X....E....E.....................................X----------------
--------------------------------X................E..........E..............E....X----------------
--------------------------------X...............................................X----------------
--------------------------------X...............................................X----------------
--------------------------------X.......,,,,,,,,,...............,,,,,,,,,..E....X----------------
--------------------------------X.......,.......,...............,.......,.......X----------------
--------------------------------X..E....,.ttttt.,........E......,.......,.......X----------------
--------------------------------X.......,.t...t.,..E............,.......,.......X----------------
--------------------------------X.......,.t.E.t.,...............,.......,.......X----------------
--------------------------------X.......,.t...t.,...............,.......,.......X----------------
--------------------------------X.......,.ttttt.,...............,.......,.......X----------------
--------------------------------X.......,.......,...............,.......,.......X----------------
--------------------------------X.......,,,,,,,,,...............,,,,,,,,,...E...X----------------
--------------------------------X...............................................X----------------
--------------------------------X.....E.................E.......................X----------------
--------------------------------X.......................................E.......X----------------
--------------------------------X..............E.....E...............E..........X----------------
--------------------------------X...............................................X----------------
--------------------------------X.A...........................................A.X----------------
--------------------------------X...............................................X----------------
--------------------------------XXXXXXXXXXXXXXXXXXXXXXXXXXXXXXXXXXXXXXXXXXXXXXXXX----------------
-------------------------------------------------------------------------------------------------
-------------------------------------------------------------------------------------------------
-------------------------------------------------------------------------------------------------
-------------------------------------------------------------------------------------------------
-------------------------------------------------------------------------------------------------
-------------------------------------------------------------------------------------------------
-------------------------------------------------------------------------------------------------
------------------------XXXXXXXXXXXXXXXXXXXXXXXXXXXXXXXXXXXXXXXXXXXXXXXXXXXXXXXXX----------------
------------------------X.......................................................X----------------
------------------------X.......................................................X----------------
------------------------X.......................................................X----------------
------------------------X.......................................................X----------------
------------------------X.......................................................X----------------
------------------------X.......................................................X----------------
------------------------X.......................................................X----------------
------------------------X.......,,,,,,,,,...........H...........,,,,,,,,,.......X----------------
------------------------X.......,.......,.......................,.......,.......X----------------
------------------------X.......,.......,.......................,.......,.......X----------------
------------------------X.......,.......,.......................,.......,.......X----------------
------------------------X.......,...E...,.......................,...E...,.......X----------------
------------------------X.......,.......,.......................,.......,.......X----------------
------------------------X.......,.......,.......................,.......,.......X----------------
------------------------X.......,.......,.......................,.......,.......X----------------
------------------------X.......,,,,,,,,,.......,,,,,,,,,.......,,,,,,,,,.......XXXXXXXXXXXXXXXXX
------------------------X.......................,.......,.......................,...............X
------------------------X.......................,.......,.......................,...............X
------------------------X.......................,.......,.......................,...............X
------------------------X...T...................,...E...,.......................,...E.......E...X
------------------------X.......................,.......,.......................,...............X
------------------------X.......................,.......,.......................,...............X
------------------------X.......................,.......,.......................,...............X
------------------------X.......,,,,,,,,,.......,,,,,,,,,.......,,,,,,,,,.......XXXXXXXXXXXXXXXXX
------------------------X.......,.......,.......................,.......,.......X----------------
------------------------X.......,.......,.......................,.......,.......X----------------
------------------------X.......,.......,.......................,.......,.......X----------------
------------------------X.......,...E...,.......................,...E...,.......X----------------
------------------------X.......,.......,.......................,.......,.......X----------------
------------------------X.......,.......,.......................,.......,.......X----------------
------------------------X.......,.......,.......................,.......,.......X----------------
------------------------X.......,,,,,,,,,...........H...........,,,,,,,,,.......X----------------
------------------------X.......................................................X----------------
------------------------X.......................................................X----------------
------------------------X.......................................................X----------------
------------------------X.......................................................X----------------
------------------------X.......................................................X----------------
------------------------X.......................................................X----------------
------------------------X.......................................................X----------------
------------------------XXXXXXXXXXXXXXXXXXXXXXXXXXXXXXXXXXXXXXXXXXXXXXXXXXXXXXXXX----------------
-------------------------------------------------------------------------------------------------
-------------------------------------------------------------------------------------------------
-------------------------------------------------------------------------------------------------
-------------------------------------------------------------------------------------------------
-------------------------------------------------------------------------------------------------
-------------------------------------------------------------------------------------------------
-------------------------------------------------------------------------------------------------
------------------------XXXXXXXXXXXXXXXXXXXXXXXXXXXXXXXXXXXXXXXXXXXXXXXXX------------------------
------------------------X...............................................X------------------------
------------------------X...............................................X------------------------
------------------------X...............................................X------------------------
------------------------X...H.......................................H...X------------------------
------------------------X...............................................X------------------------
------------------------X.....,,,,,,,.......................,,,,,,,.....X------------------------
------------------------X.....,.....,.......................,.....,.....X------------------------
------------------------X.....,.....,.......................,.....,.....X------------------------
------------------------X.....,..E..,.......................,..E..,.....X------------------------
------------------------X.....,.....,.........,,t,,.........,.....,.....X------------------------
------------------------X.....,.....,.........,Tt.,.........,.....,.....X------------------------
------------------------X.....,,,,,,,.........ttt.,.........,,,,,,,.....X------------------------
------------------------X.....................,...,.....................X------------------------
------------------------X.....................,...,.....................X------------------------
------------------------X.....................,...,.....................X------------------------
------------------------X.....................,...,.....................X------------------------
------------------------X.....................,...,.....................X------------------------
------------------------X.....................,...,.....................X------------------------
------------------------X.....................,...,.....................X------------------------
------------------------X...................XXX,,,XXX...................X------------------------
------------------------X...................XX.....XX...................X------------------------
------------------------X.........,,,,,,,,,,X.......X,,,,,,,t,,.........X------------------------
------------------------X.........,.........,.......,.......tT,.........X------------------------
XXXXX-------------------X.........ttt.......,...T...,.......ttt.........X------------------------
X...X-------------------X.........,Tt.......,.......,.........,.........X------------------------
X.T.X-------------------X.........,,t,,,,,,,X.......X,,,,,,,,,,.........X------------------------
X.:.X-------------------X...................XX.....XX...................X------------------------
XtttX-------------------X...................XXX,,,XXX...................X------------------------
X...X-------------------X.....................,...,.....................X------------------------
X.W.X-------------------X.....................,...,.....................X------------------------
X...X-------------------X.....................,...,.....................X------------------------
X...X-------------------X.....................,...,.....................X------------------------
X...X-------------------X.....................,...,.....................X------------------------
X.W.X-------------------X.....................,...,.....................X------------------------
X...X-------------------X.....................,...,.....................X------------------------
X...X-------------------X.....ttttttt.........,.ttt.........,,,,,,,.....X------------------------
X...X-------------------X.....t.....t.........,.t.,.........,.....,.....X------------------------
X.W.X-------------------X.....t.....t.........,,t,,.........,.....,.....X------------------------
X...X-------------------X.....t..E..t.......................,..E..,.....X------------------------
X...X-------------------X.....t.....t.......................,.....,.....X------------------------
X...X-------------------X.....t.....t.......................,.....,.....X------------------------
X.W.X-------------------X.....ttttttt.......................,,,,,,,.....X------------------------
X...X-------------------X...............................................X------------------------
X...X---XXXXXXXXXXXXX---X...H.......................................H...X------------------------
X...X---X.........tTX---X...............................................X------------------------
X.W.X---X.:.:.:.:.ttX---X...............................................X------------------------
X...X---X...........X---X...............................................X------------------------
X...X---X.:.:.:.:.:.X---XXXXXXXXXXXXXXXXXXXXXXXXXXXXXXXXXXXXXXXXXXXXXXXXX------------------------
X...X---X...........X----------------------------------------------------------------------------
X.W.X---X.:.:.:.:.:.X----------------------------------------------------------------------------
X...X---X...........X----------------------------------------------------------------------------
X...X---X.:.:.:.:.:.X----------------------------------------------------------------------------
X...X---X...........X----------------------------------------------------------------------------
X.W.X---X.:.:.:.:.:.X----------------------------------------------------------------------------
X...X---X...........X----------------------------------------------------------------------------
X...X---XXXXXXXXXXXXX-------XXXXXXXXXXXXXXXXXXXXXXXXXXXXXXXXX------------------------------------
X...X-----------------------X...............................X------------------------------------
X.H.X-----------------------X...........................,,,.X------------------------------------
X...X-----------------------X...................:.......,.,.X------------------------------------
X...X-----------------------X.<.............W...........,,,.X------------------------------------
X...X-----------------------X...............................X------------------------------------
X.H.X-----------------------X.....,,,,,,,,,,,,,,,,,,,,,.....X------------------------------------
X...X-----------------------X.....,XX...............XX,.....X------------------------------------
XtttX-----------------------X.....,XXXX,,,,,,,,,,,XXXX,.....X------------------------------------
X.:.X-----------------------X.....,.X...............X.,.....X------------------------------------
X.T.X-----------------------X.....,.X...............X.,.....X------------------------------------
X...X-----------------------X.....,.,...............,.,.....X------------------------------------
XXXXX-----------------------X.....,.,.....,,,,,.....,.,.....X------------------------------------
----------------------------X.....,.,.....,...,.....,.,.....X------------------------------------
----------------------------X.....,.,....,ttttt,....,.,.....X------------------------------------
----------------------------X.....,.,....,t,.,t,....,.,.....X------------------------------------
----------------------------X.<...,.,...,,t,,,t,,...,.,.T...X------------------------------------
----------------------------X.....,.,...,.t.,.t.,...,.,.....X------------------------------------
----------------------------X.....,.,....,ttttt,....,.,.....X------------------------------------
----------------------------X.....,.,....,.,.,.,....,.,.....X------------------------------------
----------------------------X.....,.,.....,,,,,.....,.,.....X------------------------------------
----------------------------X.....,.,...............,.,.....X------------------------------------
----------------------------X.....,.X...............X.,.....X------------------------------------
----------------------------X.....,.X...............X.,.....X------------------------------------
----------------------------X.....,XXXX,,,,,,,,,,,XXXX,.....X------------------------------------
----------------------------X.....,XX...............XX,.....X------------------------------------
----------------------------X.....,,,,,,,,,,,,,,,,,,,,,.....X------------------------------------
----------------------------X...............................X------------------------------------
----------------------------X.<.............W..:........<...X------------------------------------
----------------------------X...............................X------------------------------------
----------------------------X...............................X------------------------------------
----------------------------X...............................X------------------------------------
----------------------------XXXXXXXXXXXXXXXXXXXXXXXXXXXXXXXXX------------------------------------
