----------------------------------------------------------------XXXXXXXXXXXXXXXXXXXXX------------
----------------------------------------------------------------X...................X------------
----------------------------------------------------------------X.........W..H......X------------
----------------------------------------------------------------X...................X------------
----------------------------------------------------------------X...XXXXXXXXXXXXX...X------------
----------------------------------------------------------------X...X-----------X...X------------
----------------------------------------------------------------X...X-----------X...X------------
----------------------------------------------------------------X...X-----------X...X------------
----------------------------------------------------------------X,,,X-----------X...X------------
----------------------------------------------------------------X...X-----------X...X------------
----------------------------------------------------------------X.H.X-----------XE..X------------
----------------------------------------------------------------X...X-----------X...X------------
XXXXXXXXXXXXXXXXXXXXXXXXXXXXXXXXXXXXXXXXXXXXXXXXXXXXXXXXXXXXXXXXX,,,XXXXXXXXXXXXX,,,X------------
X...........,:......,.......................................................,......:X------------
X........E..,.....H.,.......................................................,.H.....X------------
X...........,.......,..E.........E.......................E..................,.......X------------
X...XXXXXXXXX...E...,.......................................................,...E...X------------
X...X-------X.......,..................................................E....,.......X------------
X...X-------X.H.....,.......................................................,.....H.X------------
X...X-------X......W,........................E..............................,W......X------------
X.W.X-------X,,,,,,,,.......A.......................................A.......,,,,,,,,X------------
X...X-------X.......................................................................X------------
X...X-------X.......................................................................X------------
X...X-------X.E.................E...................................................X------------
X...X-------X.......................................................................X------------
X...X-------X.......................................................................X------------
X...X-------X.............,,,,,,,,,,,,,,,,,,,,,...,,,,,,,,,,,,,,,,,,,,,.............X------------
X...X-------X.............,W.......:..........,.A.,.........:........W,.............X------------
X...XXXXXXXXX.......A.....,.XXXXXXXXXXXXXXXXX,,,,,,,XXXXXXXXXXXXXXXXX.,.....A.......X------------
X.......,...,.............,.X---------------XA....A.X---------------X.,.............X------------
X.......,.H.,.............,.X---------------X.......X---------------X.,.............X------------
X.......,...,.............,.X---------------X.......X---------------X.,.............X------------
XXXXXXXXXXXXX.............,.X---------------X.......X---------------X.,.............X------------
------------X.............,.X---------------X..E....X---------------X.,.............X------------
------------X.............,.X---------------X.......X---------------X.,.............X------------
------------X.............,.X---------------X.......X---------------X.,.............X------------
------------X.............,:X---------------X...W...X---------------X:,.............X------------
------------X.............,.X---------------X.......X---------------X.,........E....X------------
------------X.......E.....,.X---------------X.......X---------------X.,.............X------------
------------X.............,.X---------------X.......X---------------X.,.............X------------
------------X.............,.X---------------X...H...X---------------X.,.............X------------
------------X.............,.X---------------X.......X---------------X.,.............X------------
------------X.............,.X---------------X.......X---------------X.,.............XXX----------
------------X.............,.X---------------X:.....:X---------------X.,.............,.>----------
------------X.............,.XXXXXXXXXXXXXXXXX,,,,,,,XXXXXXXXXXXXXXXXX.,.............XXX----------
------------X.............,.,A.............:,...:...,:.............A,.,.............X------------
------------X.............,,,...............,.......,...............,,,.............X------------
------------X...............,...............,.......,...........E...,......E........X------------
------------X..............A,..E....W...H...,:..<..:,...H...W.......,A........E.....X------------
------------X...............,...............,.......,...............,...............X------------
------------X.............,,,A..............,.......,..............A,,,.............X------------
------------X...E.........,.,..............:,...:...,:..............,.,.............X------------
------------X.............,.XXXXXXXXXXXXXXXXX,,,,,,,XXXXXXXXXXXXXXXXX.,.............X------------
------------X.............,.X---------------X:.....:X---------------X.,.............X------------
------------X.............,.X---------------X.......X---------------X.,.............X------------
------------X.............,.X---------------X.......X---------------X.,.............X------------
------------X.............,.X---------------X...H...X---------------X.,.............X------------
------------X.............,.X---------------X.......X---------------X.,...E.........X------------
------------X.............,.X---------------X.......X---------------X.,.............X------------
------------X.......E.....,.X---------------X.......X---------------X.,.............X------------
------------X.............,.X---------------X...W...X---------------X:,.............X------------
------------X.............,:X---------------X.......X---------------X.,.............X------------
------------X.............,.X---------------X.......X---------------X.,.............X------------
------------X.............,.X---------------X.......X---------------X.,.............X------------
------------X.............,.X---------------X.......X---------------X.,.......E.....XXXXXXXXXXXXX
------------X.............,.X---------------X...E...X---------------X.,.............,...,.......X
------------X.............,.X---------------XA......X---------------X.,.............,.H.,.......X
------------X.............,.X---------------X.....A.X---------------X.,.............,...,.......X
------------X.......A.....,.XXXXXXXXXXXXXXXXX,,,,,,,XXXXXXXXXXXXXXXXX.,.....A.......XXXXXXXXX...X
------------X.............,W........:.........,.A.,..........:.......W,.............X-------X.H.X
------------X.E...........,,,,,,,,,,,,,,,,,,,,,...,,,,,,,,,,,,,,,,,,,,,.............X-------X...X
------------X.......................................................................X-------X...X
------------X.......................................................................X-------X...X
------------X.......................................................................X-------X...X
------------X............................................................E..........X-------X.W.X
------------X.............................................E.........................X-------X...X
------------X,,,,,,,,.......A......................E................A.......,,,,,,,,X-------X...X
------------X......W,.......................................................,W......X-------X...X
------------X.H.....,.......................................................,.....H.X-------X...X
------------X.......,.......................................................,...E...X-------X...X
------------X..E....,E.................E.........................E..........,.......XXXXXXXXX...X
------------X.......,.......................................................,.......,E..........X
------------X.....H.,.......................................................,.H.....,...........X
------------X:......,.......................................................,......:,...........X
------------X,,,XXXXXXXXXXXXX,,,XXXXXXXXXXXXXXXXXXXXXXXXXXXXXXXXXXXXXXXXXXXXXXXXXXXXXXXXXXXXXXXXX
------------X...X-----------X...X----------------------------------------------------------------
------------XE..X-----------X.H.X----------------------------------------------------------------
------------X...X-----------X...X----------------------------------------------------------------
------------X...X-----------X,,,X----------------------------------------------------------------
------------X...X-----------X...X----------------------------------------------------------------
------------X...X-----------X...X----------------------------------------------------------------
------------X...X-----------X...X----------------------------------------------------------------
------------X...XXXXXXXXXXXXX...X----------------------------------------------------------------
------------X.....H.............X----------------------------------------------------------------
------------X.........W.........X----------------------------------------------------------------
------------X...................X----------------------------------------------------------------
------------XXXXXXXXXXXXXXXXXXXXX----------------------------------------------------------------
