XXXXXXXXXXXXXXXXXXX----------------------------------------------
X................AX----------------------------------------------
X.................X---XXXXXXXXXXXXXXXXXXXXXXX-------XXXXXXX------
X..E..............X---X.....................X-------X.....X------
X.................X---X..........,,,,,......X-XXXXXXX.....XXXXXXX
X..A..............X---X..........,XXX,......X-X.................X
X.........,,,,,...X---X..........,X-X,......X-X.,,,,,.....,,,,,.X
X.........,XXX,...X---X..........,XXX,......X-X.,XXX,.....,XXX,.X
X.........,X-X,...X---X.....XXX..,,,,,...A..X-X.,X-X,.....,X-X,.X
X.........,XXX,...X---X.....X-X.............X-X.,XXX,.....,XXX,.X
X.........,,,,,...X---X.....X-X.............X-X.,,,,,.....,,,,,.X
X.................X---X.....X-X.............X-X.................X
X.................X---X.....X-X.....,,,,,...X-X.................X
X.................X---X.....X-X.....,XXX,...X-X...........A..E..X
X.................XXXXX.....X-X.....,X-X,...X-X.................X
X...........................X-X.....,XXX,...X-X.................X
X....................,,,,,..X-X.....,,,,,...X-X.................X
X....A....,,,,,......,XXX,..X-X.............X-X.........,,,,,...X
X.........,XXX,......,X-X,..X-X.......W.A...X-X...A.....,XXX,...X
X.........,X-X,......,XXX,..X-X.............X-X.........,X-X,...X
X.........,XXX,......,,,,,..X-X.............X-X.........,XXX,...X
X.........,,,,,.............X-X.............X-X.........,,,,,...X
X...........................X-X.............X-X.................X
X...........................X-X.,,,,,.......X-X.................X
X...........................X-X.,XXX,.......X-X...,,,,,.........X
X...,,,,,......A............X-X.,X-X,.......X-X...,XXX,.........X
X...,XXX,............,,,,,..X-X.,XXX,.......X-X...,X-X,.........X
X...,X-X,.......E....,XXX,..X-X.,,,,,.......X-X...,XXX,.........X
X...,XXX,............,X-X,..X-X...........<.X-X...,,,,,.........X
X...,,,,,............,XXX,..X-X.............X-X............A....X
X....................,,,,,..X-XXXXXXXXXXXXXXX-X.................X
X...........,,,,,...........X-----------------X.................X
X...........,XXX,...........XXXXXXXXXXXXXXXXXXX.................X
X...........,X-X,.....................................,,,,,.....X
X...........,XXX,...................,,,,,..,,,,,......,XXX,.....X
X......A....,,,,,............,,,,,..,XXX,..,XXX,......,X-X,.....X
X............................,XXX,..,X-X,..,X-X,......,XXX,.....X
X........................A...,X-X,..,XXX,..,XXX,......,,,,,.....X
X............................,XXX,..,,,,,..,,,,,................X
X............................,,,,,.................A............X
X............,,,,,..,,,,,.................A.....................X
X............,XXX,..,XXX,.......................................X
X....,,,,,...,X-X,..,X-X,...........,,,,,.....,,,,,....,,,,,....X
X....,XXX,...,XXX,..,XXX,...........,XXX,.....,XXX,....,XXX,....X
X....,X-X,...,,,,,..,,,,,...........,X-X,.....,X-X,....,X-X,....X
X....,XXX,.....................A....,XXX,..E..,XXX,....,XXX,....X
X....,,,,,..........................,,,,,.....,,,,,....,,,,,....X
X...............................................................X
X.............XX+XX+XX+XX+XX+XX+XX+XX+XX+XX+XX+XX...............X
X.............XX.XX.XX.XX.XX.XX.XX.XX.XX.XX.XX.XX...............X
X.......A.....XXHXXHXXHXXHXXHXXHXXHXXHXXHXXHXXHXX......A........X
X..E..........XXHXXHXXHXXHXXHXXHXXHXXHXXHXXHXXHXX...............X
X.............XXHXXHXXHXXHXXHXXHXXHXXHXXHXXHXXHXX.,,,,,...,,,,,.X
X.............XXHXXHXXHXXHXXHXXHXXHXXHXXHXXHXXHXX.,XXX,...,XXX,.X
XXXXXXXXXXXXXXXXHXXHXXHXXHXXHXXHXXHXXHXXHXXHXXHXX.,X-X,...,X-X,.X
---------------XHXXHXXHXXHXXHXXHXXHXXHXXHXXHXXHXX.,XXX,...,XXX,.X
---------------XHXXHXXHXXHXXHXXHXXHXXHXXHXXHXXHXX.,,,,,...,,,,,.X
---------------XHXXHXXHXXHXXHXXHXXHXXHXXHXXHXXHXX............E..X
---------------XXXXXXXXXXXXXXXXXXXXXXXXXXXXXXXXXXXXXXXXXXXXXXXXXX
