XXXXXXXXXXXXXXXXXXXXXXXXXXXXXXXXXXXXXXXXXXXXXXXXXXXXXXXXXXXXXXXXXXX
X.................................................................X
X...........................A....A...A............................X
X.........................A............A..........................X
X.................................................................X
X........................A..............A.........................X
X..............................T..<...............................X
X........................A..............A...A.....................X
X.....................A...........................................X
X.................................................................X
X.........................A...W....W....A.........................X
X....A............................................................X
X..A....A...................A...W......A..........................X
X.....................A....................A......................X
X.A.....A.............................A....................A.A....X
X.............................A.:..A..............................X
X.A.......................................................A.......X
X..................................A...A.......................A..X
X.......,,,...............A.....A.......................,,,.......X
X.A....,...,...........................................,...,......X
X.....,.....,.........................................,.....,.A...X
X.A...,.....,....................H....................,.....,.....X
X.....,.....,.........................................,.....,.....X
X......,...,...........................................,...,......X
X.A.....,,,.............................................,,,...A...X
X.................................................................X
X.A...............................................................X
X.............................................................A...X
X.A...............................................................X
X.................................................................X
X.A...........................................................A...X
X....................A............................................X
X.A...........................................A...................X
X.............................................................A...X
X.A...............................................................X
X.............................................A...................X
X.............................................................A...X
X.A..................A........................................A...X
X.................................................................X
X.............................................A...................X
X.................................................................X
X....................A............................................X
X.........................,,,,,,,,,,,,,,,,,.......................X
X.........................,...............,...A...................X
X.........................,.H..........H..,.......................X
X.........................,...H...........,.......................X
X.........................,...........H...,.......................X
X.........................,...............,.......................X
X....................A....,...............,.......................X
X.........................,...............,...A...................X
X.........................,......T.AA.....,.......................X
X.........................,...............,.......................X
X.........................,...............,.......................X
X.........................,..AA......AA...,.......................X
X.....................A...,...A.......A...,.......................X
X.........................,.H.......H..ttt,...A...................X
X.........................,............t.t,.......................X
X.........................,............ttt,.......................X
X.........................,,,,,,,,,,,,,,,,,.......................X
X.....................A.......................A...................X
X.................................................................X
X.................................................................X
X.................................................................X
X.................................................................X
X.................................................................X
X.................................................................X
X,,,,,,,,,,,,,,,,,,,,,,,,,,,,,,,,,,,,,,,,,,,,,,,,,,,,,,,,,,,,,,,,,X
X.................................................................X
X.................................................................X
X.....................................:...........................X
X.................................................................X
X...........................:.....................................X
X................................:................................X
X.................................................................X
X.........................:...........:...........................X
X.................................................................X
X.................................................................X
X..............................:..................................X
X.........................:........:..:...........................X
X.................................................................X
X.................................................................X
X.................................................................X
X.........................:.:.........:...........................X
X.................................................................X
X.................................................................X
X................................:................................X
X.........................:...........:...........................X
X.................................................................X
X.................................................................X
X.................................................................X
X.........................:...........:...........................X
X................................:................................X
X............................:....................................X
X.................................................................X
X.................................................................X
X.................................................................X
X..................................:..............................X
X...........................:.....................................X
X.......,,,,,.........................................,,,,,.......X
X......,.....,.......................................,.....,......X
X.....,.......,................:....................,.......,.....X
X....,.........,..............:::..................,.........,....X
X...,...........,.............:::.................,...,,,,,...,...X
X...,...........,.................................,...,ttt,...,...X
X...,...........,.................................,...,t.t,...,...X
X...,...........,.................................,...,ttt,...,...X
X...,...........,...........:...E...:.............,...,...,...,...X
X....,.........,...................................,..,...,..,....X
X.....,.......,.............:.......:...............,.,...,.,.....X
X......,.....,.......................................,,...,,......X
X...K...,,,,,.................:.:.:...................,...,.......X
X.................................................................X
X.................................................................X
X.................................................................X
X.................................................................X
X.................................................................X
X.................................................................X
X.................................................................X
X.................................................................X
X.................................................................X
X.................................................................X
X.................................................................X
X.................................................................X
X.................................................................X
X.................................................................X
X.................................................................X
X.............................B.B.B.B.............................X
X.................................................................X
X.............................B.B.B.B.............................X
X.................................................................X
XXXXXXXXXXXXXXXXXXXXXXXXXXXXXXXLLLLLXXXXXXXXXXXXXXXXXXXXXXXXXXXXXXX
------------------------------X.....X------------------------------
------------------------------X.....X------------------------------
------------------------------X.....X------------------------------
------------------------------XLLLLLX------------------------------
------------------------------X.....X------------------------------
------------------------------X.....X------------------------------
------------------------------X.....X------------------------------
------------------------------X.....X------------------------------
------------------------------X.....X------------------------------
------------------------------X.....X------------------------------
------------------------------X.....X------------------------------
------------------------------X.....X------------------------------
------------------------------X.....X------------------------------
------------------------------X.....X------------------------------
------------------------------X.....X------------------------------
------------------------------X.....X------------------------------
------------------------------X.....X------------------------------
------------------------------X.....X------------------------------
------------------------------X.....X------------------------------
------------------------------X.....X------------------------------
------------------------------X.....X------------------------------
------------------------------X>>>>>>------------------------------
