--------------XXXXXXXXXXXXXXXXXXX---------------------------------
--------------X...HHHHHHHH,....AX---------------------------------
--------------X.E.,,,,,,,,,.....X---------------------------------
--------------X...HHHHHHHH,.,,..X---------------------------------
--------------X,,,XXXXXXXXX.,.,.X---------------------------------
--------------X...X-------XH,,,.X---------------------------------
--------------X...X-------XXX,XXX---------------------------------
--------------X.E.X---------XWX-----------------------------------
--------------X...X-----XXXXX,XXXXX-------------------------------
--------------X...X-----XXX.,.,.XXX-------------------------------
--------------X...X-----XXX.,,,.XXX-------------------------------
--------------X...X-----X.........X---------------XXXXX-----------
--------------X,,,X-----X...,,,...XXXXXXXXXXX----XXE,EXXX---------
--------------X...X-----X..,XX,,..,.E.......X----XA....HX---------
------------XXX,,,XXX---X.E,XX,,..,.......E.X----X......X---------
---XXX------X.,E..,EX---X..,,,.,..,.........X----X,,,,,,X---------
--XX<XX-----X.,...,.X---X...,,,...XXXXXXX...X----X,,,,,,X---------
--X...X-----X.,...,.X---X........EX-----X...X---X........X--------
--X<.<X-----X.,...,.X---XXX.....XXX-----X...X--X,,,,XXX,,.X-------
--X...X-----X.,..E,.X---XXX.....XXX-----X..HX--X,.E.X-XE,.XHHHX---
--X.<.X-----X.,...,.X---XXXX,,,XXXX-----X...XXXX,...++X.,.,E.EX---
--X..HX-----XE,...,.X------X.E.X--------X...,+,.,.......,.,,..X---
XXX,,,XXXXXXX.,...,.X------X...X--------X.E.,+,.,.......,E,E.EX---
XH............,..E,.X------X...X--------X...,+,.,.......,.,E.EX---
X,,,,,,,E,,,,,,...,.X------X...X--------X...XXXX,...XXX.,.,,.AX---
X.................,.X------X...X--------X..HX--X,.E.X-XE,.XXXXX---
X...............E.,.X------X...X--------X...X--X,,,,XXX,,.X-------
X............E....,.X------X...X--------X...X---X........X--------
X,,,,,,,,E,,,,,,,,,.X------X...XXXXXXXXXX...X----X,,,,,,X---------
XH.................AX------X.E..E...........X----X,,,,,,X---------
XXXXXXXXXXXXXXXXXXXXX------X.......E..E...E.X----X.E....X---------
---------------------------X................X----XW..E.AX---------
---------------------------XXXXXXXX,,,XXXXXXX----XXXXXXXX---------
----------------------------------X,,,X---------------------------
----------------------------------X,,,X---------------------------
----------------------------------X,,,X---------------------------
----------------------------------X,,,X---------------------------
----------------------------------X...X---------------------------
----------------------------------X,,,X---------------------------
----------------------------------X...X---------------------------
----------------------------------X.E.X---------------------------
----------------------------------X...X---------------------------
----------------------------------X...X---------------------------
----------------------------------X...X---------------------------
----------------------------------XE..X-AXXXXXXXXXX---------------
----------------------------------X...X-X,,,,,,,,,>---------------
----------------------------------X..EX-X,.......,>---------------
----------------------------------XE..X-X,.,,,,,,,>---------------
----------------------------------X...X-X,.,XXXXXX>---------------
----------------------------------X...X-X,.,X---------------------
----------------------XXXXXXXXXXXXX,,,X-X,.,X---------------------
----------------------X.E.............X-X,.,X---------------------
----------------------X...H.H.H.H.H.H.X-X,,,X---------------------
----------------------X..XX,,,,,,,,,,XXXXLLLX---------------------
----------------------X.HXX,,,,,,,,,,XXX,,,,XXX-------------------
----------------------X..,,.................E.X-------------------
----------------------X..,,.,,,,,,,,,,,,,,,,,.XXXXXXXXXXXXXXX-----
----------------------X.E,,.,...............,.,......,,,,...X-----
----------------------X..,,.,.XXXXXXXXXXXXX.,.,.A....,,,,.E.X-----
----------------------X..,,.,.XX...,,,,,.XX.,.,......,,,,...X-----
----------------------XE.,,.,.XX...,,,,,,XX.,.XXXXXXXXXXX,,,X-----
----------------------X..,,.,.,,.......,,XX.,.X---------X,,,X-----
----------------------X..,,.,.XX,......,,XX.,.X---------X,,,X-----
----------------------XE.,,.,.XK,......,,XX.,.X---------X,,,X-----
----------------------X..,,.,.X,,.....H,,XX.,.XXXXX-----X,,,X-----
----------------------X..,,.,.X.,,,,,,,,,XX.,.,...X-----X,,,X-----
----------------------XE.,,.,.XA..E....,.XX.,.,.E.X-----X,,,X-----
----------------------X..,,.,.XXXXXXXXXXXXX.,.,...X-----X,,,X-----
----------------------X..,,.,.XXXXXXXXXXXXX.,.,...XXXXXXX,,,XXXXXX
----------------------X..,,.,...............,.,...,++.........,E.X
----------------------X..,,E,,,,,,,,,,,,,,,,,.,...,++....E....,E.X
----------------------X.E,,...................,...,++.........,.HX
----------------------X..XX,,,,,,,,,,,,,,,,,,,X...XXXXXXXXXXXXXXXX
----------------------X...........................X---------------
----------------------XA........E.....E....E......X---------------
----------------------X...........................X---------------
----------------------XXXXXXXXXXXXXXXXXXXXXXXXXXXXX---------------
