-----------------------------------------------------------------------------------------------------------------XXXXXXXXXXXXX--------------------------------------
---------------------------------------------------------------------------------------------------------------XXX,,,<X<<X,,,XXX------------------------------------
---------------------------------------------------------------------------------------------------------------X...............X------------------------------------
-----------------------------------------------------------------------------------------------------------XXXXX.A.....:.....A,XXXX---------------------------------
----------------------------------------------------------------------------------------------------------X...++..............,+...X--------------------------------
---------------------------------------------------------------------------------------------------------X...E++..............,+.E..XX------------------------------
--------------------------------------------------------------------------------------------------------X.....++..............,+......X-----------------------------
-------------------------------------------------------------------------------------------------------X....XXXX.,,,,,,,,,,,,,,XXX....X-----------------------------
------------------------------------------------------------------------------------------------------X...EXX--X.,.,.......,W,EX-XX.E..X----------------------------
-----------------------------------------------------------------------------------------------------XX....X---XXXXX,,,,,,,XXXXX--XX....X---------------------------
-----------------------------------------------------------------------------------------------------X....XX-------X.......X-------X....X---------------------------
-----------------------------------------------------------------------------------------------------X....X--------X...E...X-------X.....X--------------------------
-----------------------------------------------------------------------------------------------------X....X--------X.......X-------X.....X--------------------------
-----------------------------------------------------------------------------------------------------X...E.X-------X.......X------XX.E..XX--------------------------
-----------------------------------------------------------------------------------------------------X.....X-------X.......X------X.....X---------------------------
------------------------------------------------------------------------------------------------------X.....X------X...H...X-----X.....X----------------------------
-------------------------------------------------------------------------------------------------------X.....XX----X.......X---XX......X----------------------------
-------------------------------------------------------------------------------------------------------XX...E..XXXXXXX,,,XXXXXX..E...XX-----------------------------
---------------------------------------------------------------------------------------------------------XX........XXX...XXX........X-------------------------------
-----------------------------------------------------------------------------------------------------------XX....E.HXX...XA,E.....XX--------------------------------
-------------------------------------------------------------------------------------------------------------XX....XXX...XXX...XXX----------------------------------
---------------------------------------------------------------------------------------------------------------XXXXX-X...X-XXXX-------------------------------------
---------------------------------------------------------------------------------------------------------------------X...X------------------------------------------
-------------------------------------------------------------------------------------------------------------------XXX...XXX----------------------------------------
-----------------XXXX------XXXX------XXXX------XXXX----------------------------------------------------------------XE,...E.X----------------------------------------
-XXXXXXXXXXXXXXXXX...XXXXXXX...XXXXXXX...XXXXXXX...XXXXXXXXXXXXXXX-------------------------------------------------X.,...,.X----------------------------------------
-XH.,......,.....,...,.....,...,.....,...,.....,...,.....,.......X-------------------------------------------------X.,...,.X----------------------------------------
-X.,..E....,.....,.E.,.....,.E.,.....,.E.,.....,.E.,.....,.......X-----------------------XXXXXXX-------------------XE,,,,E.X----------------------------------------
-X,........,.....,...,.....,...,.....,...,.....,...,.....,...H...X---------------------XX.......XXXX---------------X.,...,.X----------------------------------------
-X.........,.....,...,.....,...,.....,...,.....,...,.....,.......X-------------------XX.............XX-------------XE,...E.X----------------------------------------
-X.........,.....,...,.....,...,.....,...,.....,...,.....,.......X-----------------XX.................X------------X.,...,.X----------------------------------------
-X.........,,,,,,,...,,,,,,,...,,,,,,,...,,,,,,,...,,,,,,,.......X----------------X......,,,,,,,......X------------XXX...XXX-----XXXXXXXXXXXXXXXXXXXXX--------------
-X...............................................................X--------------XX.....,,.......,,.....X-------------X...X-------X.................:.X--------------
-X...............................................................X--------------X....,,...........,,....X------------X,,,X-------X.:.................X--------------
-X...............................................................X-------------X....,...............,....X-----------X,,,X-------X...................X--------------
-X...............................................................X------------X....,................,.....X----------X,,,X-------X...................X--------------
-X...............................................................X------------X....,.................,.....X---------X,,,X-------X.....E.............X--------------
-X...............................................................X-----------X....,..,,,.........,,,..,....X---------X,,,X-------X.......,,,,,.......X--------------
-X...............................................................X-----------X....,..,E,.........,E,...,...X---------X,,,X-------X.....,,.....,,.E...X--------------
XX...............................................................XXXXXXXXXXXX....,...,,,.........,,,...,...X-------XXX,,,XXX-----X.....,.......,,....XXXXXXXXXXXXXXX
X,...............................,,,,............................,........,.,....,......................,...X------X:.....:X-----X....,.........,....,.E...........X
X,.............................,,....,...........................,........,.,...,.......................,...XXXXXXXX.......XXXXXXX,,.,...........,...,.............X
X,............................,.......,..........................,........,.,...,..........,,...........,...,,,,,,,,.......,,,,,,L.,.,...........,...,.........,...X
X,.H...:......................,.E.K.E.,..........................,...A....,.,...,..........,,.W.:....H..,...,,,,,,,,...A...,,,,,,L.,.,....A.E....,...H.....E...,...X
X,............................,.......,..........................,........,.,...,..........,,...........,...,,,,,,,,.......,,,,,,L.,.,...........,...,.............X
X,.............................,,....,...........................,........,.,...,.......................,...XXXXXXXX.......XXXXXXX,,.,...........,...,.E...........X
X,...............................,,,,............................,........,.,...,.......................,...X------X:.....:X-----X....,.........,....,.......LLLLLLX
XX...............................................................XXXXXXXXXXXX....,...,,,.........,,,....,...X------XXX,,,XXX-----X.....,.......,,....XXXXXXXXX,,,,,X
-X...............................................................X----------X....,...,E,.........,E,...,...X---------X,,,X-------X.....,,.....,,.....X-------X,,,,.X
-X...............................................................X-----------X....,..,,,.........,,,..,....X---------X,,,X-------X.......,,,,,...E...X-------X,>>,.X
-X...............................................................X-----------X....,..................,.....X---------X,,,X-------X.....E.............X-------X,>.,.X
-X...............................................................X------------X....,.................,....X----------X,,,X-------X...................X-------X,,,,.X
-X...............................................................X-------------X....,...............,....X-----------X,,,X-------X...................X-------X.....X
-X...............................................................X-------------X.....,,...........,,....X------------XLLLX-------X.:...............:.X-------XXXXXXX
-X...............................................................X--------------XX.....,,.......,,.....X-------------XLLLX-------X...................X--------------
-X.........,,,,,,,...,,,,,,,...,,,,,,,...,,,,,,,...,,,,,,,.......X----------------X......,,,,,,,.......X-------------X.A.X-------XXXXXXXXXXXXXXXXXXXXX--------------
-X.........,.....,...,.....,...,.....,...,.....,...,.....,.......X-----------------XX.................X--------------X...X------------------------------------------
-X..E...E..,.....,...,.....,...,.....,...,.....,...,.....,..H....XXXXXX--------------XX.............XX--XXXXXX-------X,,,X------------------------------------------
-X.........,.....,.E.,.....,.E.,.....,.E.,.....,.E.,.....,.......,....X----------------XX.......XXXX----XA..WX-------X.E.X------------------------------------------
-X.........,.....,...,.....,...,.....,...,.....,...,.....,.......,,,..X------------------XXXXXXX-------XX,,,,XXXXXXXXX,,,XXXXXXXXXXXXXXX----------------------------
-X.........,.....,...,.....,...,.....,...,.....,...,.....,.......,A,..X--------------------------------X.......XXE.,,.....,,E.XX.......X----------------------------
-XXXXXXXXXXXXXXXXXX.XXXXXXXXX.XXXXXXXXX.XXXXXXXXX.XXXXXXXXXXXX,,,,.,..X-------------------------------X......,,XX,,,B.....B,,,XXE.......X---------------------------
------------------XX--------XX--------XX--------XX-----------X.,:.H,..X-------------------------------X......,EXX,...........,XX........X---------------------------
-------------------------------------------------------------X.,,,,,..X------------------------------X.......XXXX.B....:....B.XXXX......X---------------------------
-------------------------------------------------------------X........X------------------------------X.......X--X.............X--X......X---------------------------
-------------------------------------------------------------X.....W..X-----------------------------X........XXXX.....,,,.....XXXX.......X--------------------------
-------------------------------------------------------------X........X-----------------------------X..........,,....,+W.,....,,.........X--------------------------
-------------------------------------------------------------XXXXXXXXXX-----------------------------X........A.,,....,+A.,....,,H.........X-------------------------
----------------------------------------------------------------------------------------------------X..........,,....,++.,....,,..........X-------------------------
---------------------------------------------------------------------------------------------------X.........XXXX.....,,,.....XXXX........X-------------------------
---------------------------------------------------------------------------------------------------X.........X--X.............X--X........X-------------------------
---------------------------------------------------------------------------------------------------X.........X--X.B.........B.X--X........X-------------------------
---------------------------------------------------------------------------------------------------X.........X--X,...........,X--X........X-------------------------
---------------------------------------------------------------------------------------------------X.........X--X.,,B.....B,,.X--X........X-------------------------
---------------------------------------------------------------------------------------------------X.........X--XE.,,..H..,..EX--X.........X------------------------
---------------------------------------------------------------------------------------------------X.........X--XXXXXX+++XXXXXX--X.........X------------------------
---------------------------------------------------------------------------------------------------X.........XXXXXXXXX+++XXXXXXXXX...E.....X------------------------
---------------------------------------------------------------------------------------------------X.........,E.E.E,XX...XXE.E.E,,.........X------------------------
---------------------------------------------------------------------------------------------------X...E.....,,,,,,,XX...XX,,,,,,,.........X------------------------
---------------------------------------------------------------------------------------------------X.........,,,,,,,XX,,,XX,,,,,,,.........X------------------------
---------------------------------------------------------------------------------------------------X.......................................X------------------------
---------------------------------------------------------------------------------------------------X.......................................X------------------------
---------------------------------------------------------------------------------------------------X.......................................X------------------------
---------------------------------------------------------------------------------------------------X......................................X-------------------------
---------------------------------------------------------------------------------------------------X......................................X-------------------------
---------------------------------------------------------------------------------------------------X...................E..................X-------------------------
---------------------------------------------------------------------------------------------------X......................................X-------------------------
---------------------------------------------------------------------------------------------------X......................................X-------------------------
----------------------------------------------------------------------------------------------------X.......,,,,..............,,,,........X-------------------------
----------------------------------------------------------------------------------------------------X......,....,....,,,,,...,....,.......X-------------------------
----------------------------------------------------------------------------------------------------X......,.....,...,,,,,...,.....,.....X--------------------------
----------------------------------------------------------------------------------------------------X......,.....,...,,K,,...,.....,.....X--------------------------
-----------------------------------------------------------------------------------------------------X.....,....,....,,,,,...,....,.....X---------------------------
-----------------------------------------------------------------------------------------------------X.....,,..,,....,,,,,...,,..,,.....X---------------------------
------------------------------------------------------------------------------------------------------X......,,................,,.......X---------------------------
------------------------------------------------------------------------------------------------------X.................................X---------------------------
------------------------------------------------------------------------------------------------------X.................................X---------------------------
-------------------------------------------------------------------------------------------------------X...............................X----------------------------
--------------------------------------------------------------------------------------------------------XXXX.......................XXXX-----------------------------
------------------------------------------------------------------------------------------------------------XX...................XX---------------------------------
--------------------------------------------------------------------------------------------------------------XXXXXX........XXXXX-----------------------------------
--------------------------------------------------------------------------------------------------------------------XXXXXXXX----------------------------------------
