---------------------------------------------------------XXX-----------------------------------------------------------------------------
---------------------------------------------------------X.X-----------------------------------------------------------------------------
---------------------------------------------------------X.X-----------------------------------------------------------------------------
---------------------------------------------------------X,X-----------------------------------------------------------------------------
---------------------------------------------XXXXXXXXXXXXXtXXXXXXXXXXXXX-----------------------------------------------------------------
---------------------------------------------X..,....E...,.,.....E..,..X-----------------------------------------------------------------
---------------------------------------------X...,......,...,......,...X-----------------------------------------------------------------
---------------------------------------------X...,......,.T.,......,...X-----------------------------------------------------------------
---------------------------------------------X,,XXX...XXX..WXXX...XXX,,X-----------------------------------------------------------------
---------------------------------------------X,,XXX,,,XXX,,,XXX,,,XXX,,X-----------------------------------------------------------------
---------------------------------------------X..XX......,...,......XX..X-----------------------------------------------------------------
---------------------------------------------X...,....,,,..A,,,....,...X-----------------------------------------------------------------
---------------------------------------------X...,....,.......,....,...X-----------------------------------------------------------------
---------------------------------------------X,.XX....,,,...,,,....XX,.X-----------------------------------------------------------------
---------------------------------------------X.,XX......,..T,......XX.,X-----------------------------------------------------------------
---------------------------------------------X,,XX....,,,...,,,....XX,.X-----------------------------------------------------------------
---------------------------------------------X..XX....,.......,....XX..X-----------------------------------------------------------------
---------------------------------------------X...,....,,,...,,,....,...X-----------------------------------------------------------------
---------------------------------------------X...,......,...,......,...X-----------------------------------------------------------------
---------------------------------------------X,.XX....,,,...,,,....XX,.X-----------------------------------------------------------------
---------------------------------------------X.,XX....,.......,....XX.,X-----------------------------------------------------------------
---------------------------------------------X,,XX....,,,...,,,....XX,,X-----------------------------------------------------------------
---------------------------------------------X..XX......,...,......XX..X-----------------------------------------------------------------
---------------------------------------------X...,....,,,...,,,....,...X-----------------------------------------------------------------
---------------------------------------------X...,....,.......,....,...X-----------------------------------------------------------------
---------------------------------------------X..XX....,,,...,,,....XX..X-----------------------------------------------------------------
---------------------------------------------X,EXX......,...,......XX,EX-----------------------------------------------------------------
---------------------------------------------X.TXX....,,,...,,,....XX.TX-----------------------------------------------------------------
---------------------------------------------XtAXX....,.......,....XXttX-----------------------------------------------------------------
---------------------------------------------XX,XX....,,,...,,,....XXX,X-----------------------------------------------------------------
----------------------------------------------X.XXX....,,...,,.....X-XXX-----------------------------------------------------------------
----------------------------------------------X.X--X,..,.....,..,XX----------------------------------------------------------------------
----------------------------------------------XXX-XX.EXX,...,,X,EX-----------------------------------------------------------------------
----------------------------------------------XXXX....X-X,,,XXX...XX---------------------------------------------------------------------
------------------------------------------XXXX..,...XXX-X...X-X.....X--------------------------------------------------------------------
--------------------------------------XXXX.,....XXXX----X...X--XX....X-------------------------------------------------------------------
------------------------------------XX.,....,.XX--------X...X----XX.,.X------------------------------------------------------------------
------------------XXXXXXXXXXXXXXXXXX...,..XXXX----------X...X------X..X------------------------------------------------------------------
-----------------X.......,.E,.....,...XXXX--------------X...X-------X..X-----------------------------------------------------------------
----------------X........,...,....,.XX------------------X...X--------X..X----------------------------------------------------------------
--------------XX..XXX..XXX..XXX..XXX--------------------X...X---------X.,XX--------------------------------------------------------------
-------------X...XXXX,,XXX,,XXX,,XX---------------------X,,,X----------X...X-------------------------------------------------------------
------------X...XX................X------------------XXXX...XXXX--------X...X------------------------------------------------------------
-----------X...XX..................X----------------X...........XX-------X..,X--------------------------------XXX------------------------
----------X...XX...................X--------------XX..,,,,,,,,,,..XX------X,.X--------------------------------X,X------------------------
---------X..XXX....................X-------------X..,,..........,,..X------X..X-------------------------------X,X-----------XXXXXXXXX----
-------XX..XXX......................X-----------X.,,..,,,,,,,,,...,..X------X..XXXXXXXXXXXXXXXXXXXXXX------XXXX,XXXXX-------X,,,,,,,,X---
------X...XX........................X---------XX.,..,,..,...,..,,..,..X------X.,.....,....,....,....X-----X.,.,..,.,,X------X,,,,,,,.X---
-----X...XX.........................X--------X..,..,....,...,....,..,..X------X,.....,....,....,....X----X..,.,.,..,,.X-----X.......,,X--
----X...XX..........,,,,,,,,,,,,,,...X-------X.,.,,.....,...,.....,..,.X-------X,,,,,,,,,,,,,,,,,,,,X---X...XXXXXXXXX.AX---X.....E...,,X-
----X..XX.........,,.....W.......,...X------X..,,.......,.A.,.....,..,..X------X..,E.............,..X---X..X--XXXXXXX,,XXXXX.........,,X-
----X..XX.......,,...............,...X------X.,.,.......,...,......,..,.X------X..,..............,..X--X..X---X............,.........,,X-
----X..XX.....,,.......,,,,,.....,....X----X..,.,.......,.W.,.......,.,..X-----X,,,...........E..,,,X-X...X--X.............,.........,,X-
----X.E.,...,,.......,,.....,....,....X----X.,.,........,...,.......,..,.X-----X..,..............,..XX...X---X.............,.........,,X-
----X...,...,.......,..,,,,..,...,....X----X.,.,......XXX,,:XXX......,.,.X-----X..,..............,.E,,..XXX-X..............,.........,,X-
----X..XX...,......,...,,.,,,.,..,.....X--X..,.,......X-X...X-X......,.,..X----X..,..............,..XXXXX+X-X..............,.........,,X-
----X.,XX...,......,.,,,,,,,,.,..,.....XXXX.,..,,,,,,,XXX,<,XXX,,,,,,,..,.XXXXXX,,,,,,,,,,,,,,,,,,,,XXXXX+XX...............,...,,,,ttt,X-
XXXXX,.XX...,.....,..,,,,,,,,..,.,.....,..,.,..,......,.,...,.,....A.,..,..,.,.,..,...,...,...,..,..,.,.,.,,...............,...,...t,t,X-
X..,t...,...,.T.E.,.T..,:,W.,A.,.,.....,..,.,.,...A.W.,.<...<.:..W....,.,..,.,.,..,...,...,...,..,..,..,.W.,,....A..W......,...A.WEt,t,X-
XXXXX...,...,.....,......,,,,,.,.,.....,..,.,.,.......,.,...,.,.......,.,..,.,.,..,...,...,...,..,..,..,...,,..............,...,...ttt,X-
----X,,XX...,......,..,,,...,.,..,.....XXXX.,..,,,,,,,XXX,,,XXX,,,,,,,..,.XXXXXX,,,,,,,,,,,,,,,,,,,,XXXXX+XX...............,...,,,,,.,,X-
----X..XX...,......,..,,..,,,.,..,.....X--X..,.,......X-X.:.X-X......,.,..X----X..,..............,..XXXXX.XX...............,.........,,X-
----X..XX...,.......,..,,,...,...,....X----X.,.,......XXX,,,XXX.....,..,.X-----X..,..............,.E,,..XXX-X..............,.........,,X-
----X.E.,...,,.......,,.....,....,....X----X.,..,.......,...,.......,..,.X-----X,,,..............,,,XX...X--X..............,.........,,X-
----X...,.....,,.......,,,,,.....,....X-----X.,.,.......,...,......,..,.X------X..,...........E..,..X-X..X---X.............,.........,,X-
----X..XX.......,,.......A.......,...X------X.,..,......,.W.,.....,...,.X------X..,..............,..X--X..X--X.............,.........,,X-
----X..XX.........,,.....A.......,...X-------X.,..,.....,...,.....,..,.X-------X..,E.............,..X---X..X--XXXXXXX,,XX,,X.....E...,,X-
----X...XX..........,,,,,,,,,,,,,,...X-------X..,..,....,.A.,....,..,..X-------X,,,,,,,,,,,,,,,,,,,,X---X...XXXXXXXXX.AXX,,X.........,,X-
-----X...XX..........................X--------XX.,..,,..,...,..,,..,..X-------X,.....,....,....,....X----X..,..,...,,.X-X,,XX.......,,.X-
------X...XX........................X-----------X.,,..,,,,,,,,,...,..X-------X.,.....,....,....,....X-----X.,.,.,..,,X--X..XX,,,,,,,.,X--
-------X...XX.......................X------------X..,,..........,,..X-------X..XXXXXXXXXXXXXXXXXXXXXX------XXXX+XXXXX---X..XX,,,,,,,,.X--
--------X...XX......................X-------------XX..,,,....,,,..XX-------X..X-------------------------------X,X-------XXXXXXXXXXXXXX---
---------X...XX....................X----------------X....,,,,...XX--------X..X--------------------------------X,X------------------------
----------XX..XX...................X-----------XXXX--XX.......XX---XXXX--X...X--------------------------------X.X------------------------
------------X..XX..................X---------XX....XXXXXX...XX-XXXX....XX,..X---------------------------------XXX------------------------
-------------X..XX................X-------XXX....E.....XX,,,XXX.....E.....,XX------------------------------------------------------------
--------------X..XXXX,,XXX,,XXX,,XX-----XX...................................XX----------------------------------------------------------
---------------X..XXX..XXX..XXX..XXXXXXXX.....................................X----------------------------------------------------------
----------------X........,.E.,..........,....XX...............................X----------------------------------------------------------
-----------------X.......,..,...........,...X--X........................XXXX..X----------------------------------------------------------
------------------XXXXXXXXXXXXXXXXXXXXXXX..X---X........................X--X..X----------------------------------------------------------
----------------------------------------X..X---X.......................X---X..X----------------------------------------------------------
----------------------------------------X...XXXX........................X--X..X----------------------------------------------------------
----------------------------------------X................................XX...X----------------------------------------------------------
----------------------------------------X.....................................X----------------------------------------------------------
----------------------------------------X.....................................X----------------------------------------------------------
----------------------------------------X.................,,,.................X----------------------------------------------------------
----------------------------------------X..............,,,...,,,..............X----------------------------------------------------------
----------------------------------------X............,,.........,.............X----------------------------------------------------------
----------------------------------------X....E......,............,............X----------------------------------------------------------
----------------------------------------X...........,.....,,,,...,..........E.X----------------------------------------------------------
----------------------------------------X..........,....,,....,...,...........X----------------------------------------------------------
----------------------------------------X..........,....XX.AXX,...,...........X----------------------------------------------------------
----------------------------------------X..........,...,XX,tXX.,...,..........X----------------------------------------------------------
----------------------------------------X..........,...,A,tWt.A,...,..........X----------------------------------------------------------
----------------------------------------X..........,...,.,tt,..,...,..........X----------------------------------------------------------
----------------------------------------X..........,...,XX,,XX.,..,......XX...X----------------------------------------------------------
----------------------------------------X..........,....XX.AXX,...,.....X--X..X----------------------------------------------------------
----------------------------------------X...XXXX....,.....,,,,...,.....X---X..X----------------------------------------------------------
----------------------------------------X...X--X....,............,.....X---X..X----------------------------------------------------------
----------------------------------------X..X---X.....,,.........,.......XXXX..X----------------------------------------------------------
----------------------------------------X...X--X.......,,,...,,,..............X----------------------------------------------------------
----------------------------------------X....XX...........,,,.................X----------------------------------------------------------
----------------------------------------X.....................................X----------------------------------------------------------
----------------------------------------X.....................................X----------------------------------------------------------
-----------------------------------------X...................................X-----------------------------------------------------------
-----------------------------------------X...................................X-----------------------------------------------------------
------------------------------------------X....E...........A..............E..X-----------------------------------------------------------
------------------------------------------X..................................X-----------------------------------------------------------
------------------------------------------X.........XXXX...W...XXXX..........X-----------------------------------------------------------
-------------------------------------------X........X--X.......X--X.........X------------------------------------------------------------
-------------------------------------------X.......X---X...:..X---X.........X------------------------------------------------------------
-------------------------------------------X........X--X.......X--X.........X------------------------------------------------------------
--------------------------------------------X........XX.........XX..........X------------------------------------------------------------
--------------------------------------------X..............................X-------------------------------------------------------------
---------------------------------------------X.............................X-------------------------------------------------------------
---------------------------------------------XXXXXXXXXXXXX+XXXXXXXXXXXXXXXXX-------------------------------------------------------------
---------------------------------------------------------X.X-----------------------------------------------------------------------------
---------------------------------------------------------X++X----------------------------------------------------------------------------
--------------------------------------------------------X.A.X----------------------------------------------------------------------------
--------------------------------------------------------X..WX----------------------------------------------------------------------------
--------------------------------------------------------X...X----------------------------------------------------------------------------
--------------------------------------------------------X.<.X----------------------------------------------------------------------------
---------------------------------------------------------X,X-----------------------------------------------------------------------------
---------------------------------------------------------X,X-----------------------------------------------------------------------------
---------------------------------------------------------X.X-----------------------------------------------------------------------------
---------------------------------------------------------XXX-----------------------------------------------------------------------------
