------------XXX---------------------------------------------------------------------
------------X.X----XXXXXXXXXXXXXXXXXXXX---------------------------------------------
-----------XX+XX---X.....XX.t..E...E.EX---------------------------------------------
---------XX.....XX-XE.E.EXX.t....E....X---------------------------------------------
--------X,,,,,,,,,XX.....XX.t..E...E.EX---------------------------------------------
--------X:...:...:XX.....XX.t....E....X---------------------------------------------
-------XX.........XX..H..XX.t..E...E.EX---------------------------------------------
-------X,....<....,,.....XX.t....E....X---------------------------------------------
-------XX.........XX.....XX.t..E...E.EX---------------------------------------------
--------X.........XXXXXXXXX.t....E....X---------------------------------------------
--------X,,,,,,,,,XXXXXXXXX.t..E...E.EX---------------------------------------------
--------X.........XX..E..XX.t....E....X---------------------------------------------
-------XX.........XX.....,,.t..E...E.EX---------------------------------------------
-------X,.A..W..A.,,..H..,,.t.........X---------------------------------------------
-------XX.........XX..E..XX.t..E.E.E.EX---------------------------------------------
--------X.........XX.....XX.t.........X---------------------------------------------
--------X,,,,,,,,,XXXX,XXXX.t..E...E.EX---------------------------------------------
--------X.........XXXX,XXXX.t....E....X---------------------------------------------
-------XX.........XX.....XX.t..E...E.EX---------------------------------------------
-------X,..E.E.E..,,E.E.HXX.t....E....X---------------------------------------------
-------XX.........XX.....XX.t..E...E.EX---------------------------------------------
--------X........:XXXXXXXXXXXXXXXXXXXXX---------------------------------------------
XXXXXXXXX,,,,,,,,,XXXXXXXXXXXXXXXXXXXXXBX::BXXXXXXXXXXXXXXXXXXXXXX------------------
X:.....................B.B..................,...,...............AX------------------
X..A.......<.<.<............................,.E.,...............BX------------------
X:..........................................,...,..E....,,,......X------------------
X...............................E...........,,,,,.......,,,......X------------------
X:......................................................,,,......X------------------
X...E.................................................,B,,,B.E...X------------------
X.........................,,,,,,,,,...................,H,A,,,,,..X------------------
X......................,,,..,.H.,..,,,................,,,,,...,..X------------------
X....................,,,....,...,...,.,,........E.....,,,,,...,..X------------------
X..................,,...,...,.E.,...,...,,............,...,...,..X------------------
X.................,.....,...,...,..,......,...........,.E.,,,,,B.X------------------
X................,.,.....,.XX,,,XX.,.....,.,..........,...,E.,.,HX------------------
X...............,..,.....XX-X...X-XX....,...,.......,,,B,:,..,,,.X------------------
X..............,....,..XX-XXX,,,XXXXXX.,.....,......,.,B.BB.B,,,,X------------------
X.............,...H..XX-XX..........XXX..H....,.....,,,......,...X------------------
X.............,,,...X-XX......:.......XX....,,,..............,...X------------------
X............,...,.X-X.................XX.,,...,.............,...X------------------
X............,....X-X.........:.........XX.....,.............,,,,X------------------
X...........,.....XX...,,,..........,,,..X......,...............BX------------------
X...........,,,..X-X...,T,....E.....,T,..XX...,,,........:....B.BX------------------
X...........,..,,XX....,,,..........,,,...X,,,..,...............BX------------------
X...........,....XX.......................X,,,,,,,,,,,,XXX,,,,,XXX------------------
X...........,.E..XX..........XX,..........XX,,E,,,,,,,,XXX,,,,,XXX------------------
X..........,....X-X.........,XX,..........XX....,,,,,,..........BX-------XLLLX------
X..........,....XX,,,,,,,,,XX.W.X,,,,,,,,,,X....,,...,....E......X---HXXXX,,,XXXAX--
X....E.....,,,,,XX,.E.E.H.HXX.E.X..H...E.E,X,,,,,,.A.,...........X---X.....E.....X--
X..........,....XX,,,,,,,,,,,.K.,,,,,,,,,,,X....,,...,...........X---X.....H.....X--
X..........,....XX...........XX,...........X....,,,,,,,.........BX---X.E...E..E..X--
X..........,.....XX..........,.,..........X.....,...,.,..,,,,,,,,X---X...........X--
X...........,...,XX..........,H,..........X,....,..E,,,..,H,,..A,X---X...........X--
X...........,.,,.XX..W..E....,A,..A.E.....X.,,,.,........,,,,A..,X---XXXXX,,,XXXXX--
X...........,,....XX.........,.,.........X.....,,..........B,...,X-------X,,,X------
X...........,.....XX.........,H,.........X......,........,,,,,,,,XXXXXXXXX,,,XXXXXXX
X...........,....,.XX....E...,.,...E....X.,....,.........,...,.A.XX.,,,,......,,,,.X
X............,.,,...XX.......,E,.......X...,,..,.........,...,...XX.,H,,......,,A,.X
X............,,......XXX.....,.,......X...A..,,..........,...,...XX.,.,,...E..,,.,.X
X............,......,..XXX...,E,....XX.,......,..........,,,,,...XX.,H,,......,,A,.X
X.............,.....,....XXXX,,,.XXX,,,,,,,,,,,,,,,,,,XXXXXXXXXXXXXE,.,,..,,,.,,.,.X
X..............,,..,.....,..XXXXX,,,,,,,,,,,,,,,,,,,,,XXXXXXXXXXXXX.,H,,..,T,.,,A,EX
X................,.,..A..,....,....,..E..,.,...................BBXX.,.,,..,,,.,,A,.X
X.................,,.....,....,.H..,......,......................XX.,H,,......,,.,.X
X...................,,..,.....,.....,...,,...............,,,,,...,,.,H,,......,,A,.X
X.....................,,,.....,.....,.,,.................,...,...,,.,,,,......,,,,.X
X.....E.................,,,,..,...,,,,...................,.E.,,,,,,................X
X...........................,,,,,,.......................,...,,.,,,................X
X..............E...............................E.........,,,,,,,,,,...,,,,,,,,.XXX.X
X...............................................................E,,...,H,E.H.,.X-X.X
X................................................................,,...,,,,,,,,.X-X.X
X................................................................,,...,.,,,,.,.X-X.X
X................................................................,,...,E,W,,E,.X-X.X
X.................................E..............................,,...,,,,,,,,.X-X.X
X...................................................A:...........,,...,H,E.H.,.X-X.X
X..........BB.....BB...............................XXXXXX,,,,..H.,,.E.,,,,,,,,.X-XEX
X.....XXX,XXXX,,,XXXX,XXX........................X,XXXXXX,,,XX...,,............X-X.X
X.....XXX,XXXX,,,XXXX,XXXB......................X..A:X:......X...,,............X-X.X
X,,,,,XXA..,.,....,,,..XXB...........E..........XE...XX...E.HX...,,....XXXXXXXXX-X.X
X.....XX...,,,.E.E,.,.AXX......................X.....XX......X...XX....X---------X.X
X.....,,,,.,,,...,,,,,.,,......................X.....XX......,...XX....XXXXXXXXXXX.X
X.....,,.,.,,,...,...,.,,.....E................,.....++......,...XX................X
X.....,,,,.H..A,,,.H.,.,,......................,.W..H++...,,,,...XX.......E........X
X.....,,H,.,,,.,,,...,.,,.........:............K.....++..:,T,,.E.XX................X
X.....,,,,.,.,...,,,,,.,,......................,.....XX...,,,,...XX.....XXXXXXXXXXXX
X.....XX,,,,,,.E.,,,,,EXX......................X.....XX......,...XX..E..X-----------
X.....XX..,,,,,..,...,.XX......................X.....XX....E.X...XX.....X-XXXXXXXX--
X.....XX,,,.,.,..,...,.XX:........:.............XE...XX......X.E.XX.....X-X....,HX--
X.....,,E.,A,,,.:,...,.,,.......................XX,A:X:...E.HX...XX+++++X-X..E.,.X--
X.....,,,,,,,....,,,,,.,,........................X,XXXXXX,,,,X...XX.....X-X....,:X--
X..E..,,,...,,,,,,.W,,.,B,,,,,,,,............................,,,.XX.....XXX....,.X--
X.....,,,...,,...,..A..,,...,...,.E......................,,,.,.,.XX.....,+,..E.,AX--
X.....,,,...,,...,,....,,...,...,,,,,,.............,,,,,.,,,.,,,BXX.....XXX....,.X--
X:....XX,,,,,,...,,,,,.XX...,...,,...,.............,...,...,,,..BXX..E..X-XXXXXXXX--
X,,...XX....H,,,,,.....XX,,,,,,,,,...,.............,...,...,.,..BXX.....X-XXXXXXXX--
X.,...XXXX,,,,,,,,,,,XXXX,,,,....,...,.............,...,.E.,,,..BXX.....X-X..E.,AX--
X,,...XXXX,,,,,,,,,,,XXXXH,,,,...,,,,,.............,,,,,....A..BBXX.....XXX....,.X--
X.........E.....E..W.E..,,,,:,...............................BB.:XX.....,+,....,HX--
XXXXXXXXXXXXXXXXXXXXXXXXXXXXXXXXXXXXXXXXX,,,,,,,XXXXXXXXXXX,,,XXXXX.....XXX..E.,.X--
----------------------------------------X+++++++X-------X...W,..X-X.....X-X....,AX--
----------------------------------------X.......X-------XH..,,.HX-X.....X-X....,.X--
----------------------------------------X.......X-------X.......X-X.,,,.X-XXXXXXXX--
-------------XXXXXXX--------------------X,,,,,,,X-------X.......X-X.,T,.X-XXXXXXXX--
-------------X.....X--------------------X....,,,X-------X...A...X-X.,,,.X-X..E.,HX--
-------------X.,,,.X--------------------X,,,,...X-------X.......X-X.....XXX....,.X--
-------------X.,T,.X--------------------X.....,,X-------X.......X-X.....,+,....,.X--
-------------X.,,,.X--------------------X...,,...X------X...:...X-X.....XXX....,.X--
-------------X.....X---------------------X,,...,,X------XA.....AX-X.....X-X....,HX--
-------------X.....X---------------------X....,...X-----X.......X-X..E..X-X..E.,.X--
-------------X.....X---------------------X...,...,.XXXXXXXX++XXXXXX.....X-XXXXXXXX--
-------------X.....X----------------------X,,...,..,.,.,.......XXLL.....XXXXXXXXX---
-------------X.....XXXX-------------------X.....,.,..,.,.......XXLL.....,XX.E..:X---
-------------X.....X.HX--------------------X...,..,..,.,.........LL.....,,,.....X---
-------------X..E..+.AX---------------------X.,...,..,.,.E..A....LL.....,,,.....X---
-------------X.....X..X----------------------XX...,.,..,.........LL..E..,,,.....X---
-------------X.....X.HX------------------------XX,..,..,.........LL.....XXX.....X---
-------------X.....XXXX--------------------------XX.,..,.......XXLL.....X-X..H..X---
-------------X..E..X-------------------------------XXXXXXXXXXXXXXXX.....X-X..E..X---
-------------X.....X----------------------------------------------X:...:X-X.....X---
-------------X.....X----------------------------------------------XXXXXXX-X.....X---
-------------XXX,XXX---------------------------------------XXXXXXXXXXXXXXXX.E.ttX---
---------------X>X-----------------------------------------XtttttttttttttXX:..t.X---
-----------------------------------------------------------X,,,,,,,,,,,,,XXXXXXXX---
-----------------------------------------------------------X,,,,,,,,,,,,,X----------
-----------------------------------------------------------XE.E.E.E.E.E.EX----------
-----------------------------------------------------------X.............X----------
-----------------------------------------------------------XE.E.E.E...E.EX----------
-----------------------------------------------------------X........E....X----------
-----------------------------------------------------------XE.E.E.E...E.EX----------
-----------------------------------------------------------X.............X----------
-----------------------------------------------------------XE.E.E.E.E.E.EX----------
-----------------------------------------------------------X.............X----------
-----------------------------------------------------------XE.E.E.E.E.E.EX----------
-----------------------------------------------------------X.............X----------
-----------------------------------------------------------XE.E.E.E...E.EX----------
-----------------------------------------------------------X........E....X----------
-----------------------------------------------------------XE.E.E.E...E.EX----------
-----------------------------------------------------------X.............X----------
-----------------------------------------------------------XE.E.E.E.E.E.EX----------
-----------------------------------------------------------XXXXXXXXXXXXXXX----------
