----------------------XXXXXXXXXX--------
--------------------XX....<..<..XX------
-----------------XXX...<.<........XX----
---------------XX...................XX--
--------------X.......................X-
--------------X...H.....,....H........X-
-------------X.........,.,,,,,,,.......X
-------------X.........,,,,,,,,,.......X
-------------X.........,,.,...,,....H..X
-------------X..H.....,,,.,E.,,,,,.....X
-------------X........,.,.,,,,,,,,,....X
-------------X........,.,....,,,,,.....X
-------------X..H.....,.,...,,,W,......X
--------------X.......,.,...,,,,......X-
--------------X....H...,,,,,,,,,......X-
---------------XX......,,,,,,,,,.....X--
-----------------X........,.........X---
-----------------X.................X----
------------------XXXX...........XX-----
----------------------XXXXX,XXXXX-------
--------------------------X,X-----------
--------------------------X.X-----------
--------------------------X,X-----------
--------------------------XWX-----------
--------------------------X.X-----------
--------------------------X.X-----------
--------------------------X.X-----------
--------------------------X.X-----------
--------------------------X.X-----------
--------------------------X.X-----------
--------------------------X.X-----------
-------------------------X..X-----------
-------------------------XEX------------
-------------------------X.X------------
-------------------------X.X------------
-------------------------X.X------------
-------------------------X.X------------
-------------------------XEX------------
-------------------------X.X------------
-------------------------X.X------------
-------------------------X.X------------
-------------------------X.X------------
-------------------------X.X------------
-------------------------X.X------------
-------------------------XEX------------
-------------------------X.X------------
-------------------------X.X------------
-------------------------X.X------------
-------------------------X.X------------
------------------------X.X-------------
------------------------X.X-------------
------------------------XEX-------------
------------------------X.X-------------
------------------------X.X-------------
------------------------X.X-------------
------------------------X.X-------------
------------------------X.X-------------
------------------------X.X-------------
------------------------X.X-------------
------------------------X.X-------------
------------------------X.X-------------
------------------------X.X-------------
------------------------X.X-------------
------------------------X.X-------------
------------------------E.X-------------
------------------------X.X-------------
-----------------------X.X--------------
-----------------------X.X--------------
-----------------------X.X--------------
-----------------------X.X--------------
-----------------------X.X--------------
-----------------------XWX--------------
-----------------------X.X--------------
-----------------------X.X--------------
-----------------------X.X--------------
-----------------------X.X--------------
-----------------------X.X--------------
-----------------------X.X--------------
-----------------------X.X--------------
-----------------------X.X--------------
-----------------------X.X--------------
-----------------------X.X--------------
-----------------------XX---------------
-----------------------XX---------------
----------------------X.X---------------
----------------------X.X---------------
----------------------X.X---------------
----------------------XEX---------------
----------------------X.X---------------
----------------------X.X---------------
----------------------X.X---------------
----------------------X.X---------------
----------------------X.X---------------
----------------------X.X---------------
----------------------X.X---------------
----------------------X.X---------------
----------------------X.X---------------
----------------------X.X---------------
----------------------X.X---------------
----------------------XX----------------
----------------------XX----------------
---------------------X-X----------------
---------------------X-X----------------
---------------------X-X----------------
---------------------X-X----------------
---------------------X-X----------------
---------------------X-X----------------
---------------------X-X----------------
---------------------X-X----------------
---------------------X-X----------------
---------------------X-X----------------
---------------------X-X----------------
---------------------X-X----------------
---------------------X-X----------------
---------------------X-X----------------
---------------------X-X----------------
---------------------XX-----------------
---------------------XX-----------------
---------------------XX-----------------
--------------------X-X-----------------
--------------------X-X-----------------
--------------------X-X-----------------
--------------------X-X-----------------
--------------------X-X-----------------
--------------------X-X-----------------
--------------------X-X-----------------
--------------------X-X-----------------
--------------------X-X-----------------
--------------------X-X-----------------
--------------------X-X-----------------
--------------------X-X-----------------
--------------------X-X-----------------
--------------------X-X-----------------
--------------------XX------------------
--------------------XX------------------
--------------------XX------------------
-------------------X-X------------------
-------------------X-X------------------
-------------------X-X------------------
-------------------X-X------------------
-------------------X-X------------------
-------------------X-X------------------
-------------------X-X------------------
-------------------X-X------------------
-------------------X-X------------------
-------------------X-X------------------
-------------------X-X------------------
-------------------X-X------------------
-------------------X-X------------------
-------------------X-X------------------
-------------------XX-------------------
-------------------HX-------------------
-------------------XX-------------------
-------------------XX-------------------
------------------X-X-------------------
------------------X-X-------------------
------------------X-X-------------------
------------------X-X-------------------
------------------X-X-------------------
------------------X-X-------------------
------------------X-X-------------------
------------------X-X-------------------
------------------X-X-------------------
------------------X-X-------------------
------------------X-X-------------------
------------------X-X-------------------
------------------XX--------------------
------------------XX--------------------
------------------XX--------------------
------------------XX--------------------
------------------XX--------------------
-----------------X-X--------------------
-----------------X-X--------------------
-----------------X-X--------------------
-----------------X-X--------------------
-----------------X-X--------------------
-----------------X-X--------------------
-----------------X-X--------------------
-----------------X-X--------------------
-----------------X-X--------------------
-----------------X-X--------------------
-----------------X-X--------------------
-----------------X-X--------------------
-----------------XX---------------------
-----------------XX---------------------
-----------------XX---------------------
-----------------XX---------------------
-----------------WX---------------------
-----------------XX---------------------
----------------X.X---------------------
----------------X.X---------------------
----------------X.XX--------------------
----------------X...XX------------------
----------------X...H.XX----------------
----------------X.X..E.X----------------
----------------X.X....X----------------
----------------X.X...W-----------------
----------------X,X...X-----------------
----------------XEX.E.X-----------------
----------------X.XX..X-----------------
----------------XEXX..X-----------------
----------------XEXXWX------------------
----------------X.+X.X------------------
----------------XE+X.X------------------
---------------X.X+..X------------------
---------------XEX+.EX------------------
---------------X.X+XX-------------------
---------------XHX--X-------------------
---------------X,X--X-------------------
---------------XWX----------------------
------XXXXXXXXXX,XXXXXXXXXXXXX----------
-XXXXX........................X---------
-X.............................X--------
-X....................E.........X-------
-X...............................X------
-X.........................E......X-----
X..................................X----
X..............E...................X----
X.......E..........................X----
X...........................E......X----
X.................................X-----
X.................................X-----
X.................................X-----
X.................................X-----
X.................................X-----
X....E.............E..............X-----
X.................................X-----
X.............................E...X-----
X..........E.....................X------
-X...............................X------
-X.:.........:...................X------
-X...................:.....:.....X------
-X...............................X------
-X....E..........................X------
-X...................E...........X------
-X...........................E...X------
-X..............................X-------
-X.............E................X-------
-X........................H.....X-------
-X..............................X-------
-X..............................X-------
-X.................E............X-------
-X.....E........................X-------
-X..............................X-------
-X.............................X--------
-X...........E.................X--------
-X...................E.........X--------
--X.......................E....X--------
--X............................X--------
--X....E.......................X--------
--X............................X--------
--X.......E....................X--------
--X...........................X---------
--X............E....E.........X---------
--X...........................X---------
--X...........................X---------
--X........................E..X---------
--X...........................X---------
--X...........................X---------
--X...........................X---------
--X...........................X---------
--X...E..................E...X----------
--X..........................X----------
--X............E.............X----------
---X.........................X----------
---X................E........X----------
---X..E......................X----------
---X.......E.................X----------
---X.......................E.X----------
---X............H...........X-----------
---X........................X-----------
---X....H...............E...X-----------
---X........................X-----------
---X........................X-----------
---X........................X-----------
---X...E....................X-----------
---X........................X-----------
---X.......................X------------
---X.......E...............X------------
---X.......................X------------
----X......................X------------
----X...............E......X------------
----X......................X------------
----X......................X------------
----X......................X------------
----X......E...............X------------
----X.....................X-------------
----X.....................X-------------
----X.....................X-------------
----X..................E..X-------------
----X............E........X-------------
----X.....................X-------------
----X.....................X-------------
----X....E....H...........X-------------
----X.W....W....W.....W..X--------------
-----X..............E....X--------------
-----X...................X--------------
-----X.........E.........X--------------
-----X...................X--------------
-----X................E..X--------------
-----X...................X--------------
-----X...................X--------------
-----X...................X--------------
-----X...E..............X---------------
-----X.............H....X---------------
-----X..................X---------------
-----X..................X---------------
-----X.........E.....E..X---------------
-----X..................X---------------
-----X..................X---------------
-----X..................X---------------
------X................X----------------
------X................X----------------
------X...H......E.....X----------------
------X................X----------------
------X................X----------------
------X................X----------------
------X............H...X----------------
------X................X----------------
------X..E............X-----------------
------X...............X-----------------
------X.......E.......X-----------------
------X.....H.........X-----------------
------X...............X-----------------
------X...............X-----------------
------X...............X-----------------
-------X..............X-----------------
-------X..............X-----------------
-------X.............X------------------
-------X.....E.....E.X------------------
-------X.............X------------------
-------X.............X------------------
-------X.............X------------------
-------X.............X------------------
-------X.............X------------------
-------X......H....E.X------------------
-------X............X-------------------
-------X............X-------------------
-------X..E.........X-------------------
-------X............X-------------------
-------X............X-------------------
--------X...........X-------------------
--------X.........E.X-------------------
--------X....EE..E..X-------------------
--------X..........X--------------------
--------X.E........X--------------------
--------X..........X--------------------
--------X..........X--------------------
--------X,,,,,,,,,,X--------------------
--------X..........X--------------------
-------XX..........X--------------------
-------X-X...+++...X-X------------------
-------XXX,,,,,,,,,XXX------------------
-------X,W++++W+++W+.X------------------
-------X,,.........,.X------------------
-------X,,.........,.X------------------
-------X,W........W,.X------------------
-------X,,.........,.X------------------
-------X,,.........,.X------------------
-------X,W....W...W,.X------------------
-------X,:,,:,,:,,,:.X------------------
-------X,...,,,,...,.X------------------
-------X,.W.,,,,.W.,.X------------------
-------X,,,,,,,,,,,,.X------------------
-------X...,...,.....X------------------
-------X...,...,.....X------------------
-------X...,...,.....X------------------
-------X...,:..:.....X------------------
-------X...,,>>>.....X------------------
-------X.............X------------------
-------XXXXXXXXXXXXXXX------------------
