---XX-XXXXXXX-XXXXXXX-XX-----------------------------------------------------------------------------------------------------------
---XXXX,,,,.XXX,,,,.XXXX-----------------------------------------------------------------------------------------------------------
---X,,,,,.,.,.,,,.,,,,,X-----------------------------------------------------------------------------------------------------------
---X,,,,,,,.,.,,,,,,,,,X-----------------------------------------------------------------------------------------------------------
---X,,,,,,,,,,,,,,,,,,,X---------------------------------------------------------XXXXXXX-------------------------------------------
---X,,,.....,,,.....,,,X---------------------------------------------------------XE.E.EX-------------------------------------------
---X.......,,,,,,.......XX-------------------------------------------------------X.....X-------------------------------------------
--X.....,,,......,,,,....,X------------------------------------------------------XE.E.EX-------------------------------------------
--X...,,.............,,..,.X-----------------------------------------------------X.....X-------------------------------------------
XX,.,,.................,..,.X----------------------------------------------------XE.E.EX-------------------------------------------
X,,.,..................,...,X----------------------------------------------------X.....X-------------------------------------------
X,,.,...................,..,,X---------------XXXXXX------------------------------Xt.E.tX-------------------------------------------
X,,.,......,,,....,,,...,...,XX------------XX------X-----------------------------XXXXXXX--------XLLLX------------------------------
X,,.,....,,,,.,,,,...,...,,.,,,XX---------X--------X----------------XX---XXX-------------------XX.E.X------------------------------
X,,.,..,,,,..,,...,,.,.....,,.,,,X-------X----------X--------------X,,XXX,,,XX-----------------X....X------------------------------
X,,.,..,,....,,,,,..,.,......,.,.XX------X-----XXX--X-------------X,....,,,,.X-XXX--XXXXXX-----X,,,,X--------XXXXX-XXXXX-XXX-------
X,,..,.,,..,,,,,,,,.,..,,,,...,.XXX------XX,---X-X--X--XXXXXX---XX,,,,,,,,,.,XX,,.XX..,.,E-----X,,,,X--------:.,HXXX...XXH..X------
X.,,.,.,,..,.,,,,,,,.,.....,...,...XX----XXXXXX--XX-XXX..,,,,XXX,,,...,,,,.,...,,.E..,,,,X---XX,,,,,,XX------X,,,,,,,,,,,,,,,X-----
-X,,.,.,,.,.,XX,,,,.,,,,,,,.,...,,,,XXX-X,,,,XX----X--X,,,,,,,,,,....,.,..,,..,,,,..,,,.,XX-X:.,,,,,,.:XXX---XE,,,..,,,..,,,E.X----
-X,,.,.,,.,.X--X..,,,.,,,,.,.,......,.,X,...,,X------XX,,..,,,.....,,,,...,,..,E,,.,.,,H,,X-X,,.,.T,,,,,EX---X.,,,,,.,,,,,,,,,X----
-X,,..,,,.,,X-XX...,,,,,,,,.,.,....,,,.,......XXXXXXX.,,,,,,..,,.,,,,.....,,..,,,,..,,.,,,XXX,.,,,,,,,,XXX---X.,,,,,.,XXXX,,,XX----
-X.,,.,,.,.,,X.......XXX,,,..,,...,.,,,......,.,.,.,,,.,,...,,,.,,,........,,.,,,,.,,A,,,,.,,,,.,,,,,,,X-----X.,,,,,.,XX++,,,XXXXXX
--X,,.,.,.,.,,.....XX---X,,,.,.,.,.,.,.......,.,,.,..,,........,,,,........,.,.,,,,,,,,.,,.X,,,.,,:,,,,XXXXXXX.,,,:,.,XX,,,,,,,H,,X
--X,.,.,.,,.,,,,.XX-----X.,,,.,,.,.,,.......,.,,..,.,.......:..,,,,...:.....,,.,,,,...,,,,.,,,,.,,,,,,,,,E+,,,.,:,,W.,X,.,,,,.,,,,X
--X.,.,,.,.,.,,.,X-------X,,,.,.,.,,,......,.,.,.,,,......:....,,,,..:...:..,,.,+,,..:,,,,.X,,,.,,,,,,,,,,+,,,.,,,,,.,,E.,,,,:,H,,X
---X,.,.,.,.,.,,,X-------X,,,..,,.,,,.,,..,.,.,.,,.........:.:.,,,,....:....,,.,+,,...,,,,.X,,,.....,,,,,E+,,,.,,,,,,,,,.,,,,.,,,,X
---X.,.,,..,.,,,.X--------X,,,.,,.,,,,..,,..,,.,,.........:..:.,,,,...:.....,,.,,.,:..,,,,.,,,,,,,,,,.,XXXXXX,.,,::,:,XB.,,,,.,,,,X
----XXXXX,..,,.,,X--------X,,,,,.,,.,.XX,,.,,..,,.........:....,,,,....:.:.,,..,,.,,..,,,,BXX,.,,,,,..BX-----X.,,,,,.,XXXX,,,XXHXXX
---------X..,.,,,,X------X.,,,,,.,,,,X--X,,,,.,,.........,,,,,,.,,,........,,.,,,,,,.T,,,,X-X,,,,,,,..,XXX---X.,,,,,.,XXXX,,,XXXXXX
---------X,..,,.,.XX-----X.,,,,,,,.,X---X,,,,.,.......,,,......,..,,,......,,.,,,,,...,,,XX-X,...,,.,.,,EX---X.,,,,,.,,,,,,,,,X----
----------X..,.,,,,.XX--X..,,.,,,,.,X---X,,,,.,......,..,,,,,,,...,,.,,....,,.,E,,,.:.,,,X--X,,,,..,.,,XXX---X.,,,,,..........X----
----------X..,.,.,,...XX..,,,,,.,,.,XXXX,,.,,,,.....,.,,.,,,,,,,,,,,,..,...,,.,,,,,...,.,XX-X,......,,,X-----XE,,,,,,,,,,,,,,X-----
----------X,..,.,.,,,...,,,.,,,..,,,,,,,,,,.,,,....,.,..,.XXXXXXXXX.,,,.,:.:.,.,,.,,,,..,,X-X,....:...,X-----X.,.XXX...XXX..X------
----------X,..,..,.,.,,,,,,,,.,..,,,,,:,,,,.,,,....,,..,..X--XXXXX-X.,.,,.:.,,.,,E.,,...,:X-XHH......HHX-----:XXHX-X,,EX-HXX-------
---------X..,..,.,..,,,,,,.,.,..,.,,.,,,.,,.,,,:...,..,..>XXXX,,,HXX..,,.,,,.,,,,,,,,,,,,X--XXXX,,,,XXXX-----------XXXXX-----------
---------X,..,..,.,,,.,,.,,.,..,.,.,.....,.,,,,..:,,.,..>,,.,,,....XX..,,,..,.:.........,X-----XX+++X------------------------------
-------XXX.,..,..,...,,,,,,,...,.,,.....,..,,,,:.:,,.,XXX,.,,,,,,,..XX.,..,,,,,.,,,,,,,,,X---XXXX,E,XXX----------------------------
--------X.,.,,.,..,,,,,,,.....,..,,.....,..,,,,..:,,.,X-X.,....,..,.XX.,,,,.,.,.,.,..,.AAAX--XH,,,,,,.A----------------------------
---------XX,..,.,.............,.,.,.....,.,.,,,.:.,,.,X-X,,..E,,,:,EXX.,,.,.,,,.,..,.,..,HX--XH,,,,,,.X----------------------------
-----------X,,.,.,,,,.........,.,.,......,,,.,,...,,.,XXX,,..,.,,,,.,,,,,,,,,,,.,...,,..,,X--X,,,,,,,.X----------------------------
------------X.,.,....,,,,,,....,,..,,....,,,.,,...,,.,XX,,,.E.E.,,,.,,.,........,,,,,,..,XX--X.,,,,,,.X----------------------------
-------------XX,.,,,,,,,,..,,,,XXXXX.,,,,.,,.,,...,,.,XX,.,,,,..,,,.,,,,,,,,,,,,,....,..,X---XE,..,,,EX----------------------------
---------------X,,,,,,,,,,,...XX---X....X.,,,,....,,.,XX,.,.,,,,,.,.HX.,,.,..........,..,XXXXXXX,,,,XXX----------------------------
----------------XXXXXXXX.,,XXX-----X...XXXXX,,....,,.,XXH.,.:,,,.E.XXX.,,,...........,:.,,,E,t.X...,X------------------------------
------------------------XX.X-------X...X---X,,....,,.,X-X..,,,,,..,XXX.,,.,..........,.W,,,.,ttX....X------------------------------
--------------------------X----XXXXX..X--XX,,,....,,.,.XXX..E...,XX,XX.,,.,..........,..E,,E,,HX,,,,X------------------------------
-------------------------------XX.....X--X,.,,....,,..,..XXXX,,,HXXXE.,E,.,..........,..,,,...EX,,,,X------------------------------
---------------------------------XXXXX----X.,,,...,,...,..XXX,,,XXXX.,.,.,...........,..,,,E..HX,,,,X------------------------------
------------------------------------------X,,,,...,,....,.:.:,.,....,.,,.,...........,..,,XXHHKX....X------------------------------
------------------------------------------X,,.,..,.,.....,,,,,,,,,,,E,..,,,,,,,,,....,..,XX---XX....XXXX---------------------------
------------------------------------------X,.,,,,.,........::,.,..,,,.,,,,.......,,..,..,X----X,,,,,,,EH---------------------------
------------------------------------------X,.,.,,,..........:,.,,,,,,,.,..,,,,,...,..,..,XX---X,,,,,,,.H---------------------------
-------------------------------------------X,,.....,,,,......,.,.,....,.,,.....,,,.,,,..,HX---X,,,,,,,EH---------------------------
-------------------------------------------X,,..,,,....,,,...,.,,....,.,...,,,,...,,.,..,,X---XX,,,,XXXX---------------------------
-------------------------------------------X,,.,...,,,,,.,...,.,.....,.,.,,....,....,,..EXX----X....X------------------------------
------------------------------------------X.,.,.,,,,,,,,,.,..,.,....,.,,,.......,,,,.,..,X-----XX,,,X------------------------------
-------------------------------------------XX,.,,......,.,,..,.,....,.,,............,,..,XXXXXXXX,,,XXXXHX-------------------------
--------------------------------------------X.,.,.......,,,..,.,...,..,,.............,..,,....++....B.,,,X-------------------------
--------------------------------------------X.,,........,,,..,.,...,.,,..............,..,,T...++........E+-------------------------
--------------------------------------------X,.,.,,,,,..,,,..,.,...,.,,......,,,,,,,,,,:.,..E.++......E,,X-------------------------
-------------------------------------------X.,,.,X,,XX..,,,..,,,....,,,.....,,XXX,,,XXX,XXX,XXXXX,,,X,,.HX-------------------------
-------------------------------------------X,.,.,X..X,..,,.,.,,,....,,,.....,.XXX,,XX-XXX-XXX--XX,,,XXXXX--------------------------
-----------------------------------------XXX.,..,,..,,..,,.,.,,,....,,,.....,.X<,<,,.X---------X....XX-----------------------------
---------------------------------------XX,.,,...,X..X,..,,.,.,,,....,,,.....,.X<,<.,.X-XXXXXEXXX....,X-----------------------------
---------------------------------------X.,.,....,X,,XX..,,.,.,,,...,.,,.,,,.,.,,,,,,.XXX........,,,,,X-----------------------------
----------------------------------------X,,,...........,.,.,.,.,...,,.,.,,,,,.XX,,,,.,,E........,,T,EX-----------------------------
----------------------------------------X,.,...........,,.,..,.,..,.,.,.,:,,,.XX.....,,,........,,,,XX-----------------------------
-----------------------------------XX----X.,...........,,.,..,.,.,..,,..,,,,,.X,,,,,.,,,........,,,:X------------------------------
---------------------------------XX,.XXXX,,.,..........,,.,..,.,.,.,.,......,.,,,,.,.XXXX,EXX,,,,EXX-------------------------------
---------------------------------X,,,,,,,,,.,..........,,.,.:,.,.,.,.,......,.XX,,,,.X--X,X-XXXXXXX--------------------------------
------------------------------XXXX,...,,,,.,,..........,..,..,.,.,.,.,......,.XXXX,XXX--X:XX------XXXXXXXX-------------------------
------------------------------X.,,,....,.,,,.,........,,.,.::,.,.,,.,.......,.X--X,X+---X..X------Xt.tXXtX-------------------------
------------------------------XX,,,,..,,..XX,,.......,,..,...,.,,,,,,,,,,,,,,,X--X,X----X..X------X...XX.X-------------------------
-------------------------------:,,,,,,,.XX-X,,......,.,.,..:.,.,T...........,.XXXX,XX---X..X------XE.EXXEX-------------------------
---------------------------XXXXX,,,.,,..X--X.,,.....,,..,:...,.,............,.EX,,..X---X..X------X...XX.X-------------------------
---------------------------XXX,.,,......X---X,,.....,,.,...::,,,E,,,,,,,,,,,,.XX,,,,X-XX...X------XE.EXXEX-------------------------
---------------------------X,.,.,,...,,.X---X.,,,...,,.,.,,XXXXX,XXX,,,,XXX,XX-X....XXX...,XXXX---X...XX.X-------------------------
---------------------------X,.,.,,.,,,,,X---X.,..,,.,,..,,:X---X,X-XX,,,X-X,X--X....,+...,,,...X--XE.EXXEX-------------------------
---------------------------XXX,.,..,...,,X---X,,,..,XX..,,.X---X,X-XX,,,X-X,X--X..,,XXXXXX,....X--XXXXXX.X-------------------------
---------------------------XXXXX,,,,...,,.XXX,.,.,,.X-XXX,.X---XEX-XE...X-XEX--X,,,.X----X..A.A.XX-----XEX-------------------------
-------------------------------:,,,,.....,....,,XXXX-----XXX---XEX-+....XXXXXXXX,...X----X......,X-----X.X-------------------------
------------------------------XX,,,,,....,......X--X-------X---XHX-X,,,,,,.B.,.,,,,,X----X..A.H.,X-----XEX-------------------------
------------------------------X.,..,,....,,....X---------------XXX-X,,,E.,...,,.,,,,XX----X....,X------XXX-------------------------
------------------------------XXXX.,.,,..,.....X-------------------X,,,,.,,..,,.,,,,,X-----X...X-----------------------------------
----------------------------------XX,,,,,...,,X--------------------X,E,,..,..,..,,,,,X------XXX------------------------------------
-----------------------------------X..,,,..,XXX--------------------X:,,XXXX:,XXXX,,,:X---------------------------------------------
------------------------------------XXXXX,,X-----------------------XXXXX--X+XX--XXXXXX---------------------------------------------
-----------------------------------------XX-------------------------------XAX------------------------------------------------------
--------------------------------------------------------------------------X.X------------------------------------------------------
--------------------------------------------------------------------------XAX------------------------------------------------------
--------------------------------------------------------------------------XHX------------------------------------------------------
--------------------------------------------------------------------------XXX------------------------------------------------------
