------------------------------------------------------------XXXXX---XXXXX------XXXXX-------------------------------------------------------------------------------
------------------------------------------------------------X...X---X...X------X...X-------------------------------------------------------------------------------
------------------------------------------------------------X.E.X---X.E.X------X.E.X-------------------------------------------------------------------------------
------------------------------------------------------------X...X---X...X------X...X-------------------------------------------------------------------------------
------------------------------------------------------------X...X---X...X------X...X-------------------------------------------------------------------------------
------------------------------------------------------------X.E.X---X.E.X------X.E.X-------------------------------------------------------------------------------
------------------------------------------------------------X...X---X...X------X...X-------------------------------------------------------------------------------
------------------------------------------------------------X...X---X...X------X...X-------------------------------------------------------------------------------
------------------------------------------------------------X.E.X---X.E.X------X.E.X-------------------------------------------------------------------------------
------------------------------------------------------------X...X---X...X------X...X-------------------------------------------------------------------------------
------------------------------------------------------------X...X---X...X------X.E.X-------------------------------------------------------------------------------
------------------------------------------------------------X.E.X---X.E.X------X...X-------------------------------------------------------------------------------
------------------------------------------------------------X...X---X...X------X...X-------------------------------------------------------------------------------
------------------------------------------------------------X.E.X---X...X------X.E.X-------------------------------------------------------------------------------
------------------------------------------------------------X...X---X.E.X------X...X-------------------------------------------------------------------------------
------------------------------------------------------------X...X---X...X------X...X-------------------------------------------------------------------------------
------------------------------------------------------------X.E.X---X.E.X------X.E.X-------------------------------------------------------------------------------
------------------------------------------------------------X...X---X...X------X...X-------------------------------------------------------------------------------
------------------------------------------------------------X,,,X---X,,,X------X,,,X-------------------------------------------------------------------------------
------------------------------------------------------------HHHHX---HHHHX------HHHHX-------------------------------------------------------------------------------
------------------------------------------------------------X.A.X---X.A.X------X.A.X-------------------------------------------------------------------------------
------------------------------------------------------------X...X---X...X------X...X-------------------------------------------------------------------------------
------------------------------------------------------------X,,,X---X,,,X------X,,,X-------------------------------------------------------------------------------
XXXXXXXXXXXXXXXXXXXXXXXXXXXXXXXXXXXXXXXXXXXXXXXXXXXX--------X,,,HHHHX,,,XHHHHHHX,,,X-------------------------------------------------------------------------------
X..................................................X--------X.....................,X-------------------------------------------------------------------------------
X.,,,,,,,,,,,,,,,,,,,,,,,,,,,,,,,,,,,,,,,,,,,,,,,,,X-------XX.....E.E.E......E....,X-------------------------------------------------------------------------------
X.,........,,,,,,.................................,X-------X,.....................,X-------------------------------------------------------------------------------
X.,.......,......,,,,,,,,,........................,X-------XX.....................,XXXXXXXXXXXXXXX-----------------------------------------------------------------
X.,......,................,,......................,X--------X.....................,..,...,......HXXXXHX------------------------------------------------------------
X.,.....,...................,,....................,X--------X.....A....,,,,,,,....,..,...,.......,,..HX------------------------------------------------------------
X.,....,......................,,..................,X--------X...XXXXX..,XXXXX,....,..,...,.....E.,,.AHX------------------------------------------------------------
X.,...,.........................,.................,X--------X,,,X---X..,X---X,....,..,...,.......,,..HX------------------------------------------------------------
X.,...,........................,..................,X--------X...X---X,,,X---X,,,,,,..,...,.......XXXXXX------------------------------------------------------------
X.,..,.............,,,,,,,,,.,,...................,X--------X...X---X...X---X...XXXXXX,,,XXX,,,,,X-----------------------------------------------------------------
X.,..,............,.........,.....................,XXXXXXXXXX,,,XXXXX,,,XXXXX,,,X----X...X-X.....X-----------------------------------------------------------------
X.,..,............,...............................,XXAA.,...,.....H.......H.....X----X.E.X-X.....X---------------XXXXXXXXXXXXXXXXXXXXXXXXXXXXXXXXXXXXXXXXXXXXXXXXXX
X.,...,..........,................................,X,.E.,.EW,,,,,,,,,,,,,,,,,,,,X----X...XXX,,,,,X---------------X................................................X
X.,...,..........,................................,XXHH.,...,...................X----X,,,,......,X---------------X.,,,,,,,,,,,,,,,,,,,,,,,,,,,,,,,,,,,,,,,,,,,,,,.X
X.,...,..........,................................,XXXXXXXX,,...................X----XH..,,,,...,X---------------X.,............................................,.X
X.,...,.........,.................................,X------X.,...................X----X......,...,X---------------X.,............................................,.X
X.,...,.........,.................................,X------X.,.................,,XXXXXX,,,,,,,...,XXXXHX----------X.,............................................,.X
X.,....,.......,..................................,X------X.,...E.............,...,,,,...,..,...,.,.AHX----------X.,............................................,.X
X.,....,.......,..................................,X------X.,.................,.H.,,,,.E.,..,...,.,.EHX----------X.,............................................,.X
X.,....,.......,..................................,X------X.,.................,...,,,,...,..,...,.,.AHX----------X.,............................................,.X
X.,....,.......,.........,,,,,,,,,,,,,,,XXXXXXXXXXXX------X.,.................,,,,XXXX,,,XXXXX,,,XXXXXX----------X.,............................................,.X
X.,....,......,..........>,,,,,,,,,,,,,,XXXXXXXXXX,XXXXXXXX,,,,,,,............,..AX--X,,,X---X...X---------------X.,............................................,.X
X.,....,......,..........>,.,........,,,,,.....,.....E.,.,,,,,,,,,............,.E.X--X,,,X---X...X---------------X.,............................................,.X
X.,....,.....,...........>,.,........,,,,,.....,.......,.,,,,,,,,,............,..HX--X,,,XXXXX...X---------------X.,............................................,.X
X.,....,.....,...........>,.,........,,,,,.....,.....E.,.,,,,,,,,,............,...X--X...,,,,,...X---------------XXX,,,,,,,,,,,,,...............................,.X
X.,....,....,............>,.,........,,,,,.....,.......,.,,,,,,,,,............,.EAX--X.E.,,,,,...X-----------------XXXXXXXXXXXXX,...............................,.X
X.,....,....,............>,.,........,,,,,.....,.....E.,.,,,,,,,,,............,...X--X...,,,,,...X-----------------------------X,...............................,.X
X.,....,....,............>,,,,,,,,,,,,,,XXXXXXXXXXXXXXXXXXX,,,,,,,............,.E.XXXXXXXXXXXX...X-----------------------------X,...............................,.X
X.,...,......,...........,,,,,,,,,,,,,,,XXXXXXXXXXXX------X.,.................,..,.AX--------X...X-----------XLL---------------X,...............................,.X
X.,...,......,....................................,X------X.,.................,.,.E.X--------X,,,XXXXXXXXXXXXX,XXXXXXX---------X,...............................,.X
X.,...,.......,...................................,X------X.,.................,,....X--------X....,,.....,,,...,.....X---------X,...............................,.X
X.,...,........,..................................,X------X.,.................,,,,,,XXXXXXXXXX,,,,,,.....,,,...,.E.E.X---------X,............,,,,...............,.X
X.,...,........,..................................,X------X.,..........................,,..,......,,..W..,,,...,.....X---------X,....,,,,,,,,....,,.............,.X
X.,...,.........,.................................,X-HXXXXX.,..........................,,..,......,,.....,,,...,.....X---------X,,,,,..............,,...........,.X
X.,....,.........,,,..............................,X-H.A.,,.,..........................,,..,......,,.....,,,...,.E...X---------X,....................,,.........,.X
X.,.....,...........,,,,..........................,X-H.A.,,.,..........................,,W.,......,,,,,,,XXXXXXX.....X---------X,......................,........,.X
X.,......,..............,.........................,X-H.A.,,.,..........................,,..,......,,,,,,,X-----X...E.X---------X,......................,........,.X
X.,.......,..............,........................,X-XXXXXX.,..........................,,..,......,.....,X-----X.....X---------X,.......................,.......,.X
X.,........,..............,.......................,X------X.,..........................,,..,......,.....,XXXXHXX.E.E.X---------X,,,,,,..................,.......,.X
X.,.........,.............,.......................,X------X.,,,,,,,,,,,,,,,,,,,,,,,,,,,,XXXX......,.....,,,..HXX.....X---------XXXXXX,...................,......,.X
X.,..........,.............,......................,X------X........H.H........H.........X--X......,.....,,,.AHXX,,,,,X--------------X,,,,,,,,,,,,,,,,....,......,.X
X.,...........,.............,.....................,X------XXXX,,,XXXXXXXX,,,XXXXX,,,,,XXX--X......,.....,,,..HXX,,,,,X--------------X,,,,...........,.....,.....,.X
X.,............,.............,....................,X---------X,,,X-----XX...X---X....,X----X......,.....,XXXXXXX,,,,,X--------------X,,,,...........,.....,.....,.X
X.,.............,......,,,,,,.....................,X---------X.E.X-----X,.E.X---X....,X----X,,,,,,,,,,,,,XXXXXXX,,,,,XXXXXXXXXXXXXXXX,,,,,,,,,,,,,,.,.....,.....,.X
X.,..............,,,,,,...........................,X---------X...X-----XX...X---X....,X----XXXXX,,,,,,XXXXX.,W.,,,,,,,E.,,,,,....,,,,,............,.,.....,.....,.X
X.,...............................................,X---------X...XXXXXXXX,,,XXXXX,,,,,X--------XHHAAAAX---X.,..,,,,,,,..,,,,,.E..,,,,,............,.,.....,.....,.X
X.,...............................................,X---------X......,...............E,X--------XHHAAAAX---X.,H.,,,,,,,..,,,,,....,,,,,............,.,.....,.....,.X
X.,,,,,,,,,,,,,,,,,,,,,,,,,,,,,,,,,,,,,,,,,,,,,,,,,X---------X,,,,..,................,X--------X,,,,,,X---X.,..,,,,,,,E.,,,,,.E..,,,,,............,.,......,....,.X
X..................................................X---------X...,..,...............E,X--------X......X---X.,:E.........,,,,,....,,,,,............,.,......,....,.X
XXXXXXXXXXXXXXXXXXXXXXXXXXXXXXXXXXXXXXXXXXXXXXXXXXXX---------X...,..,...,,,,,........,X--------XXXX,,,X---X.,....E..E...XXX,,....,,,,,............,.,......,....,.X
-------------------------------------------------------------X,,,XXXX...,...,,,,,,,,,,X-----------X,,,X---X.,A..........X-X,,H.A.,,K,,.......W..<.,.,......,....,.X
-------------------------------------------------------------X,,,X--X.A.,...XXXXX,,,XXX-----------X,,,XXXXX.,.E....E..E.XXX,,....,,,,,............,.,......,....,.X
-------------------------------------------------------------X,,,X--X...,..HX---X,,,X-------------X...,...,.,A...E......,,,,,....,,,,,............,.,......,....,.X
-------------------------------------------------------------X,,,XXXX,,,,..HX---X.A.X-------------X...,...,.,.E....E..E.,,,,,.E..,,,,,............,.,.....,.....,.X
-------------------------------------------------------------X...,,,,,,,,..HX---X...X-------------X...,...,.,A..........,,,,,....,,,,,............,.,.....,.....,.X
-------------------------------------------------------------X.H.,,,,,,,,.EHX---HHHHX-------------XXXXXXXXX.,E..E..E..E.,,,,,.E..,,,,,............,.,.....,.....,.X
-------------------------------------------------------------X...,,,,,,,,..HX---X,,,X---------------------X.,A..........,,,,,HHHH,,,,,............,.,.....,.....,.X
-------------------------------------------------------------XXXXXXXXXXXXXXXX---X.E.X---------------------XXXXXXXXXXXXXXXXXXXXXXXXXXX,,,,,,,,,,,,,,.,....,......,.X
--------------------------------------------------------------------------------X...X-----------------------------------------------X,,,,...........,....,......,.X
--------------------------------------------------------------------------------X...X-----------------------------------------------X,,,,...........,...,.......,.X
--------------------------------------------------------------------------------X.E.X-----------------------------------------------X,,,,,,,,,,,,,,,,...,.......,.X
--------------------------------------------------------------------------------X...X-----------------------------XXXXXXXXXXXXXXXXXXX,.................,........,.X
--------------------------------------------------------------------------------X...X---------------------------XXX,,,,,,,,,,,,,,,,,,,.................,........,.X
--------------------------------------------------------------------------------X.E.X---------------------------X.,...................................,.........,.X
--------------------------------------------------------------------------------X...X---------------------------X.,...................................,.........,.X
--------------------------------------------------------------------------------X...X---------------------------X.,,,,,.............................,,..........,.X
--------------------------------------------------------------------------------X.E.X---------------------------X.,....,,,,,,,,,,...............,,,,............,.X
--------------------------------------------------------------------------------X...X---------------------------X.,..............,,,,,,,,,,,,,,,................,.X
--------------------------------------------------------------------------------X...X---------------------------X.,.............................................,.X
--------------------------------------------------------------------------------X.E.X---------------------------X.,.............................................,.X
--------------------------------------------------------------------------------X...X---------------------------X.,.............................................,.X
--------------------------------------------------------------------------------X...X---------------------------X.,.............................................,.X
--------------------------------------------------------------------------------X.E.X---------------------------X.,.............................................,.X
--------------------------------------------------------------------------------X...X---------------------------X.,.............................................,.X
--------------------------------------------------------------------------------XXXXX---------------------------X.,.............................................,.X
----------------------------------------------------------------------------------------------------------------X.,,,,,,,,,,,,,,,,,,,,,,,,,,,,,,,,,,,,,,,,,,,,,,,.X
----------------------------------------------------------------------------------------------------------------X.................................................X
----------------------------------------------------------------------------------------------------------------XXXXXXXXXXXXXXXXXXXXXXXXXXXXXXXXXXXXXXXXXXXXXXXXXXX
