----------------------------------XXX----------------XXX------------------------------------------------------------------------------------
----------------------------------XEX----------------XEX------------------------------------------------------------------------------------
----------------------------------XEX----------------XEX------------------------------------------------------------------------------------
----------------------------------XEX----------------XEX------------------------------------------------------------------------------------
----------------------------------X.X----------------X.X------------------------------------------------------------------------------------
----------------------------------X.X----------------X.X------------------------------------------------------------------------------------
----------------------------------X.X----------------X.X------------------------------------------------------------------------------------
----------------------------------X.X----------------X.X------------------------------------------------------------------------------------
----------------------------------X.X----------------X,XX-----------------------------------------------------------------------------------
--------------------------------XX,,,XX------------XX...,XXX--------------------------------------------------------------------------------
------------------------------XX,,...,,XX--XXX---XX........,XX------------------------------------------------------------------------------
-----------------------------XXX,,,,,,,XX:X...:XXX,,,,,,,,,,,XXX----------------------------------------------------------------------------
-----------------------------XXX,,,,,,,XXX..H..XXX,,,,,,,,,,,XXX----------------------------------------------------------------------------
-----------------------------X..,,,,,,,,,.,...,.,,,,,,,,,,,,,..X----------------------------------------------------------------------------
----------------------------XX.,.........,.,,,.,.............,.X----------------------------------------------------------------------------
----------------------------X,,...........,...,...............,XXX--------------------------------------------------------------------------
----------------------------X,,...........,,,,,...............,,.X--------------------------------------------------------------------------
----------------------------X,,....E......,,H,,....E..........,,EX--------------------------------------------------------------------------
----------------------------XX,...........,,,,,...............,,.X--------------------------------------------------------------------------
--------------------XXXXXXXXXX,...........,...,...............,XXX--------------------------------------------------------------------------
-------------------XX,,,,,,,XX.,.........,.,,,.,.............,.X------------------------------XXXXXXXX--------------------------------------
-------------------X,HHH......,.,,,,,,,,,.,.A.,.,,,,,,,,,,,,,..XXXXXX-------------------------XE.EE.EX--------------------------------------
-------------------X,ttt.......,.,,,.,,,.,.....,.,,,.,,,.,,,.++,,..,.XX-----------------------XE.EE.EX--------------------------------------
-------------------X,,.t.E.A..H,.,H,.,H,.,H...A,.,H,.,H,.,H,.+H,,E.,..,X---------------------X........X-------------------------------------
-------------------X,ttt.......,.,,,.,,,.,.....,.,,,.,,,.,,,.++,,..,..,.X--------------------X.E.EE.E.X-------------------------------------
-------------------X,HHH......,.,,,,,,,,,.,.A.,.,,,,,,,,,,,,,..XXXXXX,...X---------XXXXX-----X.E.EE.E.X-------------------------------------
-------------------XX,,,,,,,XX.,.........,.,,,.,.............,.X-----X...,X-------XX...XX----X........X-------------------------------------
--------------------XXXXXXXXXX,...........,...,...............,XXX----X,,.X-----XX..,A,..XX--XEE.EE.EEX-------------------------------------
----------------------------XX,...........,,,,,...............,,.X----X....X---X..H..,..H..X-XEE..E.EEX----------XXX-----XXX----------------
----------------------------X,,....E......,,H,,....E..........,,EX-----X,,,X---X...E,.,E...XX...ttt....X---------XEX-----XEX----------------
----------------------------X,,...........,,,,,...............,,.X-----X...X--X....XX,XX....X.tt...ttt.X---------X,X-----X,X----------------
----------------------------X,,...........,...,...............,XXX-----X...X--X...X-X,X-X...Xt,,,XXX,,tX--------X...X---X...X---------------
----------------------------XX.,.........,.,,,.,.............,.X-------X...X--X..,X-X,X-X,..X..,,,,,,,.X-----XXX.....XXX.....XXX------------
-----------------------------X..,,,,,,,,,.,...,.,,,,,,,,,,,,,..X-------X...X--X.T,XXX,XXX,,.X.,.......,X-----X:,..E..,:,..E..,:X------------
-----------------------------XXX,,,,,,,XX:..H.:XXX,,,,,,,,,,,XXX-------X...X--X,,.XX.T.XX.,,X,...,,t..,X-----X,,.....,,,.....,,X---XXXXX----
-----------------------------XXX,,,,,,,XXXX....XXX,,,,,,,,,,,XXX-------X...X--X.,.XX...XX.,.X,...t.t...XXXXXXX................HXXX-X.tEX----
------------------------------XX,,...,,XX--XXXX--XX,,....,,,XX---------X,,,X--X,..XX...XX..,X....ttt...,H...H,...,,,AAAAA,,,...,.X-XXXXX----
--------------------------------XX,,,XX------------XX,,,,XXX-----------X+++X--X,..XX,W,XX..,X..........,.ETE.,.E.,T,AAAAA,E,.AA,.X----------
----------------------------------X.X----------------X.XX--------------X,,,XXXX.E.XX,,,XX...X.....E....,.....,...,,,.....,,,...,.X-XXXXX----
----------------------------------X.X----------------X.X---------------X......,...,,AA.,,.T.,..........X,,XXXX................HXXX-X.tEX----
----------------------------------X.X----------------X.X---------------X.......,,,..,.,,,...,..........X..X--X,,.....,,,.....,,X---XXXXX----
----------------------------------X.X----------------X.X---------------X............,.,,.,...,,.......X,.X---X:,..E..,:,..E..,:X------------
----------------------------------X.X----------------X.X---------------X..E..........,..,,.E..,,,....X..,X---XXX.....XXX.....XXX------------
----------------------------------XEX----------------XEX---------------X............,,...,,,....,,,XX,..X-------X...X---X...X---------------
----------------------------------XEX----------------XEX---------------X.......,,,..,.,....,,......,..,X---------X,X-----X,X----------------
----------------------------------XEX----------------XEX--------------XX:......,K,.,..,.....,,,.E..,.XX----------XEX-----XEX----------------
----------------------------------XXX----------------XXX--------------X,.......,,,.,...,.....,,,,,,XX------------XXX-----XXX----------------
----------------------------------------------------------------------X,..........,....,.......,,,,X----------------------------------------
----------------------------------------------------------------------X,..........,.AA..,..........X----------------------------------------
----------------------------------------------------------------------XX:........,XX,,,XX.......E.:X----------------------------------------
-----------------------------------------------------------------------X........,.XXXXXXX,.........X----------------------------------------
-----------------------------------------------------------------------X........,.,,X+X,.,.........X----------------------------------------
-----------------------------------------------------------------------X.......,..,,...,..,........X----------------------------------------
-----------------------------------------------------------------------X.......,.,,..E..,.,.....:.:X----------------------------------------
-----------------------------------------------------------------XXXXXXX......,..,,.....,..,.......X----------------------------------------
----------------------------------------------------------------X,.,.+.,......,..,,.....,..,.......X----------------------------------------
---------------------------------------------------------------X,.,,.+.+,,,,,,.H.,,H.E.H,..H,,,,,,,X----------------------------------------
---------------------------------------------------------------X.,,,.+.+........,,.......,........AX----------------------------------------
---------------------------------------------------------------X,,,XXXXXXX,,,XXXXXXtttttXXXXXX,,,XXX----------------------------------------
---------------------------------------------------------------X.H.X-----X,,,X----X.....X----X,,,X------------------------------------------
---------------------------------------------------------------X...X-----X...X---XX,,,,,XX---X...X------------------------------------------
---------------------------------------------------------------X...XXXX--X.E.X---XA.,,,.AX---X.E.X------------------------------------------
---------------------------------------------------------------X...XXEX--X...X---X.,,.,,.X---X...X------------------------------------------
--------------------------------------X------------------------X...XXEX--XXXXX--XX,.....,X---XXXXX------------------------------------------
------------------------------------XX.XX----------------------X.E.XXEX---------X,,..:..,X--------------------------------------------------
----------------------------------XX.....X---------------------X,,,XXEX---------XX,,...,,X--------------------------------------------------
--------------------XX-----------X.,..:...X-----------------XXXX,,,XX,X----------X..,,,..X--------------------------------------------------
------------------XX..XX--------X..,......X--------------XXXX,XX...XX,XXXX-------X.,,.,,.X--------------------------------------------------
-----------------X......X-------X...,......X------------X.,.E........A..,.X------XX,,,,,XX--------------------------------------------------
----------------X........XX----X.....,......X----------XH..,...........,.H.X------X.....X---------------------------------------------------
---------------X.....E.....X--X...:..,....E..X--------X..XXX...........XXX..X----XX,,,,,XX--------------------------------------------------
--------------X.............XX.......,........X-------X,.X-X.,,,,,,,,,.X-X.,X----X.....,,X--------------------------------------------------
--------------X...E.........,.,,.....,......E..XX-----X.,XXX,.........,XXX,.X----X...,,..X--------------------------------------------------
--------------X..............,..,,...,...........XX---X....,...........,....X----X.,,....X--------------------------------------------------
--------------X..............,....,,.,..........:,X---X...,.............,.E.XXXXXX,,,,,,,X--------------------------------------------------
--------------X..............,......,,..........,,X---X...,.............,...,.A..,.,,....X--------------------------------------------------
-------------X...............,......,.,:.......,,,XXXXX...,....:,A,:....,...,....,,..,,..X--------------------------------------------------
-------------X..............,........,,.......A,,,,.L,....,....,,,.,....,...,....,,....,,X--------------------------------------------------
-------------X..............,.........,,.:.....,,,,.L,....,.T.WA,:A,....,...,....,.,.....X--------------------------------------------------
-------------X...E.........,..........,.,......,,,,.L,....,....,.A.,....,...,....,.,.....X--------------------------------------------------
-------------X..........XXXX...........,,XXX...,,,XXXXX...,....:,,,:....,...,.A..,..,...X---------------------------------------------------
-------------X..........X---XX..........,X--XE..:,X---X...,.............,.E.,....,..,..XX---------------------------------------------------
--------------X........X------X,........,X---XXE,XX---X...,.............,...XXXXXXXXXXX-----------------------------------------------------
--------------X........X------X.,,,......X-----XX-----X....,...........,....X---------------------------------------------------------------
--------------X........X------X....,,...,X------------X.,XXX,.........,XXX,.X---------------------------------------------------------------
---------------X.......X-------X.,,..,,.,.X-----------X,.X-X.,,,,,,,,,.X-X.,X---------------------------------------------------------------
---------------X.......X-------X,..,,..X..X-----------X.HXXX...........XXH..X---------------------------------------------------------------
---------------X......X--------X.....,,XX.X------------X...,E........A.,...X----------------------------------------------------------------
---------------X......X-------X..:.....XX..X------------X.,.............,.X-----------------------------------------------------------------
----------------X.....X-------X........X-XXX-------------XXXX,XXXXXXXXXXXX------------------------------------------------------------------
----------------X.....X------X........X---------------------X,X------------------------------------------XXXXXXXXXXXXXXXXXXXXXXXXXX---------
----------------X.....X------X........X---------------------XEX--------------------------------------XXXX..,,,,,,,,,,,,,,,,,,,,,,..XX-------
-----------------X....X------X.H......X---------------------XEX-----------------------------------XXX..,,,,......................,,..X------
-----------------X.....X-----X........X---------------------XEX---------------------------------XX..,,,.....,,,,,,,,,,,,,,,,,,,,...,..X-----
------------------X....X-----X.........X--------------------XEX-------------------------------XX...,......,,........::..........,,..,..X----
-------------------X...X----X.:......:.X--------------------XXX------------------------------X...,,.....,,...,,,,,,,,,,,,,,,,,,...,..,..X---
--------------------X.X-----X...........X---------------------------------------------------X...,.....,,...,,..................,,..,..,..X--
---------------------X------X..:........X---------------------------------------------------X..,.....,...,,...,,,,,,,,,,,,,,,,,..,..,..,.X--
-----------------------------X..........X--------------------------------------------------X...,....,...,...,,...,,,,,,,,,,,,..,..,..,K,..X-
-----------------------------X.........,.X------------------------------------------------X...,....,..,,..,,.....,XXX...XXXX,.E.,..,.,..,.X-
------------------------------X........,.X-----------------------------------------------X....,...,..,...,..,,,.,.X-X...X--X.,...,..,.,.,..X
------------------------------X.......,...X----------------------------------------------X...,...,...,..,...,.,.,.XXX...XXXX.,....,.,.,..,.X
-------------------------------XXXX...,....X--------------------------------------------X...,....,..,...,...,,,..,,,,,,,,,,,,..,..,..,.,.,.X
-----------------------------------XXXX....X-------------------------------------------X....,...,...,..,.....................,,,...,.,.,.,.X
---------------------------------------X....X------XXXX-------------------------------X....,....,...,..,.,,,,,.......H.......,..,..,.,.,.,.X
----------------------------------------X...XX---XX....XXXXX--------------------------X....,...,...,...,.,XXX,.............:..,,...,.,.,:,.X
----------------------------------------X.....XXX...........XX-----------------------X.....,...,.:.,..,..,X-X,.....................,.,.,.,.X
-----------------------------------------XX.....,....:........XX--------------------X......,...,...,..,..,XXX,......A..,,..........,.,.,.,.X
-------------------------------------------XX...,.E.............XX-----------------X.......,...,...,..,..,...,.......:,,:,....,,,..,.,.,.,.X
---------------------------------------------XXXX.................XXX-------------X........,...,...,..,..,...,.......,,,.,....,.,..,.,.,.,.X
-------------------------------------------------XX....HHH...........XX----------X.........,...,...,..,..,XXX,......,:,:.,....,.,E.,.,.,.,.X
-------------------------------------------XXX-----X,,,,,,,,,..........XXXXXXXXXX..........,...,...,..,..,X-X,......,:,,:,....,.,..,.,.,.,.X
-----------------------------------------XX...XX----X,,,,,,,,,,H...........:.,,,...........,...,...,..,..,XXX,.......,,..,....,,,..,.,.,.,.X
----------------------------------------X...AAA.X---X,,,,,,,.,.,H.......A....,,,...........,...,...,..,..,...,.........,A..........,.,.,.,.X
---------------------------------------X.......,.X--X.......,,XX,H...........,,,...........,...,...,..,..,...,.....................,.,.,.,.X
--------------------------------------X........,,.XXX.........,,,.:..........,,,...........,...,...,..,..,...,..:.......T....,,,...,.,.,.,.X
--------------------------------------X.......,.,,............,.,,...........,,,...........,...,...,..,..,...,..............,...,..,.,.,.,.X
--------------------------------------X...:...,X,..............,,,.....,X,,,,XXX,,,,X......,...,...,..,..,...,....:.........,...,..,.,.,.,.X
--------------------------------------X.......,XX.......,,.....,,,.....XX..:.X-X:..XX,.....,...,...,..,..,...,..............,...,..,.,.,.,.X
--------------------------------------XX......,,,.....,,<.,....,,.,H....,,,,,XXX,,,,,......,...,...,..,..,XXX,..............,XXX,..,.,.,.,.X
---------------------------------------X:.....,,,.....,...,.....,,,......,,,,,.,,,,,.......,...,...,..,..,X-X,.......H......,X-X,E.,.,.,.,.X
--------------------------------XXXXXXXX......,,,....,<.W.<...H.,,,H.....,,,,,.,,,,,.......,...,...,..,..,XXX,..............,XXX,..,.,.,.,.X
-----------------------------XXX.,...,........,,,....,....,.....,,,......,,,,,.,,,,,.......,...,...,..,..,,,,,.H...........,....,..,.,.,.,.X
---------------------------XX,.E.,.E.,........,X,.....,,<,,....,,.,H...,X,,,,XXX,,,,X......,...,...,..,.......H,H....,,,,,,.....,..,.,.,.,.X
--------------------------X.E.,..,...,........,XX..............,,,.....XX..:.X-X:..XX,.....,...,...,..,......H,.,H..,.XXX......,...,.,.,.,.X
-------------------------X.,..XXXXXXXXXX......,.,,.............,,,......,,,,,XXX,,,,,......,...,...,..,...:.H,.T.,H.,.X-X.....,....,.,.,.,.X
-------------------------XE,.X---------X:......,,,.X..........,,,............,,,...........,...,...,...,.....H,.,H..,.XXX....,.....,.,.,.,.X
------------------------X,..X---------XX.......,.XX-X........,XX,.......A....,,,...........,....,...,..,......H,H....,,,,,,,,.:...,..,.,.,.X
------------------------X.,X-----------X........X---X,,...,,,,.,.H...........,,,...........,....,...,...,......H..................,.,..,.,.X
------------------------XE.X------------X.......X---X,,,,,.,,,,.H............,,,........:..,....,....,...,.......................,..,.,..,.X
-----------------------X...X-------------XX...XX---X,,.,,,,,,..H......:......,,,...........,....,....,....,,....................,..,..,.,..X
-----------------------X,,,X---------------XXX----X...,,,,,..:.........XXXXXXXXXX....:......,....,....,.....,,................,,..,..:..,..X
-----------------------X.E.X---------------------X.....HHH...........XX----------X..........,....,.....,......,,,,,,,,,,,,,,,,...,..,..,...X
-----------------------X...X--------------------X...:..............XX-------------X..........,....,.....,,........:.............,.,,..,....X
-----------------------X...X--------------------X................XX----------------X.........,.....,......,,..................,,.,...,.....X
-----------------------X,,,X--------------------X.E.:.....:....XX-------------------X.........,.....,...::..,,,,,,,,,,,,,,,,,,..,...,......X
-----------------------X.E.X---------------------XXXXX...XXX.XX----------------------X.........,.....,,.......................,,...,.......X
-----------------------X...X-----------------------X-X,,,X-XX------------------------X..........,......,,..................:,,....,.......X-
-------------XXXXX-----X.E.X-----XXXXX---------------X,,,X----------------------------X.........,........,,...............,,.....,........X-
------------XX,,,XX---XX+++XX---XX,,,XX--------------X...X----------------------------X..........,.........,,,,,,,,,,,,,,,......,........X--
-----------X.......X-X.......X-X.......X-------------X,,,X-----------------------------X..........,............................,........X---
----------XX.......XXX.......XXX.....E.XX------------X,,,X-----------------------------X...........,,........:................,........X----
----------X,..XXX..,.,..XXX..,.,..XXX..,X------------X...X------------------------------X............,,,....................,,.........X----
----------X,..X-X..,W,..X-X..,.,..X-X..,X------------X,,,X------------------------------X...............,,,,,,,,,,,,,,,,,,,,..........X-----
----------X,..XXX..,.,..XXX..,.,..XXX..,X------------X,,,X-------------------------------X..........................................XX------
----------XX.......XXX.......XXX.....E.XX------------X...X------------------------------X,,,...........:..........................XX--------
-----------X.......X-X.......X-X.......X-------------X,,,X------------------------------X.,.,............:.......................X----------
------------XX,,,XX---XX,,,XX---XX,,,XX--------------X,,,X-----------------------------X.E.,,,,...................T.............X-----------
---XXXXX-----XA..X-----X,,,X-----XH.HX---------------X,,,X------------------------------X...t,.,,...............................X-----------
--XX,,,XX---XX,,,XX----X...X----XX,,,XX-------------XX,,,XX------------------------------X.E.tttt,,,...........................X------------
-X.......X-X.......X---X.E.X---X.......X-----------X.......X-----------------------------X..E.....tt,,X,,,,,,,,,,,,,,,,,,,,,,,X-------------
XX.......XXX.......XXXXX...XXXXX.......XX---------XX.......XX-----------------------------X...E.E.E...X,,,,,,,,,,,,,,,,,,,,,,,X-------------
X,..XXX..,H,..XXX..,,.........,,..XXX..,X---------X,..XXX..,X------------------------------X.........XX,,,,,,,,,,,,,,,,,,,,,,,X-------------
X,..X-X..,.,..X-X..,,.E..E..E.,,..X-X..,X---------X,..X-X..,X-------------------------------XXXXXXXXXXX,,,,,,,,,,,,,,,,,,,,,,,X-------------
X,..XXX..,H,..XXX..,,.........,,..XXX..,X---------X,..XXXE.,X-----------------------------------------X.......................X-------------
XX.......XXX.......XXXXX...XXXXX.......XX---------XX.......XX-----------------------------------------X.....................H.X-------------
-X.......X-X.......X---X.E.X---X.......X-----------X.......X------------------------------------------X.......................X-------------
--XX,,,XX--XXX,,,XX----X...X----XX,,,XX-------------XX,,,XX-------------------------------------------X..................W..H.X-------------
---XXXXX-----X...X-----X,,,X-----X...X-----XXXXX-----XHAHX--------------------------------------------X..E...E....E...........X-------------
------------XX,,,XX---XX,,,XXX--XX,,,XX---XX,,,XX---XX,,,XX-------------------------------------------XX......................X-------------
-----------X.......X-X.......X-X.......X-X.......X-X.......X--------------------------------------------XX:.:..:.HHH.:.:..:.XX--------------
----------XX.......XXX.......XXX.......XXX.......XXX.......XX---------------------------------------------XXXXXXX+++XXXXXXXX----------------
----------X,..XXX..,.,..XXX..,H,..XXX..,.,..XXX..,.,..XXX..,X-------------------------------------------XXXXXXXXX...XXXXXXXXX---------------
----------X,..X-X..,.,..X-X..,A,..X-X..,A,..X-X..,.,..X-X..,X-------------------------------------------XA.,.............E.AX---------------
----------X,..XXX..,.,..XXX..,H,..XXX..,.,..XXX..,.,..XXXE.,X-------------------------------------------X.E,......E.....,...X---------------
----------XX.E..E..XXX.......XXX.......XXX.......XXX.......XX-------------------------------------------X,.XX...........XX.,X---------------
-----------X.......X-X.......X-X.......X-X.......X-X.......X--------------------------------------------:.,XX,,,,,,,,,,,XX,:X---------------
------------XX,,,XX---XX,,,XX---XX,,,XX---XX,,,XX---XX,,,XX--------------------------------------------XX...,,,,,,,,,,,,,...X---------------
-------------X,,,X-----H.AHX-----X,,,XXXXXXX,,,X-----XHAHX---------------------------------------------X,...,,,,,,,,,,,,,...X---------------
-------------X.E.X----XX,,,XX---X...............X---XX,,,XX--------------------------------------------X:...,,:E....E.:,,.E:X---------------
-------------X...X---X.......X-X..E.E........E...X-X.......X--------------------------------------------X,..,,,,,,,,,,,,,..,X---------------
-------------X...XXXXX.......XX...E.E........E....XX.......XX--------------------------------------XXXX-X.,XX,,:..T..:,,XX,.X-XXXX----------
-------------X......,,..XXX..,,...................,,..XXX..,X--------------------------------------X..XXX,,XX,,,,,,,,,,,XX,,XXX..X----------
-------------X.E...E,,..X-X..,,...E.E........E....,,..X-X..,X--------------------------------------X...,,...,,,,,,..,,,,,...,,t..X----------
-------------X......,,..XXX..,,...................,,..XXX..,X--------------------------------------X.E.,,..E,,,,K,..,,,,,E..,,tE.X----------
-------------XXXXXXXXX.......XXXXXXXXXXXXXXXXXXXXXXX.......XX--------------------------------------X...,,...,,,,..,,.,,,,...,,t..X----------
---------------------X.......X---------------------X.......X---------------------------------------X..XXX,,XX,,,,,,,,,,,XX,,XXX..X----------
----------------------XXXXXXX-----------------------XX,,,XX----------------------------------------XXXX-X.,XX,,:..E..:,,XX,.X-XXXX----------
-----------------------------------------------------XXXXX----------------------------------------------:,E.,,,E,,,,E,,,,..:X---------------
-------------------------------------------------------------------------------------------------------XX...,,:.......:,,...X---------------
-------------------------------------------------------------------------------------------------------X,...,,,,,,,,,,,,,...X---------------
-------------------------------------------------------------------------------------------------------X:...,,,,,,,,,,,,,..:X---------------
--------------------------------------------------------------------------------------------------------X.,XX,,,,,,,,,,,XX,.X---------------
--------------------------------------------------------------------------------------------------------X,.XX...........XX.,X---------------
--------------------------------------------------------------------------------------------------------X.E.,...........,.E.X---------------
--------------------------------------------------------------------------------------------------------X..,.............,..X---------------
--------------------------------------------------------------------------------------------------------XA.,..H.......H..,.AX---------------
--------------------------------------------------------------------------------------------------------XXXXXXXXX,,,XXXXXXXLX---------------
----------------------------------------------------------------------------------------------------------------X,,,X-----X,X---------------
----------------------------------------------------------------------------------------------------------------X,,,X-----XAX---------------
----------------------------------------------------------------------------------------------------------------X...X-----X.X---------------
----------------------------------------------------------------------------------------------------------------X...X-----XAX---------------
-----------------------------------------------------------------------------------------------------------------XEX------X.X---------------
-----------------------------------------------------------------------------------------------------------------X.X------XAX---------------
----------------------------------------------------------------------------------------------------------------XX>XX-----XHX---------------
----------------------------------------------------------------------------------------------------------------X.,,X-----XXX---------------
-----------------------------------------------------------------------------------------------------------------XXX------------------------
