------------------------XXXXXXXX-------------------------------------------------------
---------------------XXX........X----------XXXXXX--------------------------------------
----------------XXXXX......E.....X-----XXXX......XXXXX---------------------------------
-----XX----XXXXX..................X--XX...........,,.,XXXX-----------------------------
-----X.XXXX...X......,........,,,..XX.............,.,,,,,.XXX--------------------------
-----X,,.,W...X....,,,........,A,..,...............,....,,...XXXX----------------------
-----X...,....X....,,,........,,....,..............,,....,,......XX--------------------
----->...,....,....,,,...,,,........,...............,,,,,,....A....XX------------------
----->,,.,....,....,,,....,,,.......,................................X-----------------
-----X.XXXH...,....,,,....,,,.......,.................................XX---------------
-----XX----X..,....,,,...,,,........,....,,,,,...................E......X--------------
-----------X..X....,,,..............,...,.....,.,........................X-------------
-----------X..X....,,,........,,,...,..,.......,,.........................X------------
-----------X,,XX...,,.........,A,..,....,,,......,,...............,........X-----------
-----------X..X-XX............,,,..XXXX....,,,,,..,...............,,..,....X-----------
-----------X..X---XXXXX....E.....XX----XXXXX....,,.....A.........,..,,.,,...X----------
-----------X..X--------XX........X----------XXXXX................,.......,,,,X---------
-----------X,,X----------XXXXXXXX----------------XXXXXXXXXXXXX....,...H....,..X--------
-----------X..X-------------------------------XXXXXXXXXXXXXXXXXX...,......,....X-------
-----------X..X-------------------------------X.......:.......XX....,.,,..,....X-------
---------XXX,,X-------------------------------X.......<.......X-X....,..,,,.....X------
---------X.,E.X-------------------------------X...............X-X...............X------
---------H.,..X-------------------------------X...............X--X...............X-----
---------XXX,,X-------------------------------X...............X--X...............X-----
-----------X..X-------------------------------X...............X---X...............X----
-----------X..X-------------------------------X.......W.......X---X...............X----
-----------X,,X-------------------------------X...............X---X...............X----
-----------XE.X-------------------------------X...............X---X...............X----
-----------X,,XXX-----------------------------X...............X----X.A............X----
-----------X..,.X-----------------------------X:..............W----X..............X----
-----------X..,EX-----------------------------XXXXXXXX..XXXXXXX----X.........,,,.X-----
-----------X,,XXX------------------------------------X++X----------X........,,.,.X-----
-----------X..X--------------------------------------X..X----------X........,..,.X-----
-----------XW.X-------------------------------------X....XX---------X.......,..,.X-----
-----------X,,X------------------------------------X.......XX-------X......,...,.X-----
-----------X..X-----------------------------------X..........X------X......,..,..X-----
-----------XE.X---------------------------------XX............XX----X.....,,...,.X-----
---------XXX,,X--------------------------------X................X---X.....,..,,.X------
---------X.,..X-------------------------------X..................XXX......,..,..X------
---------XH,..X------------------------------X.....................X......,,,.XX-------
---------XXX,,X------------------------------XE..................E.,........XX---------
-----------X..X------------XXXXXXXXXX--------X.....................,......XX-----------
-----------X..X-----------X..........XXXX----X......................,...XX-------------
-----------X,,X----------X.....,.......,.XXX-X......................,.XX---------------
-----------X..X--------XX......,,,,,,,,,....XX......................XX-----------------
------XXXXXX,.X-------X........,,,,,,,,,....A,......................X------------------
-----X.......,XXX---XX.........,,,,,,,,,....,.......................X------------------
----,X...........XXX...........,,,,,,,,,...E,........................X-----------------
---,X,,.............,,.........,,,,,,,,,....,.......,,,,,............X-----------------
---X,W.,..............,........,....W..,....,.......,,,,,............X-----------------
--X...,................,,............XXXXX.H.....,..,,,,,...,........X-----------------
--X......................XXXXXXXXXXXX-----XX.....,,.,,,,,..,,.........X----------------
-X...........,...........X-----------------X.....,,.,,,,,.,,..........X----------------
X...........,.,..,.......XXXXXXXXXXXXXX---X.......,,,,,,,,.,..........X---:XXXXXXXXXXXX
-X.........,,E.,.,..,,...XX..........:X---X.......,A,,,,,.A,..........X---X...........X
-X...........,,.H,,,,....XX...........X---X.......,.......,............X--X...........X
--X............,,..,.....XX...........X--X........,.......,............X--X...........X
---X.............,..H....XX...........X--X.........,..E..,.............X--X...........X
---X.............,,,,....XX...........X-X..........,.....,,,,,,,........X-X...........X
----X............,,.,,...XX...........XXX....,,,,,,,.....,,,,,,,........XXX...........X
-----X...........,.......XX:<...W..A..++.....,,,,,,,..W..,,,,,,,........++.........<.:X
-----X...................XX...........++.....,,,,,,,.....,,,,,,,........++.....W......X
------X..................XX...........++.....,,,,,,,.....,,,,,,,........XXX...........X
-------X..........,,,....XX...........XXX....,,,,,,,.....,..............X-X...........X
-------X..........,.,....XX...........X-X..........,......,.............X-X...........X
--------X.........,,,....XX...........X-X..........,..E...,............X--X...........X
---------X..............X-X...........X-X.........,.......,............X--X...........X
---------X.............X--X...........X--X........,...,....,...........X--X...........X
----------X...........X---XXXXXXXXXXXXX--X........,A.,.,..A,...........X--WXXXXXXXXXXXX
----------X...........X------------------X........,,,.H.,,.,..........X----------------
-----------X.........X-------------------X.......,,..,,,..,,,.........X----------------
-----------X........X--------------------X.......,...,.,....,.........X----------------
------------X,,,,,,X---------------------X..........,.W,..............X----------------
------------X..,,,..X---------------------X..........,,,.............X-----------------
------------X..,.,...X--------------------X..........................X-----------------
------------X..,.,,...X-------------------X..........................X-----------------
------------X..,...,,,,XXXXXXXXXXXXXXXXXXXX..........,,,.............X-----------------
------------X..,......,,...E...........E..,..........,,,............X------------------
------------X..,,.....,,.........E.........,........................X------------------
------------X....,,,,,,,..........XXXXXXXXXX..................,,,,..X------------------
------------K.........XXXXXXXXXXXX---------X..................,,,,..X------------------
------------XX......XX----------------------X.................,.H,.X-------------------
--------------XXK.XX------------------------X.................,,,,.X-------------------
----------------XX--------------------------X.................,,,,.X-------------------
---------------------------------------------H...................XX--------------------
---------------------------------------------X..................X----------------------
----------------------------------------------XX...............X-----------------------
------------------------------------------------X............XX------------------------
-------------------------------------------------X..........X--------------------------
--------------------------------------------------XX.......X---------------------------
----------------------------------------------------X....XX----------------------------
-----------------------------------------------------X++X------------------------------
-----------------------------------------------------X++X------------------------------
----------------------------------------------XXXXXXXX..XXXXXXX------------------------
----------------------------------------------X:..............W------------------------
----------------------------------------------X...............X------------------------
----------------------------------------------X...............X------------------------
----------------------------------------------X...............X------------------------
----------------------------------------------X.......W.......X------------------------
----------------------------------------------X...............X------------------------
----------------------------------------------X...............X------------------------
----------------------------------------------X...............X------------------------
----------------------------------------------X...............X------------------------
----------------------------------------------X.......<.......X------------------------
----------------------------------------------X.......:.......X------------------------
----------------------------------------------XXXXXXXXXXXXXXXXX------------------------
