------------------------------------------XXXXXX-----------------------------------------------------------------------------------------------------------------------------------------------
------------------------------------------X....X-----------------------------------------------------------------------------------------------------------------------------------------------
------------------------------------------X....X-----------------------------------------------------------------------------------------------------------------------------------------------
--------------------------------------XXXXX....X-----------------------------------------------------------------------------------------------------------------------------------------------
--------------------------------------X.,.,....X-----------------------------------------------------------------------------------------------------------------------------------------------
--------------------------------------X.,.,....X-----------------------------------------------------------------------------------------------------------------------------------------------
--------------------------------------X.,.,....X-----------------------------------------------------------------------------------------------------------------------------------------------
----------------------------XXXXXXXXXXX.,.,....X-----------------------------------------------------------------------------------------------------------------------------------------------
---------------------------->.,.++.,,.,.,.,....X-----------------------------------------------------------------------------------------------------------------------------------------------
---------------------------->XXXXXXXXXXXXXX.H..X-----------------------------------------------------------------------------------------------------------------------------------------------
------------------------------------------X....X-----------------------------------------------------------------------------------------------------------------------------------------------
------------------------------------------X....X-----------------------------------------------------------------------------------------------------------------------------------------------
------------------------------------------X....X-----------------------------------------------------------------------------------------------------------------------------------------------
------------------------------------------X,,,,X-----------------------------------------------------------------------------------------------------------------------------------------------
------------------------------------------X....X-----------------------------------------------------------------------------------------------------------------------------------------------
------------------------------------------X....X-----------------------------------------------------------------------------------------------------------------------------------------------
------------------------------------------X....X-----------------------------------------------------------------------------------------------------------------------------------------------
------------------------------------------X....X-----------------------------------------------------------------------------------------------------------------------------------------------
------------------------------------------X.E..X-----------------------------------------------------------------------------------------------------------------------------------------------
------------------------------------------X....X-----------------------------------------------------------------------------------------------------------------------------------------------
------------------------------------------X....X-----------------------------------------------------------------------------------------------------------------------------------------------
------------------------------------------X..E.X---------------------------------------------------------------XXXXXXXXXXXXXXXXXXXXXX----------------------------------------------------------
------------------------------------------X....X---------------------------------------------------------------X:...................X----------------------------------------------------------
------------------------------------------X....X---------------------------------------------------------------X..........E.........:----------------------------------------------------------
------------------------------------------X....X---------------------------------------------------------------X.....E.......E..H...X----------------------------------------------------------
------------------------------------------X.E..X---------------------------------------------------------------X..E................EX----------------------------------------------------------
------------------------------------------X....X---------------------------------------------------------------X........:..:........X----------------------------------------------------------
------------------------------------------X....X---------------------------------------------------------------X...:...........E....X----------------------------------------------------------
------------------------------------------X..E.X---------------------------------------------------------------X......E.....:.......X----------------------------------------------------------
------------------------------------------X....X---------------------------------------------------------------X..E.......E.........X----------------------------------------------------------
------------------------------------------X....X---XXXXXXXXXXXXXXXXXXXXXXXXXXXXXXXXXXXXXXXXXXXXXXXXXXXXXXX-----X.......:.........:..X----------------------------------------------------------
------------------------------------------X....X---X........,..,:........................................:-----X...H...........E..E.X----------------------------------------------------------
------------------------------------------X.E..X---X........,..,.........................................X-----X...........E........X----------------------------------------------------------
------------------------------------------X....X---X..E.....,..,...........,,,,,,,,,,,,,,,,,,,,,,,,,,....X-----X.......:............X----------------------------------------------------------
------------------------------------------X....X---X........,..,...........,.......................E,..E.X-----X.E...E..E..:..E..K..X----------------------------------------------------------
------------------------------------------X....X---X........,..,..........E,.E......................,....X-----X....................X----------------------------------------------------------
------------------------------------------X....X---X........,..,...E.......,..,,,,,,,,,,,,,,,,,,,,..,....X-----X..................E.X----------------------------------------------------------
------------------------------------------X.E..X---X........,..,...........,..,..................,..,..E.X-----XXXXXXXXXXXXXXXX,,XXXX----------------------------------------------------------
------------------------------------------X....X---X.....E..,..,...........,..,...E......E.....K.,..,....X--------------------X..X-------------------------------------------------------------
------------------------------------------X....X---X..E.....,..,...........,.A,......XXXXXXXX....,..,....X-----XXXXXXXXXXXXXXXX,,XXXXXXXX------------------------------------------------------
------------------------------------------X....X---X........,..,...........,..,......X------X....,..,..E.X-----X:.................:....:X------------------------------------------------------
------------------------------------------X....X---X........,..,...H...,,,,B..,B,,,,.X------X....,..,....X-----X...E....:......H........X------------------------------------------------------
------------------------------------------X.E..X---X......E.,..,.......,,.,,..,.,,.,.X------X....,..,....X-----X:..........E.....E..:...X------------------------------------------------------
------------------------------------------X....X---X........,..,.......,,A,,..,.,A.,.X------X....,..,....X-----X........E..............EX------------------------------------------------------
------------------------------------------X.H..X---X..E.A...,..,.......,,,,,..,,,,,,.X------X..A.,..,....X-----X..:..:......:...........XXXXXXXXXXXXXXXXXXXXXXXXXXXXXXXXXXXX-------------------
------------------------------------------X....X---X........,..,...E.......B..,B.....X------X....,..,..E.X-----X..............:.:...E...XX:...............................:X-------------------
------------------------------------------X....X---X........,..,...........,..,......X------X....,..,....X-----X.A........E.............XX.................................X-------------------
------------------------------------------X....X---X......E.,..,...........,..,......XXXXXXXX....,..,....XXXXXXX....E..:........,,,,,..HXX.................................X-------------------
------------------------------------------X....X---X........,..,...........,..,..................,..,..E.XX..,.,..........A.....,.E.,....,.......E............E............X-------------------
------------------------------------------X....X---X..E.....,..,...........,..,..E...............,..,....XX..,.,.......E.....E..,...,....,.................................X-------------------
------------------------------------------X.E..X---X........,..,W.......:..,..,......H...E.......,..,....XX..,.,...:.:..........,...,.E..X.................................X-------------------
XXXXXXXXXXXXXXXXXXXXXXXXXXXXXXXXXXXXXXXXXXX....X---X....A...,..,...........,.A,................A.,..,....XX..,.,:...........,,,,XXXXXXX..X.................................X-------------------
X.:..............................,.............X---X........,..,....H......,..,..................,..,....,,..,.,....,,,,,,,,.,,,X------XXX.,,,,,,,,,,,,,,,,,,,,,,,,,,,:,...XX------------------
X........E...E..E...E..E....E....,...E.........X---X......E.,..,...........,..,..................,.E,..E.XX..XXX,,,,.,,,,,,,,.E.XXXXXXXX-X.:..................E........:,..,.XXXX--------------
X...H............................,........E...:X---X........,..,..........E,.E,,,,,,,,,,,,,,,,,,,,..,....XX..X--XX,,,.....E............X-X,..........E..................:..XX----XX------------
X................................,.............X---X.E......,..,...........,........................,....XX..X----XXXXE........E....E.:X-X,.............................:,.X-XX---X------------
X....,,,XXXXXXXXXXXXXXXXXXXXXX,,,XXXXXXXXXXXXXXX---X........,..,...........,,,,,,,,,,,,,,,,,,,,,,,,,,....XX.A.X-------XXXX..E...:H.....X-X,........E.....E...E....E......:,X--X---X------------
X.E..,..X--------------------X...X-----------------X........,..,.........................................XX...X-----------XXX.........:X-X.:............................:.:X---X--X------------
X....,..X--------------------X...X-----------------X....H...,..,........H..............................E.XXXXXX--------------XXXX.E....X-X,,,,,XXXXXXXXXXXXXXXXXX,,,,,,XXXXX---X--X------------
X....,..XXXXXXXXXXXXXXXXXXXXXX...X-----------------X........,..,.................XXXXXXXXXXXXXXXXXXXXXXXXX-----------------------XXXXXXX-X.....X----------------X......X-------X--X------------
X....,...........................X-----------------X........,..,................:X-------------------------------------------------------X.....X----------------X......X--------X-X------------
X....XXXX......:.................X-----------------XXX+++XXXXXXX:XXXXXXXXXXXXXXXXX-------------------------------------------------------X..E..X----------------X......X--------X--X-----------
X.E..X--X............:.....:.....X-------------------X...X-------------------------------------------------------------------------------X.....X----------------X......X--------X--X-----------
X....X--X........................X---------------XXXXX+++XXXXX-XXXXXXXXXXXXXXXX----------------------------------------------------------X.....X----------------X..E...X---------X-X-----------
X....X--X........................X---------------X...........X-X..............X-----XXXXXXXXXXXXXXXX-------------------------------------X,,,,,X----------------X......X---------X-X-----------
X....X--X........................X---------------X...........X-X..............X-----X..............X------------------------------------X.......X---------------X......X---------X-X-----------
X....X--X...........:............XXXXXXXXXXXXXXXXX.......E...X-X...E.......E..X-----X......T.......X----------------------------------XX....H....X--------------X......X----------XX-----------
X.:..X--X........................XX:............:X..E........X-X..............X-----X.W............X---------------------------------X...........X--------------X......X-----XXXXXXXXXXXXXXXXX-
X....X--X:.......................XX..............X...........X-X..............X-----X..............X--------------------------------X..E........E.X------------XX,,,,,,X-----X...............X-
X....X--X...............:........XX..........E...X...........X-X..............X-----X..............X-----XX-------------------------:..............X---------XX.........XX---X.H.....:.....H.X-
X.E..X--X......:.................XX..............X...........X-X.A............X-----X..........A...X----X.,XX-----------------------X.:.............XXXXXXXXX.............X--X...............X-
X....X--X........................XX....,,,,,.....X...........X-X.......H......X-----X..............X---X..,..XX---------------------X...............,:....:,...E.......E...X-X,,,,,,,,,,,,,,,X-
X....X--X.....................,,,XX....,...,.....:.E......E..X-X..............X-----X..,,,,,,,,....X--X....,...XX-------------------X......E........,......,..............:X-X,,,,,,,,,,,,,,,X-
X....X--X...................,,E..XX.E..,...,.....,.....A.....X-X..............X-----X..,......,....X--X..<.,..<..XX-------XXXXXXXX--:..:.........:..,..H...,........E......X-X:..A..........:X-
X....X--X.........:.......,,..,,.XX....,,,,,.....,...........X-X..............X-----X..,......,....X--X.....,......XX-----X.t.E..X--X...............,......,...............X-X.......:.......X-
X....X--X................,H..,..,XX....,,.,,.....,...........X-X..............X-----X..,......,....X--X......,....<..XX---X.t....X---X..............,:....:,.............:.X-X...........E...X-
X.E..X-XX...............,...,..:.XX....,,.,,.E...,...........X-X..:...........X-----X..,......,....X-X.......,.......:X---X.t....X---X.E........E...XXXXXXXX:..............X-X...............X-
X....X-XX...............,E.,.....XX....,,.,,.....,...........X-X..............X-----X..,......,....X-X...<....XXX.....X---XXX....X----X...........XX--------X..E...........X-X....:..........X-
X....X--X...:..........,..,.A....XX....,,.,,.....,..E..A...E.X-X......H.......X-----X..,......,....X-X:......X---XX...X-----X....X----X....:.....X----------X..........E..:X-XH..............X-
X....X--X.............,..,.....E.XX....,,.,,.....,...........X-X..............X-----X..,...:..,....X-XXXXXXXX-----X...X-----X....X-----X......:XX------------X...........XX--X....H..........X-
X....X--X.............,.H,.E.....XX....,,.,,.E...,...........X-X..............X-----X..,......,.H..X--------------X...X-----X....X-----X.....XX---------------X........XX----X........E......X-
X....X--X............,...,....H..XX....,,.,,.....,...........X-X.A............X-----X..,......,....X--------------X...X-----XXXX.X------X,,,X-----------------X......XX------XH...........H..X-
X....X--X............,...,.......XX....,,.,,.....:.....H.....X-X..........E...X-----X..,......,....X--------------X...X--------XEX------X...X------------------XXXXXX--------X...............X-
X..E.X--X.:....:.....,.E.,....E..,,....,,.,,.....,...........X-X..............X-----X..,......,....X--------------X..EX--------X.X------X.H.X--------------------------------X...............X-
X....X--X............,...,.......,,.E.....,,.....,...........X-X.....E........X-----X..,......,....X--------------X...X--------X.X------X...X--------------------------------X...............X-
X....X--X.......XXXXXX...,.....E.,,.......,,.....,........E..X-X..............X-----X..,......,....X--------------X...X--------X.X------X...X--------------------------------XA.....E........X-
X....X--X.......X----X...,.E.....XX.......,,.E...,...E.......X-X..............X-----XA.,......,..A.X--------------X....X-------X.X------X...X--------------------------------X...............X-
X....X--X.......X----X.E.,.......XX.......,,.....,......A....X-X..............X-----X..,......,....XXXXXXXXX-------X...X-------X.X------X.W.X--------------------------------X..:............X-
X....X--X.......X----X...,...E..HXX.......,,.....,...........X-X..............X-----X..,......,....,......:X-------X...X-------XHX------X...X--------------------------------X...............X-
X....X--X.......XXXXXX...,E......XX.......,,.....,...........X-X..............X-----X..,......,....,...E...X-------X...X-------X.X------X...X--------------------------------X...............X-
X..E.X--X.......,Ht.XX.H.,.......XX...E...,,.....,...........X-X...E..........X-----X..,......,....,.......X-------X...X-------X.X------X...X--------------------------------X...............X-
X....X--X.......XXXXXX...,..T....XX.......,,.....,...........X-X..............X-----X..,......,....,.......X-------X.E.X-------X.X------X.A.X--------------------------------XW..............X-
X....X--X.:....:X----X...,.....E.XX.......,,.....,...........X-X..............X-----X..,..:...,....,..:....X-------X...X-------X.X------X...X--------------------------------X...............X-
X....X--X.......X----X.E.,.E.....XX.......,,.....,...........X-X..............X-----XB.,......,....,.......X-------X...X-------X.XXXXXXXX,,,XXXXXXXXXXXXXXXXXXXXXXXXXXXXXXXXXX...............X-
X....X--X.......X----X...,.......XX.......,,..E..:..E.....E..X-X..............X-----X..,......,....,.......X-------X...X-------X.XX:.......................,.............,............:......X-
X....X--X.......X----X...XXXXXXXXXX.......,,.....,...........XXX..........E...X-----X..,......,....,.......X-------X,,,X-------X,XX........................,.............,...................X-
X....X--X.......X----X...X--------X....,,,,,.....X...........++,..............X-----XB.,......,....,.......X-------X+++X-------X.XX........................,.E..H.....E..,...................X-
X....X--X:......XXXXXX...X--------X....,...,.....X...........XXX..............X-----X..,......,....,.......X-------X,,,XXXXXXXXX,XX........E....:......A...,.............,...................X-
X.E..X--X............,...X--------X....,...,.....XXXXXXXXXXXXX-X..............X-----X..,......,....,....E..X-XXXXXXX.............XX........................XXXXXXXXXXXXXXXXXXXXXX............X-
X....X--X............,.E.X--------X....,,,,,.E...X-------------XXX,XXXXXXXXXXXX-----X..,......,....,.......X-X,..................XX........................X---------------X....X......H.....X-
X....X--X............,...X--------X.E............X---------------X+X----------------X..,......,....,.......X-X,:.................XX.XXXX,:,,XXX............X---------------X....,............X-
X....X--X.......,,,,,,,..X--------X..............X--------------XX,XXXX-------------XB.,......,....,.......X-X,.......E...A...E..XX.XXXX,,::X-X....E....:..X---------------X....,............X-
X....X--X.......,.....,E.X--------X:............:X-XXXXXXXXXXX--X.....X-------------X..,......,....,,,,,,,.X-X,..................XX.......H.XXX............X---------------X.B..,............X-
X.E..X--X.......,..E..,..X--------XXXXXXXXX,,,XXXXX.....,....X--X.....X-------------X..,......,.:........,.X-X,.E..,,,,,,,,,,....XX.........,:,............X---------------X,,,.,..E.........X-
X....X--X.......,.....,..X----------------XLLLX--X...E..,....X--X.....X-------------X..,......,....XXXXX.,.X-X,....,........,....XX.........,:,............X---------------X,.,.X............X-
X....X--X.......,.....,E.X----------------X,,,X-X.......,.E..X--X.....X-------------XB.,..:...,....X---X.,.X-X,....,........,....XX.........,:,............X---------------X,E,.XA...........X-
X....X--X.......,.....,..X----------------X....X........,....X--X.....X-------------X..,......,....X---X.,.X-X,....,........,....XX...A.....XXX............X---------------X,.,.X...........:X-
X....X--X.......,..E..XXXX------------XXXXX.A...........,....X--X.....X-------------X..,......,....X---X.,.X-X,....,...E..H.,....XX.........X-X............X---------------X,.,.XXXXXXX,,,,XXXX
X....X--X.......,.....X-----------XXXX...........XXX....,.....X-X....,X-------------XB.,......,....XXXXX.,,X-X,.:..,........,....XX.........X-X.....:......X---------------X,.,...............X
X....X--X....:..,.....X--------XXX..............X---XX..,..E..X--X,,,.X-------------X..,......,............X-X,....,........,....XX.........X-X........:...X---------------X,E,,,,,,,,,,,,,,,.X
X....X--X.......,..E..X------XX.................X-----X.,.....X--X,..,XXXXXX--------X..,......,............X-X,....,,,,,,,,,,....XX...W.....XXX............X---------------X,.....E.....E...,BX
X.E..X--X.......,.....X------X..................X-----X.,.....X---X,,......X--------XB.,..:...,.....H....E.X-XXX.................XX.........,:,............X---------------X,,,,,,,,,,,,,,,,,EX
X....X--X.......,.H...X------X..E...............X-----X.,.....X----X.......X--------X..,......,............X----XX............E..XX.........,.,...E........X---------------XXXXXXXXXXXXXXXXXXXX
X....X--X..:....,.....X------X..........H.......X------X,.....X-----X......X--------X..,......,............X------XX.....H.......:X.........,:,..........E.X-----------------------------------
X....X--X.......,.....X------X..................X------XX....E.X----X...E...X-------X..,......,............X--------XX...........XX:........X:X............X-----------------------------------
X....X--X.......,..E..X------X...............:..X--------X......X----X......X-------X..,......,............X----------XX.......XX-XXXXXXXX..X-X............X-----------------------------------
X....X--X.......,.....X------X..................X--------X....E..X----X.....X-------X..,......,............X------------XX,,,XX----------X..X-X............X-----------------------------------
X....X--X.......,.....X------X..................X---------X.......X---X..E..X-------X..,......,............X----XXXXXXXX-X,,,XXXXXXXX----X..X-X............X-----------------------------------
X..E.X--X.......,.....X------X..........E.......X----------X.......X--X.....X-------X..,......,...A........X----X......X-X..........X----X..XXX...E........X-----------------------------------
X....XXXX.......,..E..X------X...:..............X-----------X...E...X-X.....X-------X..,......,............X----X......XXX..........X----X..,:,............X-----------------------------------
X....,..........,.....X------X..................X-----------X........XX....X--------X..,......,.......H....X----X.................W.XXXXX:..,:,............X-----------------------------------
X....,..........,.....X------X..................X------------X........X..E.X--------X..,..:...,............X----X...................X:::XX..,:,.......:..E.X-----------------------------------
X....,..........,..H..X------X..................X-------------X...E...,....X--------X.E,......,.......H..:.X----X..:.........:......X----X..XXX............X-----------------------------------
X....,,,,,,,,,,,,.....X------X..................X--------------X......,....X--------X..,,,,,,,,.....:......X----X...................X----X..X-X............X-----------------------------------
X...E.....E....E......X------X.A.............E..X--------------X.....,.....X--------X..................H..HX----X...................X----X..X-X...H........X-----------------------------------
X:..................:.X------X..................X---------------X....,....X---------X...................H..X----X..........E........X----X..X-X............X-----------------------------------
X.....................X------X..................X----------------X...,..E.X---------X........:............HX----X...................X----XH.XXX............X-----------------------------------
XXXXXXXXXXXXXXXXXXXXXXX------X..................X-----------------X..,....X---------X.................H.H..X----X.................:.X----X..,:,............X-----------------------------------
-----------------------------XX,,,,,,,,,,,,,,,,,X-----------------X.,....X----------X....................H:X----X...................X----X..,:,,,,,,,,,....X-----------------------------------
-------------------------------XXX..............X------------------X,...X-----------XXXXXXXXXXXXXXXXXXXXXX,X----X...................X----X.,...........,...X-----------------------------------
----------------------------------XXX............XX----------------XXE..X--------------------------------X.X----X,,XXXXXXXXXXXXXXXXXX----X.,............,,.X-----------------------------------
-------------------------------------XXXX..........XXXXX--------XXX....X---------------------------------X..XX-X..X----------------------X:...............,X-----------------------------------
-----------------------------------------X..............XX------X.....X---------------------------------X.....X...X----------------------XXXXXXXXXXXXXXXXXXX-----------------------------------
-----------------------------------------X................XX----X....X----------------------------------X........X-----------------------------------------------------------------------------
------------------------------------------X.................X----X...X-----------------------------------XX.....X------------------------------------------------------------------------------
-----------------------------------------X..................X----XX.X--------------------------------------XXXXX-------------------------------------------------------------------------------
----------------------------------------X.................A.X------X---------------------------------------------------------------------------------------------------------------------------
---------------------------------------X....................X----------------------------------------------------------------------------------------------------------------------------------
--------------------------------------X..............E......X----------------------------------------------------------------------------------------------------------------------------------
-------------------------------------X......E...............X----------------------------------------------------------------------------------------------------------------------------------
--------------------------------------X..A..................X----------------------------------------------------------------------------------------------------------------------------------
--------------------------------------X..........H..........X----------------------------------------------------------------------------------------------------------------------------------
---------------------------------------X....................X----------------------------------------------------------------------------------------------------------------------------------
----------------------------------------X...................X----------------------------------------------------------------------------------------------------------------------------------
-----------------------------------------X............K...XX-----------------------------------------------------------------------------------------------------------------------------------
------------------------------------------XX............XX-------------------------------------------------------------------------------------------------------------------------------------
--------------------------------------------XX........XX---------------------------------------------------------------------------------------------------------------------------------------
----------------------------------------------XXXXXXXX-----------------------------------------------------------------------------------------------------------------------------------------
