XXXXXXXXXXXXXXXXXXXXXXXXXXXXXXXXXXXXXXXXX
X.......................E...............X
X.<.....E.........E...:.........E.....<.X
X.......................................X
X...,,,...,,,,,.,,,,,.,,,,,...,,,,,,,,,.X
X...,..,..,...,.,...,.,...,...,.......,.X
X...,...,.,...,.,...,.,...,.:.,.......,.X
X...,...,.,...,.,...,.,...,...,.......,.X
X.:.,..,..,...,.,...,.,...,...,.......,.X
X...,..,..,...,.,...,.,...,...,.......,.X
X...,.,...,,,,,.,,,,,.,,,,,...,.......,.X
X...,.,.......................,.......,.X
X.:.,,,.E...,,....:...,,,,,.E.,,,.....,.X
X...........,.,,......,...,......,,,,.,.X
X.....,,,,,.,...,,....,...,...,,,....,,.X
X...,,....,.,.....,,..,...,...,..,,,,...X
X.,,......,.,.......,.,...,...,......,,.X
X.,.......,.,.....,,..,...,.E.,.......,.X
X.,.......,.,...,,..:.,...,...,.......,.X
X.,.......,.,.,,......,...,...,......,..X
X.,,......,.,,:...,...,,,,,...,......,..X
X...,,...+,.....,,,...........,......,..X
X.E...,++......,..,...:...E...,......,..X
X............,,...,............,,....,..X
X.,,,,,,,,,.,.....,.,,,,,,,,,....,..,.:.X
X.,.......,.,.....,.,.......,..E..,,,...X
X.,.......,.,.....,.,.......,.......,...X
X.,.......,.,.....,.,.......,...........X
X.,.......,.,.....,.,.......,.,,,,,,,...X
X.,.......,.,.....,.,.......,.,.....,...X
X.,,,,,,,,,.,.....,.,.......,.,.....,...X
X...........,.....,.,.......,.,.....,...X
X.....E.....,,,,,,,.,,,,,,,,,.,,,,,,,...X
X................E......................X
X.,,,,,,,,,.............E.......,,,,,,,.X
X.,.......,.....................,.....,.X
X.,.......,,,,,.,,,,,,,,,,,.,,,,,.....,.X
X.,.E.....,,,,,.,.........,.,,,,,.....,.X
X.,.......,,,,,.,.........,.,,,,,.....,.X
X.,...E...,,,,,.,.........,.,,,,,...E.,.X
X.,.......,,,,,.,....E....,.,,,,,.....,.X
X.,.......,,,,,.,.E.......,.,,,,,.....,.X
X.,.......,,,,,.,.......E.,.,,,,,.E...,.X
X.,.......,.....,.........,.....,.....,.X
X.,,,,,,,,,.:...,.........,.....,,,,,,,.X
X...............,....E....,.............X
X.....:.....:...,.........,...E.........X
X...............,.........,.............X
X.,,,,,,,,,.....,.........,.:...,,,,,,,.X
X.,.......,.....,...E.....,.....,.....,.X
X.,...E...,,,,,.,.........,.,,,,,.....,.X
X.,.......,,,,,.,.........,.,,,,,.....,.X
X.,...E...,,,,,.,E.....E..,.,,,,,..E..,.X
X.,....E..,,,,,.,.........,.,,,,,.....,.X
X.,.......,,,,,.,....E....,.,,,,,.....,.X
X.,.......,,,,,.,.........,.,,,,,...E.,.X
X.,.......,,,,,.,.........,.,,,,,.....,.X
X.,.......,.....,.........,.....,.....,.X
X.,,,,,,,,,.....,,,,,,,,,,,.....,,,,,,,.X
X........E..............................X
X.<...........E.......:.....E.......<...X
X.......................................X
XXXXXXXXXXXXXXXXXXXXXXXXXXXXXXXXXXXXXXXXX
