-----------------------------------------------------------X---------------------------------------------------------------------------------------------------
----------------------------------------------------------X.XX-------------------------------------------------------------------------------------------------
---------------------------------------------------------X....XX-----------------------------------------------------------------------------------------------
--------------------------------------------------------X..:....XX---------------------------------------------------------------------------------------------
------------------------------------------------------XX..........XX-------------------------------------------------------------------------------------------
-----------------------------------------------------X.......E......XX-----------------------------------------------------------------------------------------
----------------------------------------------------X.................XX---------------------------------------------------------------------------------------
---------------------------------------------------X.............,,.....XX-------------------------------------------------------------------------------------
--------------------------------------------------X..........,,,,..,,.....X-----------------------------X------------------------------------------------------
-------------------------------------------------X........,,,........,,....XX-------------------------XXX------------------------------------------------------
------------------------------------------------X.....,,,,.............,,....XX---------------------XX..X------------------------------------------------------
----------------------------------------------XX....,,..............E....,,..HHXX------------------X...:.X-----------------------------------------------------
---------------------------------------------X........,,...................,,..H.XX--------------XX......X-----------------------------------------------------
--------------------------------------------X...........,,...................,,....XX-----------X.....E..X-----------------------------------------------------
-------------------------------------------X..............,,...................,,....XX-------XX.........X-----------------------------------------------------
-----------------------------------------XX.................,,...................,,....XX---XX...........X-----------------------------------------------------
---------------------------------------XX..............:......,,...................,,.:..X-X..............X----------------------------------------------------
------------------------------------XXX.........................,,........A..........,..XXX...............X----------------------------------------------------
----------------------------------XX.......,,,,,,,,,,,,,,,,,,,,,..,,..............E.,.XXX..,............:.X----------------------------------------------------
-------------------------------XXX...E.....,...................,...,..............,,.XX...,.,.............X----------------------------------------------------
-----------------------------XX.....,,.....,.......,,,,,,,,,,,.,...,...E.........,..XX..,,...,..........:.X----------------------------------------------------
--------------------------XXX.....,,..,....,.......,:::...W..,.,...,............,..XX..,......,...........X----------------------------------------------------
------------------------XX......,,....,.....,......,:::.:....,.,..,............,..XX..,........,...,,,.....X---------------------------------------------------
----------------------XX.....,,,.......,....,......,..::.....,.,..,..........,,.XX..,,.........,...,.,.....X---------------------------------------------------
-------------------XXX.....,,...........,....,.....,.......:.,.,..,.........,..XX..,............,..,,,.....X---------------------------------------------------
-----------------XX......,,..............,...,.....,.........,.,..,........,..XX..,............E.,.........X---------------------------------------------------
--------------XXX.....,,,................,....,....,........:,.,..,.......,..XX.,,................,........X---------------------------------------------------
------------XX......,,....................,...,....,.........,.,..,.....,,.XXX.,...................,........X--------------------------------------------------
---------XXX......,,.......................,...,...,.........,.,..,....,..XX..,.....................,...E...X------------------------XHX-----------------------
-------XX.E....,,,..........................,..,...,.........,.,..,E..,..XX.,,.......................,......X----------------------XXH.HXX---------------------
----XXX......,,.............................,...,..,.........,.,.,...,..XX.,..........................,.....X--------------------XH.H.H.H.HX-------------------
--XX.......,,................................,..:..,:.......<,.,.,.,,..XX.,............................,....X---------------------XH.HW.HHX--------------------
XX...A...,,...........E......................,..:,,,.........,.,.,,..XXX,,..............................,....X----------------------XHHHHX---------------------
--XXX......,,,...............................,..............<,.,.,..XX.,................................,...:X-----------------------X+X-----------------------
-----XX.......,,,............................,..:,,,:........,.,...XX..,..............E..................,...XXXXXXXXXXXXXXXXXXXXXXXXX+XXXXXXXXXXXXXXXXXXXXX---
-------XXX.......,,,.........................,...,.,........<,.,...++...,........................E........,..,.,..E....................E.....E............:X---
----------XXX.......,,,......................,...,.,.........,.,...++...E..................................,.XXXXXXXXXXXXXXXXXXXXXXXXXXXXXXXXXXX...........X---
-------------XX........,,,...................,...,.,........<,.,...++...,.................................,,:X---------------------------------X...........X---
---------------XXX........,,,................,...,.,.........,.,...XX....,...........................,,,,,....X--XHXXXXXXXXXXXXXXXXXXXXXXXXXXXXX:.....:...:X---
------------------XXX........,,,.............,...,.,.........,.,...XX....,.......................,,,,.........X--XH.E....E............E............E..:.XX-----
---------------------XX.........,,,..........,...,.,.........,.,...XX.....,.................,,,,,..,,,...E....XX-XH..................................XXX-------
-----------------------XXX.........,,,.......,...,.,.........,.,...XX.....,............,,,,,.......,.,.....XXX---XB...E.......B....E........E....B.XX----------
--------------------------XXX.........,,,....,...,.,,,,,,,,,,,.,...XX.....,........,,,,E...........,,,..XXX------XXX,XXXXXXXXXXXXXXXXXXXXXXXXXXXXXX------------
-----------------------------XX..........,,,.,...,.............,...X-X.....,..,,,,,............E.....XXX-----------X.X-----------------------------------------
-XX>>XXX-----------------------XXX..........,,...,,,,,,,,,,,,,,,...X-XE....,,,....................XXX--------------X,X-----------------------------------------
--X.E..X--------------------------XXX.........E....................X-X.........................XXX-----------------X.X-----------------------------------------
--X....X-----------------------------XX.....B.............E........X-XXXXXXXXXXX+++XXXX,,,,X,XX--------------------X,XX--------XXXXXXXHXXXXX-------------------
---XLXXX-------------------------------XXX.......................A.X-------XA....E.H.XX....X.X--------------------X....XX------X........W.HX-------------------
---XLX------------------------------------XXXXXXXXXXXXXXXXXXXXXXXXXX-------X.........XX...XX,X-------------------X+++++++X-----X.XXXXXXXXXXX-------------------
-XX++X---------------------------------------------------------------------X..E....H.XX...XX.X-------------------X+++++++X-----X+X-----------------------------
-X+++XXXXXXXXXXXXXXXXXXXXXXXXXXXXXXXXXXXXXXXXXXXXXXXX:XX---------XXXXX-----X.........X-X..XX,X---XXXXXXXXXXXXXXXXX,,,,,,,XXBXXXX+XXXXXXXXXXXXXXXXX-------------
-X...,.E.,.,.,.,.,.,.,.,.,.,....................H.:,...X---------XH.AX-----XA..H.A.A.X-X..XX.X---XH...E...E..+......E....................E.......,X------------
-X:,,,,,,,,,,,,,,,,,,,,,,,,,.....,,,....E..........,.E.X---------XE.EX-----XXXXXXXXXXX-XHX-X,X---X..E...:....+.B...................B...B...B...B.,EXX----------
-X......................:........,E,...............,...X---------X,,,X-----------------X,X-X.X---XXXXXXXXXXXXXX..............................E...,...X---------
-X...............................,,,...............,...X-XXXXXXEXX,,,XX:XXXXXXXXXXXXXXXX,XXX,XX:XXXXXXXXXXXXXX-X........................E......B.,.E..X--------
-X....................E............................,...X-X.H.....,,,,,......E...........:................:...X-X...........................E.....,.....X-------
-X.................................................,...B-X........,,,:....:........................:.........X-X...............................B.,....W.X------
-X.................................................,...X-X......,,,,.+...............:..:..................E.X-X.......................E.........,.E.....XX----
-X..........:....................................E.,...XXX:,,:,,:.,,.+.........:.E...........................X-X.............................B.,,,.....E...X---
-X.................................................,...L.L,,,,,,,.,,.+......................:..A.........:...X-XE...........................E..,.,..........X--
-X.....,,,,,,,,,,,,,,,,,,,,,,,,,,,,,,,,,,,,,,,,,,,,,...L.L,,,,,,,.,,.+....:..................................X-X.............................B.,.,.E...E..:..X-
-X.....,...,........................:...:..:...........L.L,,,,,,,.,,.+............:.............:...:...:....X-X...............................,.,..........X--
-X..:..,.E.,...........................................L.L,,,,,,,.,,.+..................:....................X-X.......................E...E.B.,,,.....E..XX---
-X.....,...,...........................................L.L,,,,,,,.,,.+............................E.........:X-X.................................,.E...A.X-----
-X.....,,,,,,,,,,,,,,,,,,,,,,,,,,,,,,,,,,,,,,,,,,,,,...L.L,,,,,,,.,,.+......:...............:........:.......X-X...........................E...B.,....E.XXX----
-X..........:....................................,K,...L.L:,,:,,,.,,.+..................:....................X-X.................................,.....+HHHXX--
-X...............................................,,,...XXX,,,,,,:,,,.+........E.....:........................X-X.........,E,A,....E....E.......B.,.E..XH.HHH.:X
-X................................................H,...X-X..E.....,,,:...:......................:....:.......X-X...E.....,A.E,..............E....,.H.X-X.H.HHX-
-X................................E................,...B-X.H.....,,,,,.................E.....................X-X.........,,,,,.........B...B...B.,.XX--X.H.XX--
-X....................E............................,...X-X.......,...,.:.........:..........:.............E..X-X......E.....E...A................,X-----X.X----
-X...............................,,,...............,...X-XXXXXXXXX,,,XXXXXXXXXXX,K,XXXXXXXXXXXXXXXXXXXXXXXXXXX-XXXXXXXXXXX,,,XXXXXXXXXXXXXXXLXXXXX-------X-----
-X...............................,E,....E..........,...X---------XE.EX---------X..EX-------------------------------------X.E.X-------------X.X-----------------
-X...............................,,,..............:,..EX---------X...X---------XE..X---XXXXXXXXXXXXXXXXXXXXXXXXXXXXXXX---X...X-------------X,X-----------------
-X:................................................,.H.X---------XH.HX---------XLLLX---XH....H...A....H....H...W....HX---X.W.X-------------X.X-----------------
-XXXXXXXXXXXXXXXXXXXXXXXXXX,,,,,,,,,,,,,,,,,,,,,,,,,,,,X-XXX-----XXXXX---------XLLLX---X.XXXXXXXXXXXXXXXXXXXXXXXXXXX.X---XLLLX-------------X,X-----------------
-------------------------XX,,,,,,,,,,,,,,,,,,,,,,,,,,,,XX---XXXX---------------X...X---X+X-------------------------X+X---X...X-------------X.:-----------------
----------------------XXXXXXXXXXXXXXXXXXXXXXXXXXXXXXXXXXXXXXXXXXXX-------------X...XXXXX+XXXXXXXXXXXXXXXXXXXXXXXXXXX+XXXXX...X-------------X,X-----------------
-------------------------------------------------------------------------------X.:............E..............................X-------------X.,X----------------
-------------------------------------------------------------------------------XXXXXXXXXXXXXXXXXXXXXXXXXXXXXXXXXXXXXXXXXXXXXXX-------------X,.X----------------
-------------------------------------------------------------------------------------------------------------------------------------------X.,X----------------
-XXXXXXXXXXXXXXXXXXXXXXXXXXXXXXXXXXXXXXXXXXXXXXXXXXXXXXXXXXXXXXXXXXXXXXXXXXXXXXXXXXXXXXXXXXXXXXXXXXXXXXXXXXXXXXXXXXX-----------------------X,.X----------------
-X.................................................................................................................X----------------------X.,,X----------------
-X..............................................................................E..................................X---------------------X.,,.X----------------
-X.................................................................................................................X--------------------X.,,.,X----------------
-X....................................................................E............................................X-----------------XX:,.,.,:X----------------
-X.................................................................................................................X---------------XX.,..,.,,.X----------------
-X.......,,,,,,,,,,,,,,,,,,,,,,,,,,,,,,,,,,,.....,,,,,,,...................................,,,,,,,.....,,,,,,,.....X------------XXX,.:.,.,.,.X-----------------
-X.......,.................................,.....,.....,...................................,.....,.....,.....,.....X-------XXXXX.,..,..,..,.,:-----------------
-X.......,..E...........................E..,.....,...E.,...................................,.....,.....,...A.,.....XXXXXXXX:,.,...,.,...,.,.,X-----------------
-X.......,........A........A......A........,.....,.....,...................................,...H.,.....,.....,.....,.L.+.,..,..,.E,..,.E,..,.X-----------------
-X.......,.................................,.....,.....,,,,,,,,,,,,,,,,,,,,,,,,,,,,,,,.....,.....,.....,.....,.....,.LE+.,...,.,...,.,...,.,.X-----------------
-X.......,.................................,.....,...................................,.....,.....,.....,.....,.....,.L.+..,..,..,..,.E,..,..X------------------
-X.......,..A..,,,,,,,,,,,,,,,,,,,,,,,,,,,,,.....,............E......................,.....,.....,.....,..H..,.....,.L.+..,..,..,...,.,...,X-------------------
-X.......,.....,.................................,............................E...A..,.....,..E..,.....,.....,.....,.L.+..,..,.:.,..,..,..X--------------------
-X.......,.....,.................................,...................................,.....,.....,.....,...A.,.....,.L.+..,...,..,...,.,.X---------------------
-X.......,.....,.................................,...................................,.....,.....,..E..,.....,.....,.L.+.E,...,...,..,.:X----------------------
-X...E...,.....,.................................,.....,,,,,,,,,,,,,,,,,,,,,,,,,,,,,,,.....,.....,.....,..E..,.....,.L.+..,...,...,...XX-----------------------
-X.......,.....,.................................,.....,.H.................................,.....,.....,.....,.....,.L.+...,.E,....,XX-------------------------
-X.......,.....,.................................,.....,...................................,.....,.....,.....,.....,.L.+.E.,...,..XX---------------------------
-X.......,..A..,.................................,.....,............E......................,.....,.....,.....,.....,.L.+..XXXXXXXX-----------------------------
-X.......,.....,.................................,.....,...................................,.....,.....,..A..,.....XXXXXXX-------------------------------------
-X.......,.....,.................................,.....,...................................,.....,.....,.....,.....X-------------------------------------------
-X.......,.....,.............,,,,,,,.............,.....,.....,,,,,,,,,,,,,,,,,,,,,,,,,,,,,,,.....,.....,.....,.....X-------------------------------------------
-X.......,.....,.............,..H..,.............,.....,.....,.,.................................,.....,..E..,.....X-------------------------------------------
-X...E...,,,,,,,.............,.....,.............,.....,.....,.,...E............E................,.....,.....,.....X-------------------------------------------
-X.......,..E..,......E......,H...K,....E........,..A..,H...A,.,.......H......................W..,.....,.....,.....X-------------------------------------------
-X.......,,,,,,,.............,.....,.............,.....,.....,.,.................................,.....,.....,.....X-------------------------------------------
-X.......,..T..,.............,..H..,.............,..E..,.....,.,.................................,.....,..A..,.....X-------------------------------------------
-X.......,.....,.............,,,,,,,.............,.....,.....,,,,,,,,,,,,,,,,,,,,,,,,,,,,,,,.....,.....,.....,.....X-------------------------------------------
-X.......,.....,.................................,.....,...................................,.....,.....,...E.,.....X-------------------------------------------
-X.......,.....,.................................,.....,...................................,.....,.....,.....,.....X-------------------------------------------
-X.......,..A..,.................................,.....,............E......................,.....,...E.,.....,.....X-------------------------------------------
-X.......,.....,.................................,.....,.H.................................,.....,.....,.....,.....X-------------------------------------------
-X...E...,.....,.................................,.....,...................................,.....,.....,..A..,.....X-------------------------------------------
-X.......,.....,.................................,.....,,,,,,,,,,,,,,,,,,,,,,,,,,,,,,,.....,.....,.....,.....,.....X-------------------------------------------
-X.......,.....,.................................,...................................,.....,..E..,.....,..E..,.....X-------------------------------------------
-X.......,.....,.................................,...................................,.....,.....,.....,.....,.....X-------------------------------------------
-X.......,..A..,.................................,...........E................E...A..,.....,.....,.....,.....,.....X-------------------------------------------
-X.......,.....,,,,,,,,,,,,,,,,,,,,,,,,,,,,,.....,...................................,.....,.....,.....,.....,.....X-------------------------------------------
-X.......,...............................,.,.....,...................................,.....,..H..,.....,..A..,.....X-------------------------------------------
-X.......,...............................,.,.....,.....,,,,,,,,,,,,,,,,,,,,,,,,,,,,,,,.....,.....,.....,.....,.....X-------------------------------------------
-X.......,..E......A.......A......A.....E,.,.....,..E..,...................................,.....,.....,.....,.....X-------------------------------------------
-X.......,...............................,.,.....,.....,...................................,,,,,,,.....,,,,,,,.....X-------------------------------------------
-X.......,...............................,.,.....,.....,...................................,.....,.....,.....,.....X-------------------------------------------
-X.......,,,,,,,,,,,,,,,,,,,,,,,,,,,,,,,,,,,.....,,,,,,,...................................,,,,,,,.....,,,,,,,.....X-------------------------------------------
-X....................................................................E..........................................E.X-------------------------------------------
-X.................................................................................................................X-------------------------------------------
-X.................................................................................................................X-------------------------------------------
-X.................................................................................................................X-------------------------------------------
-X.................................................................................................................X-------------------------------------------
-XXX,,,,,XXXXXXXXXXXXXXXXXXXXXXXXXXXXXXXXXXXXXXXXXXXXXXXXXXXXXXXXXXXXXXXXXXXXXXXXXXXXXXXXXXXXXXXXXXXXXXXXXXXXXXXXXXX-------------------------------------------
---X.....X-----------------------------------------------------------------------------------------------------------------------------------------------------
---X,,,,,X-----------------------------------------------------------------------------------------------------------------------------------------------------
---X.....X-----------------------------------------------------------------------------------------------------------------------------------------------------
---X.....X-----------------------------------------------------------------------------------------------------------------------------------------------------
---X.....X-----------------------------------------------------------------------------------------------------------------------------------------------------
---X.....X-----------------------------------------------------------------------------------------------------------------------------------------------------
---X.....X-----------------------------------------------------------------------------------------------------------------------------------------------------
---X.....X-----------------------------------------------------------------------------------------------------------------------------------------------------
---X..E..X-----------------------------------------------------------------------------------------------------------------------------------------------------
---X....HX-----------------------------------------------------------------------------------------------------------------------------------------------------
---X..tttX-----------------------------------------------------------------------------------------------------------------------------------------------------
---XH.t.tX-----------------------------------------------------------------------------------------------------------------------------------------------------
---XH.tttX-----------------------------------------------------------------------------------------------------------------------------------------------------
---XXXXXXX-----------------------------------------------------------------------------------------------------------------------------------------------------
