----------------------------------------------------XXXXXXXXXXXXXXXXXXXXXXXXXXXXXXXXXXX------------------------------------------------------------------------------------------------------
---------------------------------------XXXXXXXXXXXXX...................................XXXX----------------X---------------------------------------------------------------------------------
-----------------------------------XXXX....................................................XXX-------------XX--------------------------------------------------------------------------------
---------------------------------XX.,.........................................................XXX----------X.X-------------------------------------------------------------------------------
--------------------------------X....,...........................................................XXXX-----X...X------------------------------------------------------------------------------
-------------------------------X..E...,..............................................................XXX--X....XX----------------------------------------------------------------------------
-----------------------------XX........,................................................................XX.,.....X---------------------------------------------------------------------------
----------------------------X.....E.....,.................................................................,.,.E...X--------------------------------------------------------------------------
---------------------------X..E..........,.................................................................,.,,....X-------------------------------------------------------------------------
-------------------------XX...............,.................................................................,,.,....X------------------------------------------------------------------------
------------------------X................H.,..................................................................,.,....X-----------------------------------------------------------------------
-----------------------X........W........,,....................................................................,.,.E..X----------------------------------------------------------------------
---------------------XX....E............,.......................................................................,.,....XX--------------------------------------------------------------------
--------------------X...E............,,,.........................................................................,.,.....X-------------------------------------------------------------------
-------------------X.,..............,,......................................,,,,,,,,,,,,,,........................,.,.....X------------------------------------------------------------------
-------------------X..,............,,..XXX..............................,,,,.....W........,,.......................,.,,....X-----------------------------------------------------------------
------------------X....,.........,,..,.X:X............................,,....,:,,,,,,,,,,,,..,,......................,,.,....X----------------------------------------------------------------
------------------X.....,.......,,.,.,.X.X........................,,,,..,,,,..............,,..,,,.....................,.,...X----------------------------------------------------------------
-----------------X.......,......,..,..,XWX........................,.t.,,....................,,...,,....................,.,E..X---------------------------------------------------------------
-----------------X........,.H.,,....,.,X.X........................,,,,........................,,...,,...................,,...X---------------------------------------------------------------
----------------X..........,.,......,..XLX......................................................,,...,,.................,.,...X--------------------------------------------------------------
----------------X...........,........,...,........................................................,,...,.................,,...X--------------------------------------------------------------
---------------X......................,..,..........................................................,,..,................,.,..X--------------------------------------------------------------
---------------X......................,..,............................................................,..,................,,...X-------------------------------------------------------------
---------------X.......................,.,.............................................................,..,...............,,.E.X-------------------------------------------------------------
--------------X........................,..,.............................................................,..,..............,.,..X-------------------------------------------------------------
--------------X.........................,.,..............................................................,..,..............,,...X------------------------------------------------------------
--------------X.........................,.,...............................................................,..,.............,.,..X------------------------------------------------------------
--------------X.........................,..,...............................................................,..,.............,,...X-----------------------------------------------------------
--------------X..........................,.,................................................................,..,............,,...X-----------------------------------------------------------
-------------X...........................,..,................................................................,..,...........,.,.EX-----------------------------------------------------------
-------------X............................,.,.................................................................,..,...........,,...X----------------------------------------------------------
-------------X............................,,,..................................................................,..,..........,.,..X----------------------------------------------------------
-------------X............................,.,...................................................................,..,..........,,...X---------------------------------------------------------
-------------X............................,.,....................................................................,..,.........,,...X---------------------------------------------------------
-------------X............................,.,.....................................................................,.,.........,.,..X---------------------------------------------------------
-------------X............................,.,.....................................................................,..,.........,,...X--------------------------------------------------------
-------------X.............................,.,.....................................................................,.,.........,.,..X--------------------------------------------------------
-------------X.............................,.,......................................................................,.,.........,,..X--------------------------------------------------------
-------------X.............................,.,......................................................................,.,.........,,...X-------------------------------------------------------
-------------X.............................,.,.......................................................................,.,........,.,E.X-------------------------------------------------------
------------X..............................,,,.......................................................................,.,.........,,...X------------------------------------------------------
------------X..............................,.,........................................................................,,.........,.,.XX------------------------------------------------------
------------X..............................,,,............................ttt...................................ttt...,.,.........,XX--------------------------------------------------------
------------X..............................,.,............................t.t...................................t.t...,.,.........X----------------------------------------------------------
------------X..............................,.,............................ttt...................................ttt...,.,.........X----------------------------------------------------------
------------X..............................,.,.........................................................................,,.........X----------------------------------------------------------
------------X..............................,.,.........................................................................,.,........X---------------XXX----------------------------------------
------------X..............................,.,.........................................................................,.,........X---------------XTX----------------------------------------
XXXXXXXXXXXXX..............................,.,.........................................................................,.,........X-------------XXX,XXX--------------------------------------
X...........,..............,,,,............,.,..........................................................................,,........X-------------X<.<.<X--------------------------------------
X...........,.............,,...,,,.........,:,..........................................................................,.,........X------------X.....XXXXX----------------------------------
X...........,............,.,,,...,,,.......,.,..........,...............................X...............................,.,........X------------X..:..+Wt:X----------------------------------
X.....E.....,..........,,.,...,,,...,.....,..,.........,,,.............................XXX..............................,.,........X------------X.....XXXXX----------------------------------
X...........,.........,..,.......,,..,....,W.,.......,,,.,,...........................XX.XX.............................,.,........X------------XH...HX--------------------------------------
X...........,........,,.,..........,.,,...,.,.......,.,,,.,,,........................XX...X.............................,.,........X------------X.....X--------------------------------------
X...........,........,.,............,..,..,.,......,.,,T,..,,,......................XX..E..X.............................,,........X------------X.....X--------------------------------------
XXXXXXXXXXXXX........,.,.............,..,,..,.......,.,,,....,,....................XX.......X............................,,........X------------X.W...X-----------------------------------XXX
X...........,.......,.,..............,...,..,........,...E..E.,,..................XX.E.....,.,...........................,,........X------------X.....X-----------------------------------X:X
X...........,.......,,,...............,.,.,,..........,........,,................XX.......,.H.,..........................,,........X----------XXX,,,,,XXX---------------------------------XtX
X...........,.......,.,................,...,...........,,...E...,,..............XX.......,.....,.........................,,........X----------X...,,....X--------------------------------X-X-
X.....E.....,.......,.,................,...,.............,.......,,............XX..E....,.......,........................,.,.......X----------X...,,....X---------------------------X--XXWX--
X...........,.......,.,.......E........,,..,..............,.......,,,.........XX.......,.........,.......................,.,.......X----------X...,,....X--------------------------X.X-X,.X--
X...........,.......,,,...............,..,,.,,.............,..E.....,,.......XX.......,...........,......................,.,........X---------X...,,....X-------------------------X...XW.X---
X...........,.......,..,.............,..,.,,..,.............,....E...,,......X-X.....,.........E...,.....................,.,........X---------X...,,....X------------------------X.....XX----
XXXXXXXXXXXXX........,.,............,...,...,..,,............,......H.,,.....X--X...,.....,,,,,.....,.....................,,........X---------X...,,....X-----------------------X..,,...X----
X...........,........,,.,..........,...,.....,...,............,,.E...,,......X---X.,......,...,......,....................,,........X---------X...,,....X----------------------X..,,H,...X---
X...........,.........,.,.........,....,......,,..,.............,...,,.......X----X.H.....,.W.,.......,...................,,........X---------X...,,....X---------------------X..,,E,,....X--
X...........,..........,.,.......,....,.........,..,,............,.,.........X---X.,......,...,......,....................,,........X---------X...,,....X-------------XXX----X..,,.,,....X---
X.....E.....,...........,.,,,,,,,....,...........,,..,............,..........X--X...,.....,,,,,.....,.....................,,........XXXXXXXXXXX...,,....XXXXXXXXXXXXXXX,XXXXX...,.,,....X----
X...........,............,,.....,..,,..............,..,,.....................X-X.....,.........E...,......................,,........,.............,,..............,.........,..,..,....X-----
X...........,.............,,,,...,,.................,,..,....................XX.......,...........,.,.....................,,........,.............,,..............,E......E.,.,..,....X------
X...........,.................,,,,....................,..,,...................XX.......,.........,.,.,....................,.,,......,.............,,..............,.........,,..,....X-------
XXXXXXXXXXXXX..........................................,...,...................XX..E....,.......,...,,....................,...,,,,,,,,,,,,,,,,,,,,,,,,,,,,,,,,,,,,,,,,,,,,,,,..,....XXXXXXX--
------------X...........................................,,..,...................XX.......,..H..,....,.,...................,E..,H,H,H,H,E,H,H,H,,,,,,,,,,,,,,,,,E,,,,,.......E.,.....,.,W.:X--
------------X.............................................,..,,..................XX.......,...,......,,,,,,A,,,,..........,.,,......,.............,,..............,,,,,,,,,,,..,....XXXXXXX--
-------------X.............................................,,..,..................XX..E....,.,.......,...,,,,,,,,,........,,........,.............,,..............,.........,,..,....X-------
-------------X...............................................,..,,..................X.......X........,.,,.......,.,.......,,........,.............,,..............,E.....E..,.,..,....X------
-------------X................................................,...,..................X..E..X.........,.,.........,,.......,.........,.............,,..............,.........,..,..,....X-----
-------------X.................................................,,.,,..................X...X..........,.,..........,,.....,,.........XXXXXXXXXXX...,,....XXXXXXXXXXXXXXX,XXXXX..,,..,....X----
-------------X...................................................,,.,..................X.X...........,.,..........,,.....,,.........X---------X...,,....X-------------XXX----X..,,..,....X---
--------------X....................................................,.,....ttt...........X............,.,.,,,,,,,,t,,,...,,.........X----------X...,,....X---------------------X..,,E.,....X--
--------------X.....................................................,.,...t.t........................,.,,....E..t.,H,...,,.....,...X----------X...,,....X----------------------X..,,H,..XX---
-------------XX......................................................,.,,.ttt........................,.,.,,,,,,,,t,,,...,,..,,,.,.X-----------X...,,....X-----------------------X..,,..X-----
-----------XX.,.......................................................,..,...........................,,,,...............,,,,,,.,.X------------X...,,....X------------------------X.....,X----
-----------X...,.......................................................,..,..........................,,..................,,,...,+X------------X...,,....X-------------------------X...XA.X---
------------X.E,........................................................,..,.........................,,...................,....X..X-----------X...,E....X--------------------------X.X-X,.X--
------------X...,........................................................,..,...................XXX,,,,,XXX...................XX.EXXXXXXXXX---X...,,....X---------------------------X---XW,X-
-------------X..,.........................................................,,,...................X-X.....X-X...................X-X.,..H....X---X...,,....X--------------------------------X.X-
-------------X..,..........................................................,,...................XXX.....XXX..................X--X..,......X---XXX,,,,,XXX---------------------------------XtX
--------------X..,.........................................................,.,..................,H........,.................X---X..,...E..X-----X.....X-----------------------------------X:X
--------------X..,.....................................................,,,,,,,,,,,,,,,,,,,,,,,,,,...ttt...,...,,,,.........X----X..,......X-----X.....X-----------------------------------XXX
--------------X.E.,..................................................,,,..,.,,.:..W...,.,....H..,..EtTtE..,...,Tt,,.......X----X....,....AX-----X.....X--------------------------------------
---------------X..,.................................................,...,,,,,,,,,,,,,,,,,,,,,,,,,...ttt...,...,,,,,,,...XX-----X....,.....X-----X.....X--------------------------------------
---------------X..,.................................................,,.,....,,..................,H........,........,.,.X------X.....,....HX-----XH...HX--------------------------------------
----------------X..,................................................,.,.....,,..................XXX.....XXX........,,.X------X.....,,.....X-----X.....XXX------------------------------------
----------------X..,...............................................,..,.....,,..................X-X.....X-X.........X,XX-----X.....,,.E..AX-----X.....tTX------------------------------------
-----------------X..,..............................................,,,......,,..................XXX,,,,,XXX........X-X,,XXXXX:W..,,,......X-----X.....XXX------------------------------------
-----------------X..,,.............................................,.,......,,......................,.,..........XX---XX,,,,,.,,,,,......HX-----X.....X--------------------------------------
------------------XE..,,...........................................,:,.....,.,......................,.,.........X-------XXXXX,,,,.........X-----XXLLLXX--------------------------------------
------------------XX....,,,........................................,.,.....,,,......................,.,........X------------X............AX------X,,,X---------------------------------------
--------------------XXX....,,......................................,,,....,.,.......................,.,......XX-------------X.........E...X------X,,,X---------------------------------------
-----------------------XXE...,,,,...................................,.,,.,,.,.......................,.,....XX---------------XH..E.........X-----X.....X--------------------------------------
-------------------------XXX.E...,,,,...............................,.,.,..,........................,.,...X-----------------X.............X----X.......X-------------------------------------
----------------------------XXXX..E..,,XXXXXXXXXX....................,,W,,,.........................,.,.XX------------------X....A.H.A.H.HX---X..E...E..X------------------------------------
--------------------------------XXXXXE.X---------XXXXXXXXXXXXXXXXXXXXXXXXXXXXXXXXXXXXXXXXXXXXXXXXXXXX,XX--------------------XXXXXXXXXXXXXXX--X...........X-----------------------------------
-------------------------------------XXX------------------------------------------------------------X.X-------------------------------------X.............X----------------------------------
---------------------------------------------------------------------------------------------------XLLLX-----------------------------------X......>>>......X---------------------------------
---------------------------------------------------------------------------------------------------XLLLX----------------------------------X:......>.>.....:.X--------------------------------
----------------------------------------------------------------------------------------------XXXXXX.:.XXXXXX------------------------------X......>>>......X---------------------------------
----------------------------------------------------------------------------------------------X:...........HX-------------------------------X.............X----------------------------------
----------------------------------------------------------------------------------------------X,,,,,,W,,XXX,X--------------------------------X...........X-----------------------------------
----------------------------------------------------------------------------------------------XH.XXX....X-XHX---------------------------------X....E....X------------------------------------
----------------------------------------------------------------------------------------------X..X-X....XXX.X----------------------------------X.......X-------------------------------------
----------------------------------------------------------------------------------------------XH.XXX.....E.HX-----------------------------------X.....X--------------------------------------
----------------------------------------------------------------------------------------------X...E.........X------------------------------------XXXXX---------------------------------------
----------------------------------------------------------------------------------------------XH.....XXX...:X--------------------------------------------------------------------------------
----------------------------------------------------------------------------------------------X......X-X....X--------------------------------------------------------------------------------
----------------------------------------------------------------------------------------------XXXX...XXX...HX--------------------------------------------------------------------------------
----------------------------------------------------------------------------------------------XX-X,,,,E,,,,,X--------------------------------------------------------------------------------
----------------------------------------------------------------------------------------------XXXX.......XXXX--------------------------------------------------------------------------------
----------------------------------------------------------------------------------------------X.E........X-XX--------------------------------------------------------------------------------
----------------------------------------------------------------------------------------------XH...,,,...XXXX--------------------------------------------------------------------------------
------------------------------------------------------------------------------------------XXXXX....,:,....E.X--------------------------------------------------------------------------------
------------------------------------------------------------------------------------------XW,.,H...,,,.....HX--------------------------------------------------------------------------------
------------------------------------------------------------------------------------------XXXXX.....E..XXX..X--------------------------------------------------------------------------------
----------------------------------------------------------------------------------------------XXXX.....X-X.HX--------------------------------------------------------------------------------
----------------------------------------------------------------------------------------------XX-X,,,,,XXX,,X--------------------------------------------------------------------------------
----------------------------------------------------------------------------------------------XXXX......E..HX--------------------------------------------------------------------------------
----------------------------------------------------------------------------------------------X.E...........X--------------------------------------------------------------------------------
----------------------------------------------------------------------------------------------XH.....XXX...:X--------------------------------------------------------------------------------
----------------------------------------------------------------------------------------------X......X-X....X--------------------------------------------------------------------------------
----------------------------------------------------------------------------------------------XXXX...XXX...HX--------------------------------------------------------------------------------
----------------------------------------------------------------------------------------------XX-X....E.....X--------------------------------------------------------------------------------
----------------------------------------------------------------------------------------------XXXX.........HX--------------------------------------------------------------------------------
----------------------------------------------------------------------------------------------X,E,,,,,,,,XXXX--------------------------------------------------------------------------------
----------------------------------------------------------------------------------------------XH.........X-XX--------------------------------------------------------------------------------
----------------------------------------------------------------------------------------------X..........XXXX--------------------------------------------------------------------------------
----------------------------------------------------------------------------------------------XHXXX........HX--------------------------------------------------------------------------------
----------------------------------------------------------------------------------------------X.X-X..XXX..E.X--------------------------------------------------------------------------------
----------------------------------------------------------------------------------------------XHXXX..X-X...HX--------------------------------------------------------------------------------
----------------------------------------------------------------------------------------------X..E...XXX....X--------------------------------------------------------------------------------
----------------------------------------------------------------------------------------------XH......E....:X--------------------------------------------------------------------------------
----------------------------------------------------------------------------------------------XXXXXXX,XXXXXXX--------------------------------------------------------------------------------
----------------------------------------------------------------------------------------------------XXX--------------------------------------------------------------------------------------
