-------XXXXXXXXXXXXXXXXXXXXXX----------------------
-------X.........+...........XXXX------XXXXXX------
-------X.........+.E.............XXXXXX...,..XX----
-------X.........+...XXX,,,XXXX.E.,+,,.,,.,...X----
-------X.........XXXXXXX,,,XXXXXXXXXX,,.,.,...X----
-------X.........X...............++<<,..,.,...X----
-------X.........X.H:........XXX.++.<,..,.,...X----
-------X...:.....X...XX......X-X.,+,,,.,..,...X----
-------X.........X.AEXX......XXX.,.....,.,.....X---
-------X.........X..............H,.....,.,.....X---
-------X..:......X..............H,....,..,......X--
-------X.........X.......XX.....H,....,...,....X---
-------X.:.......X......EXX......,...,....,...X----
-------X......E..X.......XX......,...,...,..,,X----
-------X.E.......X...............,...,..,..X...X---
-------X.........XA..............,..,..,...X..EX---
-------X...B.B...X...XX......XXXH,..,..,...X.E.X---
-------X.BB.B....X..EXX......XXX.,..,.,....XX.X----
-------XBBBB..B..X...............,..,.,.....X.X----
-------X.K...E...XA..H........H.E,.,..,.....X.X----
-------X,,,,,,,,,X,,,,,,,,,,,,,,,,.,.,......X.X----
-------X.................,...,.....,.,......XXEX---
--------X..E....E.......E+++++.....,.,......XX.X---
--------X................,...,.....,.,.......X.X---
---------X...............,...,.....,.,.......XXX---
---XXX---X...........E...,...,.....,.,.......XXX---
-XX.A.XXX,...............,..E,......,.,......XXX---
-X.....++.,..............,...,......,..,.....XEX---
X.E....+.XX..............,...,.......,.,....XX-X---
X...W.:.X-X............:.,...,.......,,.,...XX-X---
X......X---X.............,...,....,,,..,,,..XXX----
>....H.X---X..:......:...,...,....,.,,,.....X-X----
-XX...X----X......:......,.E.,...,..,......XXX-----
---XXX------X............,...XX,,,.,.......X.X-----
------------X.E..........,...XW.,,.,.......XEX-----
------------X............,...XHE,.,.,.....XXX------
-------------X...........,...XX.,.,.,.....X-X------
-------------X...........,...XHE,.,.,.....X-X------
-------------X...........,..EXXA:,,.,.....X-X------
--------------X..........,...XAAA,,..,...XXX-------
--------------X..........,...XA.H,.++,...X.X-------
--------------X..........,...XE,H,HHHX...XEX-------
--------------X..........,...XX,H....X...X.X-------
---------------X.........,...XX,....EXH..X.X-------
---------------X.........E...XX,E....X...X.X-------
---------------X.......,,,,,,XX,,,...XXXX..X-------
----------------X......,.H.......H...XX,E..X-------
----------------X......,.........,...,A.,+.X----X--
----------------X......,........E,,+,,.A,++X---XHX-
-----------------X.....,.........,++.AA.,..X-XXE.AX
-----------------X.....,H........,,+,,.E,...X..EEX-
-----------------X.....,.........,A..E..,........X-
------------------X....,.........,.E...E,.......X--
------------------X,,..,.........,......,.W.XXXX---
------------------X+,.E,E.......H,...:..XXXX-------
------------------X+,,,,.........,......X----------
------------------X.,.+L........H,......X----------
------------------XE,E+L.........,.....X-----------
------------------X.,.+L........H,.....X-----------
------------------X.,.XX.........,.....+X----------
------------------XE,.XXE........,.....++X---------
-------------------X,E.X,,,,,,,,,,....++..X--------
-------------------X,....E..E..E..E...X+...X-------
-------------------X,.................X....X-------
-------------------X,,,,,,,,,,,,,,,,,X..E.X--------
-------------------XH.E..E..E...E..E..E...X--------
-------------------XXXXXXXXXXXXXXXXXXXXXXX---------
