---------------------------------XXXXXXXXXXXXXX------------------------------------
--------------------------------X..............XX----------------------------------
-------------------------------X...,,,,,,,,,,,...X---------------------------------
-------------------------------X...,....:....,...X---------------------------------
-------------------------------X.XX,....:....XX..X---------------------------------
-------------------------------X.XX,..A...A..XX..X---------------------------------
-------------------------------X...,.........,...X---------------------------------
-------------------------------X...,....W....,...X---------------------------------
-------------------------------X...,,,,,,,,,,,...X---------------------------------
-------------------------------X...XXXX..XXXX....X---------------------------------
-------------------------------X...X--X,,X--X....X---------------------------------
-------------------------------X...X--X++X--X....X---------------------------------
-------------------------------X...X--X,,X--X....XXXX------------------------------
-------------------------------X...X--X,,X--X....XX,X------------------------------
-------------------------------X...X--X,,X--X....XXXX--XXX-------------------------
-------------------------------X...X--X,,X--X....X-XXXX...X------------------------
-------------------------------XX..X--X..X--X...XX-X,,,,...X-----------------------
--------------------------------X,X---XX,X---X,X--X.....,,.X-----------------------
---------------------------XXXX-X,X--XXX,XX--X+X--X,,,,,,.,,X----------------------
--------------XXX-XXX-XXX-XX..,XX,XXXX<.<<X-XX,XXX.,..,,,...,X---------------------
--------------X.X-XEX-X.X-X,...+....XX..E.X-X...,,.,..,X,...,X---------------------
------------XXX,XXX,XXX,XXX,...+.A..XX..W.X-X.H.,,,.....,...,X---------------------
------------X....,,.......W,...+....XX.E.EX-X...,,,.....,....X--------------X------
----------XXX..,,,K........,...XX,,XXXX+++X-X,,,XX,,,,,,,....X-------------X.X-----
----------X.,..,E,.........,...XX++XXXX,,,X-X,,,X.....,,,,,,,X------------X.,,XX---
----------X.,..,,,........E,........XX,,,,X-X.........,,,,,,,X-----------X.,,..,X--
----------X.,..............,.........X,.T,XX.........,,XX,,,XX--------XXX.,,....XX-
----------X.,............B.,.........,,,,,,,.........,,XX,,,XXXXXXXXXXX,,,,...H.,.X
----------X.,.............E,.....ttt.,,,,,,,.ttt.....,,XX,,,,,.X,,,,,.,,,,.....,.XX
----------X.,.........,,,..,.....t.t.,,..,,,.t.t....,.,,,,.::,.,,EE,E.,.......,.,X-
----------XXX...XX,XX.,.XXX,.....ttt.,,..,,,.ttt....,.,,,,...,.,,,..,.,......,.,X--
------------X...XXXXX,,,X-X,.........,,,,,,,........,.,,,,:W.,.,,EE.E,......,.,X---
------------X,,,,X--X,,,X-X,.........X,..,XX.......,..,XX,...,.,,,,,,,......,,X----
------------X...XX--X.,EX-XX,,,,,,,,XX,,,,XX,,,,,,,,.XXXX,...,.XXX,,XXX.....,,X----
------------X,,,XXXXX,,.XXXX,,,,,,,,XXX,,,X-X,,,,,,,,X--XX,,,XXX-X,,X-X.....,XX----
-------XXXXXX..E.B........XXXXXXXXXXX-X+++X-XXXX,,,,XX--XX,,,XXXXX,,X:XX,,,,,XX----
-----XX.X+..,.............X-XXXXXXXHBBX+++BXHXXX,,,,XXXX........,.....XX,,,,,,X----
----X....+..,.....E.......XXX...,,,.,.......,,,....,,,....,,,,,,,,,,..,,,,,,,XX----
----X.....K.,.............,+....,,,.,.......,,,....,,,....,..,,,...,..,,,,..,XX----
---X,....+..,.............,+....,,,.,.......,,,....,,,....,..,,,...,..XX,,..,,X----
---X.,,XX+..,E............,+....,,,.,.A.A.A.,,,....,,,....,..,,,...,..XX,,,,,XX----
---X...XXXXXX...B.........XXX....XXX,......,.XXX....XXX...,..,,,,,,XXXXXXXXXXX-----
---X...X----X.HXXXX,,,XXXXXXXXXXXX-XXX,,,,,XXX-X++++X-XXX.,...,...HX:X-------------
---X.,,X----X..XX..........X---------X,,,,,X---X.,,.X---X.,...,....XXX-------------
---X,,,.XX--XXXXX..........X------XXXXH.HH,XXX-XW...X---XE,E,,,...,XX--------------
---X,.....XXXXXXX..........X------XE,,,...,,EX-X....X---X.......,,...X-------------
---X,,,,,,,,,,,,.........,,XX--XXXXXXXH.HH,XXX--X,,,X---XXXXXXXE.....X-------------
----X,,,,,,,,,,.,.......,....XX.....XX,,,,,XXXXXX,,,X---------X..E...+-------------
----X,...,,,,,,.,......,.....,,.....XX,,,,XX:...,...X---------X:.....X-------------
----X,...,XXXXX..,...XX......,,..E..XX,,,,X-XW..,...X---------XXXXXXXX-------------
----X,...,X----XX.,,,X-X.....,,.....XX,,,,XXXE..,...X------------------------------
----X,...,X------X,,,X--X.E..XX.....XX,,,,,XX...,...X------------------------------
----X,,,,,X------X,,,X---XXXX--XX,AXX.,.T.,.X,HXXXXXX------------------------------
----X.....X------X,,,X----------X,,XX.,...,.X,,XX----------------XXXXXXX-----------
----XX,:,XX------X,,,X----------XE,..,,...,,,.,,X---XXX-XXX-XXX-XX,,,,,XX----------
-----XLLLXXXXXXXXX,,,XXXXXXXXXXXX,,,,.,,,,...,,,XX--XHX-XHX-XHX-X.......X----------
-----XELEX..E..,...E...,......XXE,,..,,,,,,....,,.XXX.XXX.XXX.XXX.......X----------
-----X...X.....,.E.....,......,L,,..,,..A.,,...,,.,.,.,.,.,.,.,.,..,,,..X----------
-----X...X.....,.....E.,......,L,,..,,.,,,,,...,,.,.,.,.,.,.,.,.,E.,W,:.X----------
-----XE.EX.....,.......,......,L,,..,,A,WA,,...,,.,.,.,.,.,.,.,.,..,,,..X----------
-----XXXXX.....,E......,E.....XXX,..,,.,,,,,...,,.XXXAXXXHXXXHXXX.......X----------
---------XX,,XXX,,,,,,,XXXXXXXX-X,...,,,A,,....,XX--XEX-XEX-XEX-X......XX----------
----------X..X-X,,,,,,,X--------X,....,,,,.....EX---XXX-XXX-XXX-XXXXXXXX-----------
-:XXXXXXXXX,,XXX,,,,,,,XXX------X,,,,.......,,,,X----------------------------------
XX...,,,,................X----XXX,...,,..,,,...,XXX--------------------------------
X,E..,,,,..........H.....X---X,,,,....,..,.....,,,X--------------------------------
X,...,,,,.....H..H.......X---X........,..,.........X-------------------------------
X,...,,,,..A..........H..X---X.........,.,..........X------------------------------
X,......,................X---X.ttt.....,H,.....ttt...X-----------------------------
X,.:....,,,,,,,,,,,,,,,,,X---X.t.t.....,,,.....t.t...X-----------------------------
XX..A...,E...H....E..B..EX---X.ttt.....,.,.....ttt...X-----------------------------
-:......,.......H........X---X.........,.,...........X-----------------------------
-XXXXXXXX.H.B..........H.X---X.........,.,...........X-----------------------------
---------X..........E...X----X.......,,,,,,.........X------------------------------
----------XXH..E,,,....X-----X...X...,,...,...X,....X------------------------------
------------X...,.,...X------X...,....,.W,,...,,....X------------------------------
-------------XXXXXXXXX--------X.......,>E,,.........X------------------------------
------------------------------X........,,,.........X-------------------------------
------------------------------X..................XX--------------------------------
-------------------------------X................X----------------------------------
-------------------------------XXX............XX-----------------------------------
----------------------------------XXXX....XXXX-------------------------------------
--------------------------------------XXXX-----------------------------------------
-----------------------------------------------------------------------------------
