--XXXXXXXXXXXXXXXXXXXXXXXXXXXXXXXXX----------------------------------------------------------------------------------------------------------------------
--X............E.E...E.E.E.E,,...tX----------------------------------------------------------------------------------------------------------------------
--X.E...E...E...............,,..t.X----------------------------------------------------------------------------------------------------------------------
--X............E.E...E.E.E.E,,.t..X----------------------------------------------------------------------------------------------------------------------
--X.........................,,t...X----------------------------------------------------------------------------------------------------------------------
--X............E.E...E.E.E.E,,t...X----------------------------------------------------------------------------------------------------------------------
--X.E...E...E...............,,t..X-----------------------------------------------------------------------------------------------------------------------
--X............E.E...E.E.E.E,,t..X-----------------------------------------------------------------------------------------------------------------------
--X.........................,,t..X-----------------------------------------------------------------------------------------------------------------------
--X............E.E...E.E.E.E,,t..X-----------------------------------------------------------------------------------------------------------------------
--X.E...E...E...............,,t..X-----------------------------------------------------------------------------------------------------------------------
--X............E.E...E.E.E.E,,.t,X-----------------------------------------------------------------------------------------------------------------------
--X.........................XXXX..X----------------------------------------------------------------------------------------------------------------------
--X............E.E...E.E.E.EX---X.X----------------------------------------------------------------------------------------------------------------------
--X.E...E...E...............X---X..X---------------------------------------XXX---------------------------------------------------------------------------
--X............E.E...E.E.E.EX----X.X------------------------------------XXX...X--------------------------------------------------------------------------
--X.........................X----X..X------------------XXXXXXX----------X......X-------------------------------------------------------------------------
--X............E.E...E.E.E.EX-----X.X-----------------X.......XXX-------X......X-------------------------------------------------------------------------
--X,,,,,,,,,,,,,,,,,,,,,,,,,X-----X..X---XXXXXX-------X...A.....X------X....E...X------------------------------------------------------------------------
--X,,,,,,,,,,,,,,,,,,,,,,,,,X------X.X-XX......XX----X..........X------X.........X-----------------------------------------------------------------------
--X...tttttttttttttttttttt..X------X..X..........X---X........E..X-----X..H.A.A.HX-----------------------------------------------------------------------
--X.tt....................ttX-------X,,..........X----X..........X-----X.........X----XX-----------------------------------------------------------------
--XXXXXXXXXXXXXXXXXXXXXXXXXXX-----XX...,.........X----X.........AX------X...E....X----X.XX---------------------------------------------------------------
--------------------------------XX.....,.........X----X..........X------X........X----X...XXXXXXXXX------------------------------------------------------
------------------------------XX.......,.........X----X...E..E...X------X.E...E.X-----X...,........XXXXXXXXXXXXXXXXXX------------------------------------
----------------------------XX.........,.........X---X...........X------X......X-------X..,..........................XXXXXXXXXXXXXXXXX-------------------
--------------------------XX............,.......X----X.........E.X-----X...E.EX--------X.,............................................XXXXXXXXX----------
------------------------XX..............,.......X--XX.,..........X-----X.....X---------X.,....................................................X----------
----------------------XX................,........XX...,..........X-----X.....X--------X..,....................................................X----------
--------------------XX..................,..............,.......HX------X......X------X...,....................................................X----------
------------------XX.....................,.............,........X-----X.......X----XX....,....................................................X----------
----------------XX.......................,..............,.....XX------X,,,,....X-XX.....,.....................................................X----------
--------------XX.........................,...............,...X-------X.....,,,,XX.......,.....................................................X----------
------------XX...........................,...............,.XX--------X..................,.....................................................X----------
----------XX.............................,..........T.....X---------X...................,...........................................:.........X----------
--------XX..,,...........................,................X-------XX....................,.....................................................X----------
------XX...,,.,,.........................,.................X----XX.....................,......................................................X----------
-----X...,,.,,,.,........................,.................X--XX.......................,......................................................X----------
-----X..,,.H,,.E,,.......................,..................XX.........................,......................................................X----------
-----X..,.,+..,,.,......................,..............................................,......................................................X----------
-----X..,.+.AE,..E,.....................,...................:..........................,......................................................X----------
-----X..,.+AKAE,,,,.....................,.............................................,.......................................................X----------
-----X..,,+.E..,..,.....................,.............................................,.......................................................X----------
-----X....,+..,.E,......................,.............................................,.......................................................X----------
-----X....,.,,.,.,......................,.............................................,...................XXXX,,,XXXXXXXXXXXX.................X----------
-----X....,.,.E.,.......................,.............................................,...................X.........X.......X.........XX......X----------
-----X....,.,..,........................,............................................,....................X.....H..WX.....H.X........,XXXX....X----------
-----X....,..,,........................,,............................................,....................X.........X.......X.......,.,.XXX,,.X----------
-----X....,,,,........................,..,...........................................,....................XE........X.......X......,..,..XX.,.X----------
-----X................................,..,...........................................,....................X,,,XXXXXXX.......,.....,...,..XX,,.X----------
-----X...............................,....,..........................................,....................X+++XXXXXXX.......,.....,.H.E..,,.,.X----------
-----X..............................,.....,.........................................,.....................X.........X.......,.....,...,..XX,,.X----------
-----X.............................,......,.........................................,.....................X.........X...A...,......,..,..XX...X----------
-----X.............................,.......,........................................,.....................XXXXXXX...X.......,.......,.,XX-X...X----------
-----X............................,........,........................................,.....................XXXXXXX.E.X.......X........,X-XX....X----------
-----X...........................,..........,.......................................,.....................XXA..,,...X.......X.........XX......X----------
-----X..........................,...........,......................................,......................XX...XX...X...,,..X.................X----------
-----X.........................,.............,.....................................,......................XX...XX.....,,..,,X.................X----------
-----X.........................,.............XXXXXXXXXXXXXXXXXXXXXXXXXXXXXXXXXXXXXXX......................XX...XX...,,....XXX.................X----------
-----X........................,.............X---------------------------------------X.....................,K...XX...,.....XXX.................X----------
-----X.......................,......T......X--XXXXXXXXXXXXXXXXXXXXXXXXXXXXXXXXXXXXX--X....................XX.E.XX...,.....t.X.................X----------
-----X......................,.............X--X.....................................X--X...................XX...XX...,.....XXX.................X----------
XXXXXX......................,............X--X.......................................X--X..................XX.E.XX...,,......X.................X----------
XXXXXX,,,,,,,,,,...........,............X--X...................H.....................X--X.................XXXXXXX.....,,..,,X.........XX......X----------
-----X..........,,,,,,,,,,,............X--X...........................................X--X................X.............,,..X........,XXXX....X----------
-----X.....................,..........X--X.............................................X--X...............X..E..............X.......,.,.XXX,,.X----------
-----X......................,........X--X...............................................X--X..............X..........,,,,...X......,..,..XX.,.X----------
-----X.......................,......X--X.......H.........................................X--X.............X.........,...,...,.....,...,..XX,,.X----------
-----X.......................,.....X--X...................................................X--X............X...A.....,.A..,..,.....,W..E.A,,.,.X----------
-----X........................,...X--X..................................T..................X--X...........X........,.....,..,.....,...,..XX,,.X----------
-----X.........................,.X--X.......................................................X-X...........X........,.....,..,......,..,..XX...X----------
-----X..........................X--X........................................................X-X...........X.......,...,,,.,.,.......,.,XX-X...X----------
-----X...........T..............X-X.........................................................X-X...........XXXXXXX,..,,...,,.X........,X-XX....X----------
-----X..........................X-X.........................................................X-X...........X.,....,,,........X.........XX......X----------
-----X..........................X-X.............XXXXXXXXX...................................X-X...........X.,,..,.,.....:...X.................X----------
-----X..........................X-X.............XEAEEHEEX............E......................X-X...........X.,.,.,.,XXXX+++XXXXXXXXXXXXXXXXXXXXX----------
-----X..........................X-X.............XE.EE.EEX.......................XXXXX.......X-X...........X..,.,A.,XXXX,,,XXXXXXXXXXXXXXXXXXXXX----------
-----X..........................X-X.............,.....t.X.......................X..:X.......X-X...........X..,....,XX.......,.................X----------
-----X..........................X-X.............,E.EE.EEX.......................,.WXX.......X-X...........X..,,...,,,..E.E..,.................X----------
-----X..........................X-X.............,E.EE.EEX...........XXXXXXXXXXXXX..XX.......X-X...........X.E..,,.,XX.......,.................X----------
-----X..........................X-X.............X.....t.X...........XXXXXXXXXXXXX..XX.......XXX...........X......,,XX..E.E..,.................X----------
-----X..........................X-X.............XE.EE.EE,...........X.....,,,,,,,E.XX.......,.,...........XXXXXXXXXXX.......,.................X----------
-----X..........................X-X..........XXXXXXXXXX,XXXXXXX.....X.A...,,,,,,,.HXX.......,.,...........XXXXXXXXXXX.......,.................X----------
-----X..........................X-X..........X..:,,:,...,,A..XX.....XX,XX.......,E.XX.......,.,...........X........XX.......,.................X----------
-----X..........................X-X..........X.....,....,,.E.XX.....XX,XX.......,..XX.......,.,.........,,X.......HXX.......,.................X----------
-----X..........................X-X..........X..........,,...+X.........,.......,E.,,.......,.,.......,,,.,........XX.......,.................X----------
-----X..........................XXX..........X,.........,,...XX.........,...:...,..,,.......,T,.....,,,.,.,........XX.......,.................X----------
-----X..........................,.,..........X:.........,,...XXX,XXXX...,....<.<,E.,,.......,.,...,,,.,.,.,.................,.................X----------
-----X..............XXX.........,T,..........X..........,,...XXX,XXX....,.......,..XX.......,.,...,.,.,.,.,E............E...,.................X----------
-----X.............X---X........,.,........,,X.....:.........,,,T,,.....XXXXX<X<XE.XX.......,.,...,,,.,.,.,........XX.......,.................X----------
-----X.............X----X.......XXX.......,..,....,,,,.......,,,,,......XXXXXXXXX..XX.......,.,.....,,,.,.,........XX.......,.................X----------
-----X.............XX---X.......X-X......,,,,X....,A,,.X.....XXX,........,,,,,,,,..XX.......,.,.......,,,.,........XX.......,.................X----------
-----X...............XXX........X-X..........X.........X.....XXX.........,,,,,,,,..XX.......XXX.........,,X.......HXX.....H.,.................X----------
-----X..........................X-X..........X.........X,XXX.X..................XXX:X.......X-X...........XXXXXXXXXXX,,,,,,,,.................X----------
-----X.........XX...............X-X..........X.........X.XXX.X..................XXXXX.......X-X...........XXXXXXXXXXX,,,,,,,,.................X----------
-----X.......XX-X...............X--X.........X,,.......XAXXA.X..............................X-X...............................................X----------
-----X.......X--X...A............X--X........XH,.......X:XX..X..............................X-X...............................................X----------
-----X.......X--X.................X--X.......XXXXXXXXXXXAXWXXX.............................X--X...............................................X----------
-----X........XX..:.....XX.........X--X......XXXXXXXXXXXXXXXXX...........................XX--X................................................X----------
-----X................XX--X.........X--X................................................X--XX.................................................X----------
-----X...............X----X..........X--X..............................................X--X...................................................X----------
-----X...............XX---X...........X--X...........................E................X--X...................XXXXX............................X----------
-----X.................XXX.............X--X.........................................XX--X.................XXXXXXXX............................X----------
-----X..................................X--X.......................................X---X.................X-XX.................................X----------
-----X...................................X--XXXXXXXXXXXXXXXXXXXXXXXXXXXXXXXXXXXXXXX--XX.................X-X...................................X----------
-----X....................................X-----------------------------------------X..................X-X....................................X----------
-----X.....................................XXXXXXXXXXXXXXXXXXXXXXXXXXXXXXXXXXXXXXXXX..................X-X.H...A.H.............................X----------
-----X................................................................................................XX......................................X----------
-----X................................................................................................XX......................................X----------
-----X...............................................................................................X-X......................................X----------
-----X..............H................................................................................XX.....A.:.....................,,,,,,,,XXX----------
------X..............................................................................................XX.............................,...,...X------------
-------X............................H................................................................XX...A.........................,...,...XXXXXXXXXXX--
--------XX............................................................................................XX............................,...,...,.,E......X--
----------X...........................................................................................XX............................,...,...,.,.......X--
-----------X..........................................................................................XX............................,...,...,.,E......X--
------------X.............................,,,,,........................................................XX.......................,,,,,,,,,...,.,.......X--
-------------X............................,....,,...............................................................................,...,...,...,.,E......X--
--------------X..........................,,,..,,.,..............................................................................,...,EE.,...,.,.......X--
---------------XX........................,,W..,W.,...........XXXXXXXXXXXXXXXXXXXXXXXXXXX........................................,...,...,...,.,E......X--
-----------------X......................,........,...........XXXXXXXXXXXXXXXXXXXXXXXXXXX....................................,,,,,,,,,,,,,...,.,.......X--
------------------X.....................,....T...,...........XXX----XA.WX------------XXX....................................,...,EEE,...,...,.,E......X--
-------------------X....................,.,,..,,.,...........XX.XX--X...X----------XX.XX....................................,...,...,...,...,.,.......X--
--------------------X...................,.,W..,W.,...........XXE..X-XA.AX---------X...XX....................................,...,E.E,...,...,.,E......X--
---------------------XX.................,.......,...H........XX...,X,..HX--------X..E.XX....................................,,,,,,,,,,,,,...,.,.......X--
-----------------------X.................,,.....,............XX.,,..,XXXX------XX.....XX....................................,...............,.,E......X--
------------------------X..................,,,,,.............XX,.....,X-------X.......XX....................................,...............,.,.......X--
-------------------------X...................................XX.......,XX----X........XX....................................,...............,.,E......X--
--------------------------X..................................XX........,.X-XX.........XX....................................XXX,,,,,,,,,,,,,,.,.......X--
---------------------------X.................................XX.........,.X...........X,....................................X-X...............,E......X--
----------------------------XX...............................XX.......,,.t.,,.........XX...................................XX-X,,,,,,,,,,,,,,,,.......X--
------------------------------X..............................XX......,.tt....,........XX...............................XXXX---XE.E.E.E.E.E.E.E........X--
-------------------------------X.............................XX.....,.t...E...,.......XX............................XXX-------X.......................X--
--------------------------------X............................XX...,,.t.........,,.....XX........................XXXX----------X..E...E...E...E........X--
---------------------------------X...........................XX..,.tt.....E......,....XX....................XXXX--------------X.....................L,X--
----------------------------------X..........................XX,,.t...............,...XX.................XXX------------------X.....................,,.X-
-----------------------------------XX........................XX..t........E........,,.XX.............XXXX---------------------XXXXXXXXXXXXXXXXXXXXXXX.>>X
-------------------------------------X.......................XXtt....................,XX..........XXX------------------------------------------------X>.X
--------------------------------------X......................XXXXXXXXXXXXX,XXXXXXXXXXXXX......XXXX----------------------------------------------------XXX
---------------------------------------X.....................XXXXXXXXXXXXX,XXXXXXXXXXXXX..XXXX-----------------------------------------------------------
----------------------------------------X..............................................XXX---------------------------------------------------------------
-----------------------------------------XX........................................XXXX------------------------------------------------------------------
-------------------------------------------X....................................XXX----------------------------------------------------------------------
--------------------------------------------X...............................XXXX-------------------------------------------------------------------------
---------------------------------------------X..........................XXXX-----------------------------------------------------------------------------
----------------------------------------------X......................XXX---------------------------------------------------------------------------------
-----------------------------------------------X.................XXXX------------------------------------------------------------------------------------
------------------------------------------------XX............XXX----------------------------------------------------------------------------------------
--------------------------------------------------X.......XXXX-------------------------------------------------------------------------------------------
---------------------------------------------------X..XXXX-----------------------------------------------------------------------------------------------
----------------------------------------------------XX---------------------------------------------------------------------------------------------------
