--------------------------------------------------------------XXXX--------------------------------------------------------------------------------------------------------------------
--------------------------------------------------------------X...XXXXXXX-------------------------------------------------------------------------------------------------------------
--------------------------------------------------------------X..........XXXXXXX------------------------------------------------------------------------------------------------------
--------------------------------------------------------------X.................XXXXXXX-----------------------------------------------------------------------------------------------
--------------------------------------------------------------X........................XXXXXXX----------------------------------------------------------------------------------------
--------------------------------------------------------------X...............................XXXXXXX---------------------------------------------------------------------------------
--------------------------------------------------------------X......................................XXXXXXXX-------------------------------------------------------------------------
--------------------------------------------------------------X............................,,................XXXXXXX------------------------------------------------------------------
--------------------------------------------------------------X..........................,,.,,......................XXXXXXX-----------------------------------------------------------
--------------------------------------------------------------X.......................,,,..,..,............................XXXXXXX----------------------------------------------------
--------------------------------------------------------------X.....................,,.....,...,..................................XXXXXXX---------------------------------------------
--------------------------------------------------------------X..................,,,......,....,.........................................XXXXXXX--------------------------------------
--------------------------------------------------------------X...............,,,.........,.....,...............................................XXXXXXX-------------------------------
--------------------------------------------------------------X.............,,...........,.......,.....................................................XXXX---------------------------
--------------------------------------------------------------X.........,,,,.............,........,,,,,...................................................X---------------------------
--------------------------------------------------------------X....,,,,,...,...........,,.XX:XX...,....,,,,,,,,,,.............,,,,,,,,,,,,,,..............X---------------------------
--------------------------------------------------------------X.,,,........,........,,,.,.,...,...,..............,,,,,,,,,,...,.............,,,,,,,,,,,,,.X---------------------------
--------------------------------------------------------------X.,...........,.....,,.....,:..:,...,........................,,,,,........................,.X---------------------------
--------------------------------------------------------------X.,...........,..,,,.......,X.:.X..,,.............................,.......................,.X---------------------------
--------------------------------------------------------------X.,............,,..........,XX,XX,,................................,,.....................,.X---------------------------
---------------------------------------------------------------X,.........................,.,,,....................................,....................,.X---------------------------
---------------------------------------------------------------X,.........................,,..,.....................................,...................,.X---------------------------
---------------------------------------------------------------X,.............................,......................................,,.................,.X---------------------------
---------------------------------------------------------------X,.............................,........................................,................,.X---------------------------
---------------------------------------------------------------X,..............................,........................................,...............,.X---------------------------
---------------------------------------------------------------X,............:.....:............,........................XXXXXX..........,,.............,.X---------------------------
---------------------------------------------------------------X,...........,,,,,,,,,............,.......................X----X............,............,.X---------------------------
---------------------------------------------XXX---------------X,.........,,.......,.,,,..........,,....................X------X............,...........,.X---------------------------
---------------------------------------------X.X---------------X........,,.........,....,,..........,...................X------X.............,..........,.X---------------------------
----------------XXX-------------------------XXtX---------------X.....:.,...........,......,,.:.......,.................X--------X.............,,........,.X---------------------------
--------------XXEH,X---------------------XXX....X--------------X......,............,........,.........,................X--------X...............,.......,.X---------------------------
--------------:,..,X---------------------X:......X--XXXXX------X.....,.............,.........,.........,....:.......:..X--------X................,......,.X---------------------------
--------------XE.E.X-XXXXXX--------------X.......X-XX,:,X------X....,.,............,........,.,,........,,,,,,,,,,......X-------X.................,,....,.X---------------------------
--------------X,,.B--X.:.X----------------XX....X--X,tttX------X....,..,...........,........,...,.....,,,......,..,,,,,.X------X...:......:.........,...,.X---------------------------
--------------X,E,XBBBX.B.X-----------------X,,.X--X:t.:X------X...,....,,.........,.......,.....,,.,,..,......,.......,,XXXXXXX,,,,,,,,.............,..,.X---------------------------
--------------X,,,BXXXBE.,X--XXXX------XXX--X..X---X,tttX------X..,.......,........,.......,.......,....,......,........................,,,,,,,,,....,..,.X---------------------------
--------------X..,X--X,,,..XX...,XX----X.X--X...X--XX...X------X.,.........,...,,,,,,.....,..............,.....,................................,,...,..,.X---------------------------
--------------XE.,.XX,,,,,,.,,..,,X---X.:.XX....X---X+++X------X,...........,.,...:..,,,..,..............,.....,................................,.,...,.,.X---------------------------
--------------X,,.,X,,,,......E.X.,XXXX,,,XX,...,XXXXA,AXXXX---X............,,.........:,,................,....,................................,,.,..,.,.X---------------------------
--------------X...,,,...:.....XXX,.XX.......,,,,.,.,....,...XXX,............,............,.................,...,................................,,.,..,.,.X---------------------------
--------------X..,,..,,...:...X--X,XX.......,..,,..,....,.......,...........,:...........,.................,...,...............................,..,.,.,.,.X---------------------------
---------------X,,.A...,......X--X.,,........,,....,.E..,.......,...........,............,E.........E......,...,...............................,...,.,.,,.X---------------------------
----------------X.E,,A.,...E.X---X.,.,.............,....,........,,,,.......,............,.............E...,...,...............................,....,.,,,.X---------------------------
---------------XXXX..,.,....X---X..,.,.............,....,........,..,.......,............,..E....B.........,...,..XX...........................,....,..,,.X---------------------------
-------------------XX,,,,,.X----X..,..X............,....,........,:.,.......,............,.....B..B..E.....,...,.X--XXXX......................,......,..,.X---------------------------
--------------------X.,,.,.X-XX-X.:,.XX............,....,........,,,,......,.............,.................,...,X-------XXXX..................,.......,.,.X---------------------------
--------------------X.,.,.XXX..XXXXXX-X............,....,............,.....,.............,...............XXXXXXX------------XXXX,,,X,XXXXXXXXXX.......,.,.X---------------------------
---------------------X,.,.XXT....XXX--X............,.E..,.............,..,,..............,..............X--------------------XXX...X.X---------X......,.,.X---------------------------
----------------X----X,,,X-X+...,,H.X-X............,....,..............XXXX,,,,,.........,.......E.....X---------------------X,,,,,,,X----------X.....,.,.X---------------------------
----------------X----X.,,X-XX...,...X-X............,....,,,,,.........X----XXXX,.....:....,...........X-------XXXXXXXXXXXXXXX.........XXXXXXXXX--X....,.,.X---------------------------
---------------X---XXX,,,X---XXXX,,X---X...........,....,...,.........X--X----X.,..........,.........X------XX.,.,..........................,..X--X..,..,.X---------------------------
---------------XXXXA...,..X----X,,,XX--X...:.......,....,...,..........XXX-----X,...........,.......:------X.,.,,,,,XXXX,,,,,,,,,,,,,,,,,,,,..EX--X..,..,.X---------------------------
--------------X,.,.A,,,,.,:----X.,<.X---X..........,....,...,..........,.X-----X,...........,.......X-----X,..,.....,X-X.E...E.......E...E.,....X-X..,..,.X---------------------------
--------------X,..,,.:.,.,.X--X.,..,X---X....,,,,,,,....,,,,,,,,,,,,,,,,XXXXXXXX,...........,........X----X.,,,,,,,,,XXX,,,,,,,,,,,,,,,,,,,,....X-X..,..,.X---------------------------
-------------X,,,,..,,,,..,X--X.,..,.X-X....,...........................,XX,,,,XX,..:.......,......,,X---X..,.,.....,..,.........,.H.......,.....XX..,..,.X---------------------------
-------------X,..,,,..,.,..,X-X.,..,.X-X...,............................,+...>>>X,..........,....,,..XXXXX,,,.,.....,..,..........,.........,..,,XX..,..,.X---------------------------
------------XX...,,.:..,,...X--X,...,X-X...,................T,..E.....E.,+E..>E>X,...........,...,...XX:.,....,.....,,,,..........H.........,,,..XX..,..,.X---------------------------
------------XX..,,,,.,,..,,,X--X,...,X-X...,....,,,,,,B,,B..,,..........,+..,>>,X,...........,...,...+,...,E..,,....,AAA,.......,,.........,.E.,,XX..,..,.X---------------------------
-----------X--X,.,..,...,,,H.X-X.,.:X--X...,...,..H,.,.B.,...,,,,,,,,,,,XXXXXXXXXX,..........,...,...+,...,...,.,,,,...E.,,,,,,,.,........,,.....,.,,...,.X---------------------------
--------------X..,,..,,,...,.X-X.,::XX-X...,...,...,E.,.B,...,...........X-------X,..........,...,...+,...,...,A.A.,..W.E,AEEE.A.,...A...T,,.....,.,,...,.X---------------------------
---------------X.,.,,....E..X---X,,,.,XX...,...,H.AE,.E,.B...,............X------X,.........,....,...+,...,...,.,,,,...E.,,,,,,,.,........,,.....,.,,...,.X---------------------------
---------------X,..,..E.....X---XX...,X-XX.,...,,,...,..,,...,............X------X,........,.....,...+,...,...,,...,.AAA,.......,,.........,.E...,.,,...,.X---------------------------
----------------XXXXX....,XX-----X,...,XX-X,...,..E.A.,E.,...,.............X------X,...,..,......,...XX,..,E..,.....,,,,.........,H.:.......,,,,,XX.,...,.X---------------------------
---------------------XX,,,,XX----X,...,..XXX...,,..,..E,,,...,.....,,,,,....X-----X,.,,.,,,......,...XX:XX,,,.,.....,..,..........,.........,..,,XX.,...,.X---------------------------
---------------------XX,,....XX---X,...,..XX...,.,..E.A.H,...,.....,,,,,.....X----X,,...:.,......,,,.X---X..,.,.....,..,..........,H........,....XX.,...,.X---------------------------
-------------------XX.........,X--X.,,.,..,,...,..,..,...,...,.....,,K,,.....X----X,,.....,.........,X---X..,.,,,,,,,XXX,,,,,,,,,,,,,,,,,,,,.....XX.,...,.X---------------------------
------------------X,,,....,,,,,.X--XX.,...,,...,...,.,H..,...,.....,,,,,......X----X,.XX..,.........X-----X,.,......,X-XE...E.......E...E..,....X-X.,...,.X---------------------------
------------------X,..,,,,...,..X----X...,.,....,,,,,,,,,....,.....,,,,,.......X---X,X--X.,.........:-----X...,,,,,,XXXX,,,,,,,,,,,,,,,,,,,,..E.X-X,....,.X---------------------------
------------XXXXXX..,,....,,,.:..X----X..,,...........:....T..,................X---X,,XXX,,.........X------X.,.,.,.........................,...X--X,....,.X---------------------------
---------XXX....,.....,,,,........XX---XXX.....................,...............X----X,...,,...E...E..X------XX.,.,..........................,..X--X,....,.X---------------------------
------XXX.,.....,.:.................XXX--X......................,.............X-----X,,,,..,..........X-------XXXXXXXXXXXXXXXX........XXXXXXXXX--X.,....,.X---------------------------
X----X.....,....,...:H..........,,.....XX......,,,,,,,,,,,......,.............X--XX-X,..,..,....E....,.X----------------------X,X,,X,X----------X..,....,.X---------------------------
XX---X.....,....,....W.........,..,,...,......,...........,......,............XXX..XX,..,..,........,...X---------------------X.X..X.X---------X...,....,.X---------------------------
X-X-X.......,...,,............,....,..,......,.............,......,...........,,,,..XX,..,.,..E...E.,....XXXXXXXXXXXXXXXXXXXXXX,,,,,,XXXXXXXXXX....,....,.X---------------------------
-X.X........,...,.,,.........,.....,.,.E....,...............,......,..........,...,:.X,..,.,.......,....,......,...................................,....,.X---------------------------
-X.,........,...,..,..........,...,.,......,.....:.....:.....,.....,..........,....,.X,..,.,......,....,......,...................................,.....,.X---------------------------
-X..,...:..,...,..,,...........,,,,.,.....,...................,....,.........,.....,.XX..,.,,,,,,,....,......,....................................,.....,.X---------------------------
-X..,......,...,.,.,,....:.....,..,.,....,.........:..........,....,.........,.....,.XX,.,..,........,......,.....................................,.....,.X---------------------------
-X...,....,....,,.E,,,....,,,..,.,,,,.E..,....................,....,..........,:...,.XX,..,.,........,......,.....................................,.....,.X---------------------------
-X...,..,,.....,.,..,.,,..,.,..,,...,....,..E.........,,......,..E.,..........,..,,..XX,..,..,......,......,....................................,,,.....,.X---------------------------
--X...,,......,..,.E,...,,,.,...,..,.,...,............,.,,....,....,...........,,....,XX..,...,....,......,.................................,,,,........,.X---------------------------
--X...........,A..,..,..,..,,...,.,..,.E.,..:........,...,....,....,...........XX,,,,.XX,.,....,..,......,,,...........................,,,,,............,.X---------------------------
--X............,,.H,,....,.......,....,..,........:..,...,....,....,...........XX.,,...X,.,....,.,......,,..,......................,,,,.................,.X---------------------------
--X..............,,H.....,.......,...,...,...........,...,....,....,..........X-X...,,.XX..,....,......,.....,................,,,,,.....................,.X---------------------------
--X...........:....,,.....,..,,,..,,.,...,..E........,...,....,....,,,,,......X-X.....,,X..,..,,......,.:...,.............,,,,..........................,.X---------------------------
--X..................,,...,..E..,,,.,...E,.......E..,....,....,..E.,...,.....X--X......,X,.,,,.......,,....,.........,,,,,..............................,.X---------------------------
---X...................,,.,.,..E.E,.,....,.........,......,...,....,...,...XX----E,,,,,.X,..........,.,...,.....,,,,,...................................,.X---------------------------
---X.....................,,,,,,,,,..,....,........XX..,,,.,...,....,...,..X------XE.....XX.........,...,.,..,,,,........................................,.X---------------------------
---X........................,,,,,,..,..,,,,,,,,,,X--X,..,..XXXXX,,,XXXXXXX-------X:....,XX........,....,,,,,............................................,.X---------------------------
---X..............................,,,,,.........X---X,..,XX--X-X+++X-------------XE...,..X,......,.,,,,.................................................,.X---------------------------
---X............................................X---X,,,,X---XXX...XXX-----------X....,..X,...,,,,,.....................................................,.X---------------------------
---X...........................................X---X......X-X.,....,.X---XXX------X..,.,,XX,,,..........................................................,.X------------------XXXXXXXXX
----X...............,,,.......................X----X......X-X.,....,.X---X.X-------X,,.,TXX.............................................................,.X------------------XtEEE.EEX
----X.............,,...,,.....................X----X.......X-X,....,.X---XtX-------XHHXXXXX.............................................................,.X------------------Xt,XXXXXX
----X...........,,.......,,...................X----X.......X-X,....,.X---X+X--------XX-----X............................................................,.X------------------XtEX-----
----X...,,,,,,,,...........,,..........:......X----X,,,,,,,,XX,....,.X---XEX--X------------X............................................................,.X------------------XXXX-----
----X...,....................,,...............X--XX,......:.,.,,,,,,,XXXXX,XXXX------------X............................................................,.X------------------XX-------
----X...,...............,,,,,,.,............,,X--X.,........,.,....,...........X-----------X..............................................,,,,,,,,,,,,,,,.X------------------XX-------
-----X..,...............,:.:,.,,..........,,..X--XH,.......,..,,,,,,,,,,,,,,,,.X------------X...............,,,,,,,,,,,,,,,,,,,,,,,,,,,,,,................X---------------------------
-----X..,,,,............,..X.,..,.......,,....X--XH,.......,..,.E.E,.,.......,X-------------XXXXXXXXXXXXXXXXXXXXXXXXXXXXXXXXXXXXXXXXXXXXXXXXXXXXXXXXXXXXXXX---------------------------
-----XXXX,..,,,,,,......,,,..,..,......,.....X---X.,...,,,.,..,....,.,.......,XXX-----------------------------------------------------------------------------------------------------
---------XXXXXXX,,,,,,,,...,,..,,,.....,.....X---X.,..,,,,,,..,.E.E,.,.......,,EX-----------------------------------------------------------------------------------------------------
----------------XXXXXXX,,,,,,,,.......,.......X--X.,..:..:,,..,....,.,.......,XXX-----------------------------------------------------------------------------------------------------
-----------------------XXXXXXXX,,,....,.......X--X.,..XX,XX.,.,,,,,,,,,,,,,..,X-------------------------------------------------------------------------------------------------------
-------------------------------XXXXXXX,,,,,,,,,X-X.,..XXEXX.,.......XX,.,..,,,X-------------------------------------------------------------------------------------------------------
--------------------------------------XXXXXXX..X-X.,..XX.XX.XXXXXXXX-X..,....,,X------------------------------------------------------------------------------------------------------
---------------------------------------------XXXX-X.,.XX,XX.X---------X.,....,.X------------------------------------------------------------------------------------------------------
--------------------------------------------------X.,.XX,XX.X---------X.,....,.X------------------------------------------------------------------------------------------------------
---------------------------------------------------X.,.,.,..X---------X.,,,,,,XXX-----------------------------------------------------------------------------------------------------
-------------------------------------------------XX,.,.,.,,,X---------X.,....,,:X-----------------------------------------------------------------------------------------------------
-------------------------------------------------X.tX.,,,.,EX---------X..,,..,XXX-----------------------------------------------------------------------------------------------------
-------------------------------------------------XXX-XE,.,..X---------X,,..,,,X-------------------------------------------------------------------------------------------------------
-----------------------------------------------------X..XXXXX---------X..,,,..X-------------------------------------------------------------------------------------------------------
------------------------------------------------------XXXX------------X,....,,X-------------------------------------------------------------------------------------------------------
--------------------------------------------------------X,X-----------X.,,....X-------------------------------------------------------------------------------------------------------
--------------------------------------XXX---------------XX------------X,,.,...X-------------------------------------------------------------------------------------------------------
--------------------------------------XEX----XXXXXX-----EX-----------X...,,...X-------------------------------------------------------------------------------------------------------
------------------------------------XXX,XXXXXX...:XXXXXX,XXX--------XX....,,...X------------------------------------------------------------------------------------------------------
------------------------------------XE.E..E.E,.....,E.E.E.EX-------XX.,...,,..XX------------------------------------------------------------------------------------------------------
------------------------------------X........XX..XX........X-----XX,..,..:.XXX--------------------------------------------------------------------------------------------------------
------------------------------------X.E.E..E,.X,A,X,.E.E.E.X-----X..,.,XXXX-----------------------------------------------------------------------------------------------------------
------------------------------------X.......,......,.......X----X...XXX---------------------------------------------------------------------------------------------------------------
------------------------------------X,.....,........,......X----X.XX------------------------------------------------------------------------------------------------------------------
------------------------------------X:,,,,,..........,,,..:X----X.X-------------------------------------------------------------------------------------------------------------------
------------------------------------X...................,,,XX---XHX-------------------------------------------------------------------------------------------------------------------
----------------------------------XXX......................,,XXX...X------------------------------------------------------------------------------------------------------------------
--------------------------------XX..X......................,,,.....X------------------------------------------------------------------------------------------------------------------
------------------------------XX,...,.H....................,,,.....X------------------------------------------------------------------------------------------------------------------
------------------------------X..,..,......................XXXXXXXX-------------------------------------------------------------------------------------------------------------------
------------------------------X..,..,.H......,,,,,,,.......X--------------------------------------------------------------------------------------------------------------------------
------------------------------X..,..,........,A,W,A,.....A.X--------------------------------------------------------------------------------------------------------------------------
------------------------------X,,E..,H.......,,,,,,,...A...X--------------------------------------------------------------------------------------------------------------------------
-------------------------------X...,,......................X--------------------------------------------------------------------------------------------------------------------------
--------------------------------X,,XX....,,,,:....,,,,,....X--------------------------------------------------------------------------------------------------------------------------
--------------------------------XXXXX...,.....,..,.....,...X--------------------------------------------------------------------------------------------------------------------------
------------------------------------X...,.XXX.,,,,.XXX.,,..X--------------------------------------------------------------------------------------------------------------------------
------------------------------------X.,,..X-X,.....X-X,..,,X--------------------------------------------------------------------------------------------------------------------------
------------------------------------X,..,,XX..,,,,,.XX.,,..X--------------------------------------------------------------------------------------------------------------------------
------------------------------------X.,,.................,,X--------------------------------------------------------------------------------------------------------------------------
-----------------------------------XX,.....................XX-------------------------------------------------------------------------------------------------------------------------
-----------------------------------X,...E.......E...........X-------------------------------------------------------------------------------------------------------------------------
-----------------------------------XX,,,,.....,,,,.....,,,,X--------------------------------------------------------------------------------------------------------------------------
------------------------------------X....,,..,....,..,,....X--------------------------------------------------------------------------------------------------------------------------
------------------------------------X......,,......,,......X--------------------------------------------------------------------------------------------------------------------------
------------------------------------X......................X--------------------------------------------------------------------------------------------------------------------------
-------------------------------------X.........,:,........X---------------------------------------------------------------------------------------------------------------------------
-------------------------------------X..E...E,,...,.E...E.X---------------------------------------------------------------------------------------------------------------------------
--------------------------------------X..H..H,....,.H..H.X----------------------------------------------------------------------------------------------------------------------------
---------------------------------------XXXXXXX....XXXXXXX-----------------------------------------------------------------------------------------------------------------------------
----------------------------------------------X.E.X-----------------------------------------------------------------------------------------------------------------------------------
----------------------------------------------X..X------------------------------------------------------------------------------------------------------------------------------------
-----------------------------------------------X,X------------------------------------------------------------------------------------------------------------------------------------
-----------------------------------------------X:X------------------------------------------------------------------------------------------------------------------------------------
-----------------------------------------------XXX------------------------------------------------------------------------------------------------------------------------------------
