-------------------------------------------------------------------------XXXX--------------------------------------------------------
-------------------------------------------------------------------------XE.X--------------------------------------------------------
-------------------------------------------------------------------------X..X--------------------------------------------------------
-------------------------------------------------------------------------XE.X--------------------------------------------------------
-------------------------------------------------------------------------X,,X--------------------------------------------------------
-------------------------------------------------------------------------XttXX-------------------------------------------------------
-------------------------------------------------------------------------X,,XX-------------------------------------------------------
----------------------------------------------------------------------XXXX..X--------------------------------------------------------
----------------------------------------------------------------------X:XXXXX--------------------------------------------------------
--------------------------------------------------------------------XXX,XX-----------------------------------------------------------
--------------------------------------------------------------------XH,.,H-----------------------------------------------------------
--------------------------------------------------------------------X,.E,X-----------------------------------------------------------
--------------------------------------------------------------------X,...X-----------------------------------------------------------
--------------------------------X:-------------------------XXXXXXXXXX,,,,X-----------------------------------------------------------
------------------------------XXXXXXX----------------------X.,,,,,,E,...EX-----------------------------------------XXX---------------
-----------------------------X..,.,,.X------------XXX------X.XXXXXXXX,,,,X-------------------------------------XXXXXWXXXXX-----------
----------------------------X..,.E.,..X-----------XHX----XXX,XX-----X,,,,X-------------------------------XXXXXXX.,.....,EXX----------
----------------------------X.E,..XX..,X---------XXtX----XE.,,X-----X....X-------------------------------XA..,,...XXXXX...X----------
---------------------XXXXXXXX.,,,,XX..,.XXXXXXXXXX,,XX---XXXE,,X----X.E.EX-------------------------------X.E.,,.E.X---X...X----------
---------------------X...,,,,.,,,:A,..,,XX....,E..EE:X-----X,.,X----X....X-------------------------------XA..,,...XXXXX...X----------
---------------------X.E.,,,,,,,:,W,..,,XX.XXXXXX,,,,XXXX--X,,E,X---X....X-------------------------------XXXXXX........E..X----------
---------------------X...,,,,,,,E.A,.E,,XX.XXXXXX,,,,,,,XX-X,,,,X---X,,,,X------------------XXX---------------X...,,,,,.,,:X---------
---------------------X,,,XXXX.,,,,XX..,,XX.XX..,,.,,,,..HX-XE,,EX---X,,,,X------------------X.X---------------X...:.::,.,::X---------
---------------------X,,,X--X.E...XX..,,XX.XXE.,,.,,,,...XXX,,.,X---X....X------------------X,X---------------XE..,,,,,.,,.X---------
---------------------X,,,X--X..,..E...,,XX.XX..,,....,.E.,.,,,,AX--XX,,,,X-------XXXX-------X,X---------------X........E..X----------
---------------------X,,,X---X.,..,..,,,XX.XXE.,E....,...XXX::XXX---X,,,,X-------X,,X-------X.X-----------XXXXX...XXXXX...X----------
---------------------X,,,X----XXX:XXX...XX.XX..,,....,....+....EX---X....X-------X,WX--XX-XX..X-----------XE..,...X---X...X----------
--------------------XX,,,XX-----XX--X...XX.XXE.,,...E,...XXXXXXXX---X....X-------XXXX-X..X....X-----------X.XXX...XXXXX..AX----------
-------------------X.......X--------X.,,XX.XXXXX,....,.E.X----------XE.TEX-----------X.....TXX----------XXX,X-XX.......E.XX----------
------------------X....E....X-------X,..XX.XXXXX,:...,..XXXXXXXXXXXXX,,,,XXXXXXXXXX-X......X------------XH,.X--XXXXXXXXXXX-----------
------------------X....H....X-------X...XX...,.,,.....,.X..A,.................,....XXW..E...X-----------XXX,X------------------------
------------------X...XXX...X-------X.E.XXXXXXXX,......X....,.................,.....X,.,....A-------------X.XXXXXXXXXXXXXXXX---------
------------------XE.EX-XE.EX-------X...X------X,..T..,.....,.......X,,,,XX...,......,,K....X-------------XE..,E.....,,,,..XX--------
----------XXXXXXX-X...X-X...X-XXXXXXX,,,X--X:--X,....,.....,,.......X.tttXX...,.......,,...X--------------XXXX,......,,,,.E.X--------
----------XA,.,,X-X...X-X...X-X,,.,.,...X-XXKXXXX...X.....,.........X.t.tXX...,......H.,XXX----------------XXXX.E..E.,,XX...X--------
----------X.,.,,XXX,,,XXX,,,XXX,,.,.,...X-X,,,.XXAXX.....,.,........X.tttXX...,XXX......X------------------XA,,......XXXX,,,X--------
----------X.,.,.,,,,,,,H,,,,,,,.,.,.,...X-X,,,.X--X.....,.,.,.......XXXXXXX...,X-XX......X-----------------XXXX.....AX-X,,,,X--------
------XXXXX.,.,.,.,...,.,...,.,.,.,.,,,,X-T..,,.X-X.....,..,.,......XXXXXXX...,X--X.......X-------------------X,,,,,,X-X,,,,X--------
------XA....,.,.,E,...,E,...,E,.,.,.....X-X..,.,X-XA...,....,.,...............,XXXX.......X-----------------XXX,,,,,,XXX,,,,X--------
------X,E,,,,.,.,.,...,.,...,.,.,.,,,,,,X-X,,,,EX-X,,,,......,.,,,,,,,,,,,,,,,,...........X-XXXXXXXXX-------XA..............:--------
------X.......,.,,,...,,,...,,,.,.......X-XXX,XXX-X...........,.,,,,,,,,,,,,,T.,,,,,,,,,,,X-XE.....HX-----XXX...E......E.E..X--------
------X.......,,XX.,.,XX.,.,XX.,,.......X---X,X---X...........,,,,,,,,,,,,,,,,.,..........X-X.....E.XXX---XA...,,..,,.......:--------
------X........,XX.,.,XX.,.,XX.,.....,,,X-XXX,XXX-X...........,,,,,,,,,,,,.<.,,,..........X-X.........X---X....XXX.XXX..,,,,X--------
--X---X,,,.....,...,,,...,,,...,....,,,,X-XE,.,.X-X...........,,,,,,,,,.,.....,,..........X-X.XXXXX...X---X...,X-X,X-X.,.,,,X---X----
-X.X-XX,,.,...A.,,,...,,,...,,,....,,...X-X.,,,.X-X...........,,,,,,,..,,..<.H,,..........X-X.X---X...XXXXX.E..XXX.XXX.,,...X--X.X---
>,,.XXX..,,.....,.,...,.,...,.,....,,...XXX.,E,.XXX,,,...,,,,,,,,,,..,.,,.....,,.........,XXX,XXXXX.E.....+...:........,,...XXX,,.XXX
>,,.,L,E.,,.:.W.,E,...,E,...,E,....,,.E.,...,E,:.W,,,.,.,.,,,,,,,,.,.,EH,..:.<,,........,.,:.WXX:,,.......+........E...,,.E.LL,,E.t.X
X...XXX..,,.....,.,...,.,...,.,....,,...XXX.,E,.XXX..,,,,,....,,,,,.,..,,.....,,........,.XXX,XXXXX.......+E...,,..,,..,,...XXX...XXX
-X.X-XX,,,....A.,,,...,,,...,,,....,,...X-X.,,,.X-X....,......,,,,.,....,....<,,........,.X-X.X---X...XXXXX....XXX.XXX.,,...X--X.X---
--X---X,,......,XX.,,,XX.,,,XX.,....,,,,X-XE,.,.X-X...........,,,,,,....,.,W,.,XX,,.....,.X-X.XXXXXE..X---X...,X-X,X-X.,.,,,X---X----
------X.......,,XX.,.,XX.,.,XX.,.....,,,X-XXX,XXX-X...........,,....:..W.,,,,XX,,,,.....,.X-X.........X---X....XXX.XXX..,,,,X--------
------X.......,,...,.,...,.,...,,:......X---XtX---X...........,,,,,,,,,,,,,,XXK.EXX...,.,.X-X....E..XXX---XA................:--------
------X.......,.,,,...,,,...,,,.,.......X---X.X---X..........,.,,,,,,,,,,,,,X..E,XX..,.,,.X-XE.....HX-----XXX....E.......E..X--------
------X,E,,,,.,.,.,...,.,...,.,.,.,,,,,,X---XXX---X,,,,.....,.,.............XT.,,...,.E.,.X-XXXXXXXXX-------XA..............:--------
------XA....,.,.,E,...,E,...,E,.,.,.....X---------XA...,...,.,..............XXXX.....,...,X-----------------XXX,,,,,,XXX,,,,X--------
------XXXXX.,.,.,.,...,.,...,.,.,.,.,,,,X-:XXXXXXXX.....,.,.,...............XXXX......,.E.X-------------------X,,,,,,X-X,,,,X--------
----------X.,.,.,,,,,,,H,,,,,,,.,.,.,...X-X,,.,...XX.....,.,.........................,.,.,.X------------------XE....AX-X,,,,X--------
----------X.,.,,XXX,,,XXX,,,XXX,,.,.,EEEX-X,E,,....XX.....,.....................,...,...X.H.X-----------------X....E.XXXX,,,X--------
----------XA,.,,X-X...X-X...X-X,,.,.,...X-X..,,.....X,.....,...................,.,.,...X.....X----------------X......,,XX...X--------
----------XXXXXXX-X,,,X-X,,,X-XXXXXXX,,,X-X,,,.......,,.....,.................,.E.,...,.......X---------------X.E....,,,,E..X--------
------------------X...X-X...X-------X.T.X-X......E....,X....,..................,...,.X....E...X---------------X......,,,,..XX--------
------------------X...XXX...X-------X,,,XXX...E........XX...,,,,,,,,,,,,,,,,,,,,,.E.X.........X---------------XLLLXXXXXXXXXX---------
------------------XE.E,.,E.EX-------X,,,X.,.............XXXA,....................,.,,....E...EX---------------XLLLX------------------
------------------XXXXX,XXXXX-------X,,,XXX.E...E...E..,,XXXXXXXXXXXXXXXXXXXXXXXXXX,,...E.....X---------------X,,,X------------------
----------------------X.X-----------X,,,X-X...........,,,X----XXXXXXXXXXXXXXXXXXXXXX,......E.XX---------------X,,,X------------------
-------------------XXXX.XXXX--------X,,,X-X,,,,,.....,...X----XX,,XXE......,,.,...X-X.........X--XXXXXXXXXXXXXX,,,X------------------
------------------XX.......XX-------X,,,XXX,,,,,.E..,.,,,XXXXXXX,-XX.XX.AXX,,,.XX.X--X...E.X...XX...E.............X------------------
------------------A.E.....EAX-------X...,.,...,,...,.,.,,XE,,XX.XX...XX,.XX,XX,XX.X---XXXXXXXE..X.........E....E..X------------------
------------------X.........X-------XE.E,.,..E,,...,,.,..XX,,XX.XX.XX..,,,,.XX....X----------X...................XX------------------
------------------XLLLLLLLLXX-------X...,.,...,,...,,.,H.,,,.XX,.,,XX.,,.,,,......X----------XX..E...XXXXXXXXXXXXX-------------------
------------------X.........X-------X,XXXXX.E.XX,,,,,,XXXXXXXXX,,,....,.XX.,.XX...X---------X.......X--------------------------------
------------------X.........X-------X.X---X...XX++XX,,X----XXXX,.XX.XX..XX,,,XX..TX--------X.......X---------------------------------
------------------X....H.:.:X-------X.XXXXX...XX,EXE,,XXXXXXE,,E,XX.XX.........XX.X-------X.......X----------------------------------
------------------X,,,XXX,,,X-------X.....,.E.,,..,,.E,,.EXXXXXXX,......XX.XX,,XX.X------X....E..X-----------------------------------
----------X:------X...X-X,,,X-------XXXXXXX,,,XXEEXXXXXXX,X---XXX..XX...XX.XXE,,..X-----X.......X------------------------------------
----------XXX-----X...X-X,,,X-------------XLLLXXXXX---XXX,XXX-X....XX.E......,,..AX----X.......X-------------------------------------
---------X,,,X----X...X-X,,,X-------------X....X-----X:XX,X:XXXXXXXXXXXXXXXXXXXXXXX---X.......X--------------------------------------
------XXX,..,,XXXXX,..X-X,,,X-----------XXE.E.E.X----A,.,.,.,X---------XXXXXXXXXXXXXXXX....E.X---------------------------------------
------X.t,.E,,,.E...,,X-X,,,X------:X----X.....X-XXXXX.,,.,,,XXXXXX---XX..............E.....X----------------------------------------
------XXX...,,.E....XXX-X...XXXXXXXXXX----XX,XX-X...,,E,.,E,.,E.ttX---:.W...E..E..E......E.X-----------------------------------------
---------X..:,,,..E.X---X....,,,E,,,,XX----XXX--X.E.,,..:.,..,..t.X---X...................X------------------------------------------
----------XXXXXXXXXXX---X,E.:,E,,,,E.,X---------X...,,.,,.,,.,E.ttX---X...XXXXXXXXXXXXXXXXX------------------------------------------
------------------------XX..,,.,,,,..,X---------XXXXXXE..E.E.XXXXXX---XE..X----------------------------------------------------------
-------------------------X:XXXXXXXX,,,XXXXXXXX-------X..,.,.,X--------X...X----------------------------------------------------------
--------------------------XX------X...,,,,,..XX------XXXXXXXXX--------X...X----------------------------------------------------------
----------------------------------X.E.,,,,,E.AX-------:X---:X---------X...X----------------------------------------------------------
----------------------------------XA..,,,,,...X-----------------------X.E.X----------------------------------------------------------
-----------------------------------XXXXXXXX,,,X-----------------------X...X----------------------------------------------------------
------------------------------------------X,,,X-----------------------X...X----------------------------------------------------------
------------------------------------------X,,,XXXXXXXXXXXXXXXXXXXXXXXXX...X----------------------------------------------------------
------------------------------------------X...,.E....E....................X----------------------------------------------------------
------------------------------------------X.E.,...........E.....E...E...E.X----------------------------------------------------------
------------------------------------------XX..,...E......................XX----------------------------------------------------------
-------------------------------------------XXXXXXXXXXXXXXXXXXXXXXXXXXXXXXX-----------------------------------------------------------
