---------------------------------------------------XXXXXXXXXXXXXXXXXXXXX--------------------------------------------------
---------------------------------------------------X...................X--------------------------------------------------
---------------------------------------------------X.XXXXXXXXXXXXXXXXX.X--------------------------------------------------
----------------------------------------------XXX--X.X-------XXX-----X.X--------------------------------------------------
----------------------------------------------X-X--X.X-------XTX-----X.X--------------------------------------------------
----------------------------------------------XXX--X.X-------XtX-----X.X--------------------------------------------------
---------------------------------------------------X.X-------X.X-----X.X--------------------------------------------------
---------------------------------------------------X.X-------X+X-----X.X--------------------------------------------------
---------------------------------------------XXXXXXX,XXXXXXXXX.,XXXXXX,XXXXX----------------------------------------------
---------------------------------------------X.....,.E.,.....t.,t..,.H.,...X----------------------------------------------
---------------------------------------------X.XXXXX.,.,.....tE,t..,,,.XXX.X----------------------------------------------
----------------------XXX--------------------X.X---X,,,......t.,t....,,X-X.X----------------------------------------------
----------------------X.X--------------------X.X---X.,.......t.,t....,HX-X.X----------------------------------------------
----------------------X.X--------------------X.X---X.H.......t.,t....,.X-X.X----------------------------------------------
----------------------X.X--------------------X.XXXXX.,.......tE,t....,HX-X.X----------------------------------------------
----------------------X,X--------------------X.XXBt,.,.......t.,t....,.X-X.X---------XXXXXXXXXXXXX------------------------
----------------------X.X--------------------X:XXXXX.H.......t.,t....,HX-X.X---------XA...E......X------------------------
----------------------X,X--------------------X.X---X.,.......tE,t....,.X-X.X---------X.XXXXXXXXX.X------------------------
----------------------X.X--------------------X.X---X.H.......t.,t....,,X-X.X-XXXXX---X.X-------X.X------------------------
----------------------X,X--------------------X.X---X.,.......t.,t..,,E.XXX.X-XH.HX---X.X-------X+XXXXXXXX-----------------
----------------XXXX:X:+X:X:XXX--------------X.X---X.,.......t.,t..,.,.,...X-X.XXX---X.X-------X.EEEEXX.X-----------------
----------------XH,,,,,,,,,,,HX--------------X.X---X,,,......t.XXXXXXX,XXXXX-XHX-----X.X-XXXXXXX.....XX.X-----------------
----------------X,,,,,,,,,,,,,X--------------X.XXXXXEE.,.....tTX---AXX.X-XXXXX.X-----X.X-X.....X.EEEEXX.X-----------------
----------------X,,,,,,,,,,,,,X--------------X.....,.,.,.....t.X---XXX.X-X.....X-----X.X-XAXXX.X.EEEEX..X-----------------
----------------X..E....E...E.X--------------XXXXXXX,XXXXXXXXX.XXXXX,,.X-X.XXXXX-----X.X-X.X-X.X.....X..X-----------------
----------------X.............X--------------------X......AX-X,,....XXXX-X.X---------X.X-X+XXX,XtttttX,,X+++XXXXXXXXXX----
----------------X.............X--------------------XXXXXXX.X-X,XXXXX-XXXXX+X-----X++-X.X-X..,,.......,..,,..++..L,.tBX----
----------------X,,,,,,,,,,,,,X--------------------XTX---X.X-X.X-----XE.E.EX-----XWX-X.X-XW,.,,,,,,,,,..,.,AXXX.XXXXXX----
----------------X....,,,,,....X--------------------X.X---XAXXX.XXXXX-X.....X-----XAX-X.X-X,..........,..,..,X-X.X---------
----------------X....,,,,,....X----XXXXXXXXX-------X.X---X..++...A.X-X.E.E.X-----X.X-XEXXX.....E.....,..,,,,XXX+X---------
----------------X....,,..,....X----X.......X-------X,X---XXXXX.XXXXX--X,,,X------XAX-X...,........T..,......+...X---------
----------------X..E.,,,,,..E.X----X.,,,,..X-------X.X-------X.X-XXXXXX,,,XXXXXXXX+XXX...,...........,......+...X---------
----------------X.............X----X.,..,..X-------X.X-------X.X-X............,H+XW:..E..,...........,,,,,,,XXXXX---------
----------------X.............X----X.,.E,..X-------X.X-------X.X-X............,,XX...X...,..................XXXXXXXXXX----
----------------X..:........:.X----X.,,,,..X-------X,X-------X.X-X..............XX...X.H:,..................,........X----
----------------X,,,,,,,,,,,,,X----X.......X-------X.X-------X.X-X..............XX...XXXXX,,,,,,,,,,,,,,,,,,XXXXXXXX.X----
----------------X.,,,,,,,,,,,.X----X.......X-------X.X-------X.X-X...E..........XX...X---X..................X------X.X----
----------------X.,.,,,,,,,.,.X----XXXXXXXXX-------X.X-------X.X-X..............XX...X---X:................:X------X.X----
----------------X.,...,..,..,.X--------------------X,E-------X.X-X..............XX...X---X..................XXXXXXXX,XXXXX
----------------X.,...,..,..,.X--------------------X.X-------X.X-X..............XX...X---X..................,+.++,,,.,...X
----------------X.,...,..,..,.X--------------------X.E-------X.X-X..............XX...X---X..................XXXXXXXX,XXX.X
----------------X.,...,..,..,HX--------------------X.X--+XXXXX.XXX,,...........,,,...X---X.A...............AX------X.X-X.X
----------------XH,...,E.,..,,X--------------------X,E--+H......,,..,,,,,,....,,,,...X---X,................,X------X,X-X.X
----------------XXX...,..,..,XX--------------------X.X--+.......,,........,,,,,,,,...X---X.,..............,.X------X.X-X.X
----------------XXX...,..,..,XX--------------------X.E--X.......,,..........,,,,,,...X---XE.,A..........A,.EX------X,X-X.X
----------------X.,...,..,..,.X------XXXXXXXXXXXXXXX,X--XXXXXXXXXX..........,,,,,,...X---XXXXX,X:XX,X:XXXXXXX------X.X-X.X
----------------X.,...,E.,..,.X------XE,A....,...,...X-----------X..........,,,,,,...XXXXX---XHX--X.X--------------X,X-X.X
----------------X.,...,..,..,.X------X,,.....,...,...X-----------XH.E..B....,,,,,,.A.+.AW+---XXX-X..X--------------X.X-X.X
----------------X.,,..,..,..,.X------X.,.....,...,...X-----XXXXXXX..........,,,,,,...XXXXXXXXXXXXX,,XXXXXXXX-------X,X-X.X
----------------X.,,,,,..,.,,.X------X.,.....,,,,,,,,X-----X....L,..........,,,,,,...X--XH+,.....,.:,.....HX-------X.X-X.X
----------------X.,,,,,..,,,,.X------X.,.........,...X-----X....L,........,,,,,,,,...X--XXXXA.A..,..,.A.A..X-------X,X-X.X
----------------X.,,,,,.,,,,,.X------X.,.........,...X-----X....L,..,,,,,,...,,,,,...X-----X.XXXXX,,XXXXXX.X-------X.X-X.X
----------------X.,,,,,,,,,,,.X------X.,.........,...X-----X.XXXXX,,..........,,,,...X-----X.X---X.AX----X.X-------X,X-X.X
----------------X.,.,,,,,,,.,.XXXX---X.,.........,,,,X-----X.X---X..............XX...X-----X.X----X+X----X.X-------X.X-X.X
----------------X.,...,,,...,.L,BX---X.,.........,...X-----X.X---X..............XX...X---XXX,XXXXXX+XXXXXX+XXX-----X,X-X.X
----------------X.,....,....,.XXXX---X.,.........,...X-----X.X---X..............XX...X---X...,...........,...X-----X.X-X.X
----------------X.,.........,.X------X.,.........,...X-----X.X---X..............XX...X---X<.W,...........,W<.XXXXXXX,X-X.X
----------------X.,.........,.X------X.,.........,,,,X-----X.X---X..............XX...X---XA..,.....E..A..,.A.,....XX.X-X.X
----------------X.,.........,.X------X.,.............X-----X.X---X...E..........XX...X---X,,,,...........,,,,XXXX.XX.X-X.X
----------------XXX.....T...,XX------X,,.............XXXXX-X.X---X..............XX...X---H...................X--XE,..X-X.X
--XXXXXXXXX-----XXX.........,XX------XE,W............H+tTX-X.X---X..............XX...X---X....E..............X--X.XXXX-X.X
--XE..E.E.tX----X.,.........,.X------X++XXXXXX,XXXXXXXXXXX-X.X---X............,,XX...XXXXX........,,,..E.....X--X.X----X.X
--XE......tX----X.,.........,.X--------------X.K-----------X.X---X............,.XX.E...E.,.....:,,...,.....,,XXXX.X----X.X
--XE..E.E.t.X---X.,.........,.X--------------X,X-----------X.X---X,XXXXXXXXXXXX+XXXXXXXXXX......,....,.....,.ttXX.X----X.X
--XE......t.X---X.,.........,.X--------------X.X-----------X.X---X.X---------------------X......,....,.....,.tTXX.X----X.X
--XE..E.E.t.X---X.,.........,.X--------------X.X-----------X.A---X.X---------XXXXXXXXXXXXX.E....,..W.,....E,,ttXX.X----X.X
XXXE......t.X---XW,.A......A,WX--------------X.X-----------X.X---X.X---------X...A..E...XX......,,...,.....,,XXXX.X----X.X
XT.E....E.t.XXXXXXXXXtttttXXXXX--------------X.X-----------XtX---X>X---------X.XXXXXXXX.XX........++,.:......X--X.X----X.X
XXXE..E...t.X-------XA...AX------------------X.X-----------X.X---X.X-----XXXXX.X------X.+,...................X--X.X----X.X
--XE..E.E.t.X-------XXX,XXX------------------X.X-----------XXX---X.X-----X.....X--XXXXX.XXA..................X--XEX----X.X
--XE..E...t.X---XXXXXXX,XXXXXXX---XXXXXXXXX--X.X-----------------X.X-----X.XXXXX--X....EXX,,,,..E........,,,,XXXX.X----X+X
--X...E.E.t.X---XA...........AX---X.......X--X.X----------------->>X-----X.X------XAXXXXXXA..,...........,.A.,....X----X.X
--XE..E...tX----X.............X---X.......X--X.X-------------------------X.X------X.X----X.:W,.....E.....,W<.XXXXXX----X+X
--X.....E.tX----X.A.E...E..E.AX---X..ttt..X+++.XXXXXXXXXXXXXXXXXXXXXXXXXXX.X--XXXXX.X--XX,...,...........,...X---------X.X
--XXXXXXXXX-----X.............X---X..tBt..++.+.E..,.,.,.,...............E,.X--X....EX-X..,,XXXXXX,XXXXXXXX,XXX---------X.X
------XXXXXXXXX-X.............X---X..ttt..XX++XXXXXXXXXXXXXXXXXXXXXXXXXXXX.X--X.XXXXXX...XX-----X.X------X.X-----------X.X
------X..t.t..X-X..,...,,.,..,X---X.......X------------------------------X.X--X.X--XX...X-------XEXXXXXXXX.X-----------X+X
------X..ttt..X-X,,,.,.,,,,.,,X---X.......X--XXXXXXXXXXXXXXX-------------X.X--X.XXX....X--------X.++.......X-----------X.X
------X.......X-X,.,,,,,,.,,,.X---XXXXXXXXX--X.H.........tBX-------------X.X--XE....EXX---------X.XXXXXXXXXX-----------X+X
------X,,,,,,,X-X.,.,.,..,,,.,X--------------X...H..H.H..ttX-------------X.X--XXXXXXX-----------X.X--------------------X.X
------X.......H-X.........,...X--------------X..........H..X-------------X.X--------------------XEX--------------------X.X
------X.E...E.X-X.............X--------------X...ttt.Htt...X-------------X.XXXXXXXXXXXXXXXXXXXXXX.X--------------------X.X
------X.......X-X.............X--------------X.H.tTt.tTt..HX-------------XE......E...E.......E...HX--------------------X.X
-XXXXXX.......XXX.............X--------------X..HtttttttH.HX-------------XXXXXXXXXXXXXXXXXXXXXXXXXX--------------------X.X
-XTt.LL...A...,.L.............X--------------X....HtTt.H...X-----------------------------------------------------------X.X
-XXXXXX.......XXX.......T.....X--------------X..Httttttt..HX-----------------------------------------------------------X.X
------X.......X-XA...........HX--------------X...tTtHtTt...X-----------------------------------------------------------X.X
------X.E...E.X-XXXXXXX,XXXXXXX-++X----------X.H.ttt.ttt..HX-----------------------------------------------------------X.X
------X.......X-----XXX,XXX-----X.X----------X.............X-----------------------------------------------------------X.X
------XXXXXXXXX-----X.....X-----XEX-----XXXXXX..H..HH..H..HX-XXXXXXXXXXXXXXXXXXXXXXXXXXXXXXXXXXXXXXXXXXXXXXXXXXXXXXXXXXX.X
----------------XXXXX...E.XXXXX-X.X----X....XX.............X-X................................................,.,........X
----------------X:...........:X-X.X----X,.E.XXXXXXXXXXXXXXXX-X........:............T..........................XXXXXXXXXXXX
------------XXXXX,,,,,,,,,,,,,H--X-XX--X.,,,.X---------------X................................................X-----------
-----------X....,.....,.,.....X--XX..X-X,,..,.X--------------X................................................X-----------
----------X..E..E..A..,.,.....X----XA.XX.,.,..X--------------X................................................X-----------
----------X.....,.....,.,.....X-----X,.X.,..,,,X-------------X................................................X-----------
----------X,XXXXX,,,,,,,,,,,,,X-----X.,.,.A....X-------------X................................................X-----------
----------X.X---X.............X------X..,......X-------------X................................................X-----------
----------X.X---XXX.........XXX------X,,.......X-------------X................................................X-----------
----------XX------X.........X--------X.,...E...X-------------X................................................X-----------
----------XX------XXX.....XXX--------X.,.......X-------------X................................................X-----------
----------HX--------X.....X----------X,,.......X-------------X.......,,,........E.....E.......................X-----------
----------XXX-------XXX.XXX----------X.,.......X-------------X.......,.,......................................X-----------
----------------------X.X-------------X.,,.....X-------------X.......,,,,,,,,,,,,,+++,,,,,,,,,,,,,............X-----------
----------------------X.XXXXXXXXX-----X.,.,,..X--------------X.......,...........,...,...........,............X-----------
----------------------XA..A.A.AAX------XX.,,.X---------------X.......,.E....E..E.,...,.E..E....E.,............X-----------
----------------------XXXXXXXXX,XXXXXXXXXXX,XXXXXXXXXX-------X.......,...........,...,...........,............X-----------
--------------------------X.,.,...,.,.,.,....,.,..,.tX-------X.......,...,,,,,,,,,,,,,,,,,,,,,...,............X-----------
--------------------------X:.,,....,...,,.....,,...t.T-------X.......,...,,..........,.......,...,............X-----------
--------------------------X,XXX,XXXXX,XXXXX,XXXXXXXXXX-------X.......,...,,..........,.ttt...,.:.,............X-----------
---------------------------XX-X,X----XX---X,XXXXXXXXXXXXXXXXXX.......,...,,..........,.tTt...,...,............X-----------
------------------------------X.X---------X........,,.......XX.......,...,,..........,.ttt...,...,............X-----------
------------------------------X.X---------X........,,.,,,,,,XX.......,.E.,,..........,,,,,...,...,............X-----------
-------------------------------X.X--------X........,,.,.....XX.......,...,,..............,...,.E.,............X-----------
-------------------------------X.X--------X........,,.,.,,,.XX.......,...,,..............,...,...,............X-----------
-------------------------XXXXXXX,XXX------X........,,,,.,.,.XX.......,...,,..............,...,...,............X-----------
-------------------------X.tA+E...AX------X........,,,,.,,,.XX.......,.:.,,..............,...,...,............X-----------
-------------------------XXXXXXX.XXX------X........,,,,.....XX.......,...,,..............,...,...,............X-----------
-------------------------------X.X--------X........,,,,,,,,,XX.......,...,,....,,,,......,...,...,............X-----------
-----------------------------XXX.XAX------X........,.,......XX.......,...,,....,...,.....,,,,,...,............X-----------
-----------------------------XA...EX------X........,.,......XX.......,.E.,,...,.,,,.,....,,,,,.E.,............X-----------
-----------------------------XXX.XXX------X.....E..,.,.E....XX.......,...,,...,.,W,.,....,,,,,...,............X-----------
-------------------------------X.X--------X........,,,......XX.......,...,,...,.,,,.,....,,,,,...,............X-----------
---------------------------XXXXX.XXX------X......,,,.,,,....XX.......,...,,...,.....,....,,,,,...,............X-----------
---------------------------XH+.E..EX------X.....,,,,.,..,...XX.......,...,,...,....,.....,,,,,...,............X-----------
---------------------------XXXXX.XXX------X....,,,,,.,..,...XX.......,...,,....,,,,......,,,,,...,............X-----------
-------------------------------X.X--------X...,.,,,,.,..,,..XX.......,.E.,,..............,,,,,.E.,............X-----------
-----------------------------XXX.XXX------X..,,.,,,,++..,,,.XX.......,...,,..............,,,,,...,............X-----------
-----------------------------X:E..EX------X.,.,.,..,.,..,,.,XX.......,...,,..................,...,............X-----------
-----------------------------XXX.XXX------X,..,.,..,.,..,,..XX.......,...,,..................,...,............X-----------
-------------------------------X.X--------X...,.,..,.,..,,..XX.......,...,,,,,...............,...,............X-----------
-----------------------------XXX.XXX------X.E.,.,..,.,..,,..XX.......,...,,,,,...............,...,............X-----------
-----------------------------X.E..EX------X...,.,..,.,..,,..XX.......,...,,,,,...............,...,............X-----------
------------XXXXXXXXXXXXXXXXXXXX+XXXXXXXXXX,,,,,,,,,.,,,,,,,XX.......,.E.,,,,,...............,.E.,............X-----------
------------X..................,T,.....E.XX........,.,......XX.......,...,,,,,...............,...,............X-----------
------------X..E...............,.,.......XX.....E..,,,.E....XX.......,...,,,,,...............,...,............X-----------
------------X..................,,,.......XX........,.,......XX.......,...,,,,,.......,,,,,,,,,...,............X-----------
------------X..................,.,.......XX........,,,......XX.......,...,,,,,.......,,,,,,,,,...,............X-----------
------------X.................,.,........XX.......,,,,......XX.......,...,,,,,.......,,E....E,...,............X-----------
------------X.................,.,........XX.......,,,,,.....XX.......,...,,,,,.......,,...E..,...,............X-----------
------------X................,..,........XX......,.,,,,.....XX.......,...,,..,,,,,,,,,,......,...,............X-----------
------------X................,,,.........XX......,.,,,.,...HXX.......,...,,..,,,,,...,,......,...,............X-----------
------------X..............,,..,..,,,,,,,XX,XXXXXXXXXXXXXXX,XX.......,...,,..,,,,,...,,.E.E..,...,............X-----------
------------X..........,,,,...,...,,,,,,,XX.X-------------X.XX.......,...,,..,,,,,...,,......,...,............X-----------
------------X........,,...,.,,....,,..,,,XXXX-------------XXXX.......,...,,,,,,,,,,,,,,,,,,,,,...,............X-----------
------------X.......,.....,,......,,E.,,,XXXXXXXXX-----------X.......,...,,,,,,,,,,,,,,,,,,,,,...,............X-----------
------------X......,,..,,,........,,,,,,,........X-----------X.......,...........................,............X-----------
------------X......,.,,...........,,,,,,,........X-----------X.......,.E...........E...........E.,............X-----------
------------X......,..,...........,,,,,,,........X-----------X.......,...........................,............X-----------
------------X......,..,.......................E..X-----------X.......,,,,,,,,,,,,,,,,,,,,,,,,,,,,,............X-----------
------------X......,..,..........,,..............X-----------X................................................X-----------
------------X.......,.,.......,,,..,.............X-----------X................................................X-----------
------------X.......,,.,,.....,....,.............X-----------X................................................X-----------
------------X.........,..,,..,.,,,.,.............X-----------X................................................X-----------
------------X..........,.,.,,,.,.,..,............X-----------X................................................X-----------
------------X...........,.....,...,.,............X-----------X................................................X-----------
------------X............,,..,,.H.,.,............X-----------X................................................X-----------
------------X..............,,....,..,............X-----------X................................................X-----------
------------X..,,,,..............,.,.............X-----------X................................................X-----------
------------X..,tt,.............,.,,.............XXXXXXXXXXXXX................................................X-----------
------------X..,.t,........,,,,,...,.............,.,.,.,...,.,................................................X-----------
------------X..,,,,........,,.....,..............XXXXXXXXXXXXXXXXXXXXXXXXXXXXXXXXXXXXXXXXXXXXXXXXXXXXXXXXXX+++X-----------
------------X..............,,E..,,...............X--------------------------------------------------------X...X-----------
------------X..............,,,,,.................X--------------------------------------------------------X...X-----------
------------X....................................X--------------------------------------------------------X...X-----------
------------X....................................X--------------------------------------------------------X...X-----------
------------X....................................X--------------------------------------------------------XHWHX-----------
------------X..........................,,,,,,,...X--------------------------------------------------------XAAAX-----------
------------X..........................,,,,,,,...X--------------------------------------------------------XA:AX-----------
------------X..........................,,,..,,...X--------------------------------------------------------X+++X-----------
------------X..........................,,,E.,,...X------------------------------------------------------------------------
------------X,,,,,,,...................,,,..,,...X------------------------------------------------------------------------
------------X......,...................,,,,,,,...X------------------------------------------------------------------------
------------XE...E.,...................,,,,,,,...X------------------------------------------------------------------------
------------X..E...,..........................E..X------------------------------------------------------------------------
------------X......,.............................X------------------------------------------------------------------------
------------XE..E.E,.............................X------------------------------------------------------------------------
------------XXXXXXXXXXXXXXXXXXXXXXXXXXXXXXXXXXXXXX------------------------------------------------------------------------
