-------------------XXXXXXXXXXXXXXXXXX--------------------
-------------------X.......,.,.......X-------------------
--------XXXXXXXXXXXX.......,W,.......XXXXXXXXXXX---------
--------X....,,.,,.,......XXXXX......,,,,,.,...X---------
--------X,...,,.,,.,.....XXX>X-X.....,,.,,.,..,.X--------
--------X,...,,.,,,,.....XX..X-X.....,,.,,.,..,.X--------
-------X..,..XXXXXXX.....XX.:X-X.....XXXXXXX.,..X--------
-------X..,..X-----X.....XXX+X-X.....X----X..,..X--------
-------X...,.X-----X.....X-XWX-X.....X----X..,..X--------
-------X...,.X-----X..H.XX-AHX-X..H.XX----X.,..X---------
-------X....,X-----XX,,XX-XX,XXXX,,XX-----XX,..X---------
-------X....,X----XXX,,XXXX,,,XXX,,XXX-----X....X--------
-------X.....X---X......,.,...,.,.....X----X....X--------
--------X....X---X.,,,...,,...,,...,,,.X--X.....X--------
--------X.....XX-X.,W,...,.,H,.,...,W,,X-XX.....X--------
--------X.......X,.,,,...,.,,,.,.:.,,,,XX......X---------
--------X........,.......,.....,......,,.......X---------
---------X.......,.....:..,...,.......,,......X----------
----------X......,........,,,,,.......,,......X----------
-----------XX....,....................,,.....X-----------
-------------XXXXX....:,,,,,,,,,,.:...,XXXXXX------------
-----------------X..:..,........,.....X------------------
-----------------X.....,,,,,,,,,,..:..X------------------
-----------------X........,,,,........X------------------
----------XXXXXXXX.......,.,,,,,.......XXXXXXXX----------
--------XX.,....+X,,,,,,,.,,,,.E,,,,,,,X.....,.X---------
-------X...,:.E.+,H.......,,E,........H+.E.:.,..XX-------
------X....XXXXXXX,,,,,,,,,,,,.,,,,,,,,XXXXXXX....X------
-------X.XX------X.......,,,.,,........X------XX.X-------
--------X-------X......,,,,,,,,,,......X--------X--------
----------------X..:...,........,:.....X-----------------
----------------X......,,,,,,,,,,.....X------------------
----------------X.....................X------------------
----------------X.........,,,,,........X-----------------
-------XX--------X........,...,........X-------XX--------
-------X:XXXXXXXXX.....:.,.....,.......XXXXXXXXX:--------
-------XX,,.....,........,.,,,.,....:...,....,,XX--------
-------XX..,,,,.,,.......,.,H,.,.......,,.,,,..,X--------
--------X......,,,,......,.,.,.,......,,,,.....,X--------
--------X,......,..,....,.,...,.,....,..,.....,.X--------
--------X,......,,,,XXXXXXX,,,XXXXXXX,,,,.....,.X--------
--------X.,...W.....XXX---XX.XX---XXX.....W..,..X--------
--------X.,.........,AX----XWX----XA,........,..X--------
--------X..,..X.....XAX---XX.XX---XAX.....X..,..X--------
--------X..,.XX.....XXXXXXX,,,XXXXXXX....XX.,...X--------
--------X...,X-X.........................X-X,...X--------
--------X..H,X-X............<............X-X.H.X---------
--------XX...X-X.........................X-X...X---------
----------X,X--X..........<...<..........X-X,,X----------
----------X:X--X,,.....................,,X-X:.X----------
----------XXX--X..,.........<........,,.X--XXX-----------
----------------X..,................,..X-----------------
-----------------XXXXXXXXXXX+XXXXX,XXXX------------------
---------------------XXXXXXXXXXXXX,X---------------------
-------------------XX...............XX-------------------
-----------------XX...................XX-----------------
----------------X.......................X----------------
---------------X.........................XX--------------
-------------XX.......E...........E........X-------------
------------X...............................X------------
-----------X.................................XX----------
---------XX....................................X---------
--------X.......................................X--------
-------X.........................................X-------
-------X.........................................X-------
------X...........................................X------
------X...........................................X------
-----X.............................................X-----
----X...............................................X----
----X...............................................X----
---X....E..........................,............E....X---
---X.............................,,.,................X---
--X,,............................,E..,...............,X--
--X..,,,,........................,,..,...........,,,,.X--
--X......,,...........,,,..........,.,........,,,.....X--
--X.......,...........,.,..........,XX,.......,.......X--
--X.......,..........,..,...E......,XX,.......,.......X--
--X........,.........,X.,..........,XX,......,........X--
-X.........,........,X-X,..........,XX,......,.........X-
-X.........,........,.XX.,.........,XX,......,.........X-
-X.........,.........,X-X.,.......,...,......,.........X-
-X..........,........,.X...,......,E.,......,..........X-
-X..........,.........,,.E.,......,.,.......,..........X-
-X..........,...........,,,........,........,..........X-
-X..........,...E.........,.............E...,..........X-
-X...........,.............................,...........X-
-X...........,.............................,...........X-
-X...........,.............................,...........X-
X............,.............................,............X
X.............,...........................,.............X
X.............,,............E............,,.............X
X...............,,,,.................,,,,...............X
X...................,,,...........,,,...................X
X......................,,,,...,,,,......................X
-X........E................,,,................E........X-
-X.....................................................X-
-X.....................................................X-
--X...................................................X--
--X...................................................X--
--X...................................................X--
---X.................................................X---
---X.................................................X---
---X.................................................X---
----X...............................................X----
----X...............................................X----
-----XX...........................................XX-----
-------X.........................................X-------
--------XX.....................................XX--------
----------X...................................X----------
-----------XX...............................XX-----------
-------------X.............................X-------------
--------------XX.........................XX--------------
----------------XXXXXXXXXXXXXXXXXXXXXXXXX----------------
