--------------------------------------XX++XXX-XXXXXXXXXXXXXXX-XXXXXXX--------------------
--------------------------------------X+++++X-X......H......X-X.....X--------------------
--------------------------------------X.,,,.X-X.E.........E.X-X.....X--------------------
--------------------------------------X.,.H.X-X.............X-X.....X--------------------
------------XXX-XXX-XXX-XXX-----------X.,.,.XXX...,,,,,,,...XXX.,,E.X--------------------
------------XEX-E.X-XEX-XEX-----------X.,.,.+++...,,,,,,,...+++.,.,.X--------------------
------------X.X-X.X-X.X-X.X-----------X.E.,.XXX...,,.:.,,...XXX.,.,.X--------------------
------------X,X-X,X-X,X-X,X-----------X.,.,.X-X...,,,,,,,...X-X.,.,.X--------------------
----------XXX,XXX,XXX,XXX,XXX---------X.,.,.X-X...,,,,,,,...X-X.,,,.X--------------------
----------X,,,,,,,,,,,,,,,,,X---------X.,.,.X-X..........A..X-X.....X--------------------
----------X,...............,X---------X.,,,.X-X.............X-X.....X--------------------
----------X,,,,,,,,,,,,,,,,,X---------X.....X-X.............X-X.....X--------------------
----------XXXXXXXXX,XXXXXXXXX---------XXX,XXX-XXXXXXX,XXXXXXX-XXX,XXX--------------------
------------------X.X-------------------X.X---------X.X---------X.X----------------------
------------------X.X-------------------X.XXXXXXXXXXX.XXXXXXXXXXX.X----------------------
------------------X+X-------------------X.+.,.E....++.+...E...,++.X-----------X+X--------
------------XXXXXXX,XXXXXXX-------------X.XXXXXXXXXXX,XXXXXXXXXXX.X-----------X:X--------
------------X.............X-------------X+X---------X+X---------X+X-----------X+X--------
--XXXXXXX---X.,,,,E,,,,E,.X-XXXXXXXXXXXXX+XXXXXXXXXXX+XXXXXXXXXXX+XXXXX-------X+XXX++XX--
--X.....X---+.,.........,.X-X........H................................X-------X.....,,X--
XXX.....XXXXX.,.........,.XXX.,,,,,,,,,,,,,,,,,,,,,,,,,,,,,,,,,,,,,,,.XXXXXXXXX...E.,,X--
X.,.....,,,,,.,.....E...,.,+,.,.....................................,.,,,,,,,,,.....,,X--
XXX.E...,,,,,.,.........,.,+,.,,,,,,,,,,,,,,,,E,,EE,,EE,,E,,,,,,,,,,,.,,,,,,,,,.,,,H,,X--
--X.....,,,,,.,.........,.,+,...,,,,,,,,,,,,E,,,,,,,,,,,,,,,,,,.......,,,,,,,,,..,..,,X--
XXX.....XXXXX.,...E.....,.XXX...,...........,.................,.......XXXXXXXXX.....,,X--
X.,.....X---X.,.........,.X-X...,...........,.................,.......X-------X.....,,X--
XXX.....X---X.,,,,,,,,,,E.X-XXXXX,,,,,,,,,,,XXXXXXXXXXXXXXXXXXX,,,XXXXX-------XXX,,,XXX--
--X.....X---+.............X-----X...........X-----------------X,,,X-------------X...X----
XXX.....XXXXX.....,,,,,...X-XXXXX,,,,,,,,,,,XXXXXXXXXXXXXXXXXXX,,,XXXXXXXXXXX-XXX,,,XXXXX
X.,.....,,,,,....,,,,,,,..X-X...........................................,...X-X.......,:>
X.,.E...,,,,,...,,,,,,,,,.X-X.,,,.......................................,...XXX.,,,,,.XX>
X.,.....,,,,,...,,,...,,,.X-X.,.,.......................................,...,.,.,...,.X--
XXX.....XXXXX...,,,.:.,,,.X-X.,,,.......................................,.A.,.,.,.E.,.X--
--X.....X---X...,,,...,,,.X-X...........................................,...,H,.,...,.X--
XXX.....X---X...,,,...,,,.X-X,,,,,,,,,,,,,,,,,,,,,,,,,,,,,,,,,,,,,,,,,,,,...,.,.,...,.X--
X.,.....X---+...,,,...:...X-X.........XX+XX.....................XX+XX...,...,.,.,...,.X--
XXX..E..XXXXX...,,,.:.....X-X........XXX,XXX...................XXX,XXX..,...,.,.,.E.,.X--
--X.....,,,,,...,,,.......X-X.......XX.,.,.XX.................XX.,.,.XX.,...,.,.,...,.X--
XXX.E...,,,,,...,,,.:.,,,.X-X......XX..,,H..XX...............XX..,<,W.XX,...XXX.,,,,,.X--
X.,.....,,,,,...,,,...,,,.X-X.....,XX,,W.,,,XX...............XX,,,,,,,XX,...XXX.,...,.X--
XXX...E.XXXXX...,,,.:.,,,.X-XA....,,,.,..,:.,,...............,,:,,.,,.,,,...X++.,...,.X--
--X.....X---X...,,,...,,,.X-X.....,XX,,,,,,,XX...............XX,,,,,,,XX,...XXX.,...,.X--
--XXXXXXX---X...,,,,,,,,,.X-X......XX..,,,..XX........E......XX..,,,H.XX,...XXX.,,E,,.X--
------------+....,,,,,,,..X-X.......XX.,.,.XX,,,,,,,,,,,,,,,,.XX.,.,.XX.,...,.,.,...,.X--
--XXXXXXXXXXX.....,,,,,...X-X........XXX+XXX.,,,,,,,,,,,,,,,,..XXX,XXX..,...,.,.,...,.X--
--X,,,,,,,,,,.............X-X.........XX,XX..,,.............,...XX,XX...,...H.,.,...,.X--
--X,..:,,,,,,.....E.......X-X................,,.............,...........,...,.,.,.E.,.X--
--X,,,,,,,,,,.............X-X................,,.............,...........,...,.,.,...,.X--
--X,,,XXXXXXX.............X-X....E..,,,,,,,,,,,...,,+++,,...,.,,,,,,,...,...,.,.,...,.X--
--X...X-----X.............X-X.......,.......,,,...,.....,...,.,.....,...,...,.,.,...,.X--
--X.:.X-----X...E.....E...X-X.......,.......,,,...,..H..,...,.,.....,...,...,.,.,...,.X--
--X...X-----X.............X-X.......,.......,,,...,.....,...,.,.....,...,...,.,.,...,.X--
--X...X-----XXXXXXXXXXXXXXX-X.......,.......,,,...,.....,...,.,.....,...,...,.,.E...,.X--
--X...X---------------------X.......,E......,,,..E,.E...,...,.,.....,...,...,.,.,...,.X--
--X,,,XXXXXXXXXXXXXXXXXXXXXXX.......,.......,,,...,..W..,...,.E.....,...,E..,.,.,...,.X--
--X.,,,,,,,,,,.,,.......,,,,,.......,.......,,,...,.....,...,.,.....,...,...,.,.,...,.X--
--X.,....,,,E,,,,.:...:.,,,,,.......,,,,,,,,,,,...,,,,,,,...,.,,,,,,,...,...,.,.,...,.X--
--X.,,,,,..,,..,,.......,,,,,................,,.............,...........,...,.,.,...,.X--
--XX+XXXXXXXXXXXXXXXXXXXXXXXX................,,.............,...........,...,.,.,.:.,.X--
---X.X----------------------X................,,.............,...........,...,.,.,...,.X--
---X.X----------------------X................,,,,,,,,,,,,,,,,...........,,,,,.,.,...,.X--
---X+X----------------------X....,,,,,,,,,,,,,,,............,,,,,,,,,,,,,...,A,.,...,.X--
----------------------------X....,....XX+XX....,..,,,,,,,...,...XX+XX...,...,.,.,.E.,.X--
----------------------------X....,...XXX,XXX...,..,.....,...,..XXX,XXX..,...,.,.,...,.X--
----------------------------X....,..XX.,.,.XX..,..,.....,...,.XX.,.,.XX.,...,.,.,...,.X--
----------------------------X....,.XX..,,,..XX.,..,.....,...,XX..,,,..XX,...,.,.,...,.X--
----------------------------X....,.XX,,,,,,,XX.,..,...E.,...,XX:,,<,,,XX,...XXX.,,E,,.X--
----------------------------X....,.+,.,W.,:.,,.,..,.....,...,+,.,,.,W.+,,...X-X.,...,.X--
----------------------------X....,.XX,,,,,,,XX.,..,.....,...,XX,,,,,,,XX,...X-X.,...,.X--
----------------------------X....,.XX....H..XX.,..,.....,...,XX....H..XX,...X-X.,...,.X--
----------------------------X.A..,..XX.....XX..,..,,,,,,,...,.XX.....XX.,...XXX.,,:,,.X--
----------------------------X....,...XXX+XXX...,............,..XXX+XXX..,...,H,.,...,.X--
----------------------------X....,....XX,XX....,............,...XX,XX...,...,.,.,...,.X--
----------------------------X....,,,,,,,,,,,,,,,............,,,,,,,,,,,,,...,.,.,...,.X--
----------------------------X...........................E.................A.,.,.,.:.,.X--
----------------------------X...............................................,.,.,...,.X--
----------------------------X...................E.....................E.....,.,.,.:.,.X--
----------------------------X...............................................,.,.,...,.X--
----------------------------X.H.........E...............A........A..........XXX.,,,,,.X--
----------------------------X...............................................X-X.......X--
----------------------------XXXXXXXXXXX,,,XXXXXXXXXXXXX,,,,,,,XXXXX,,,,,,,XXX-X,,,E,XXX--
--------------------------------------X,,,X-----------X+++++++X---X+++++++X---X.....X----
--------------------------------------X,,,X---XXXXXXXXX,,,,,,,XXXXX,,,,,,,XXXXX,,,,,XXX--
--------------------------------------X,,,X---X.......................................X--
--------------------------------------X,,,XXXXX.,,,,,,E,,,,,,,,,,,,,,,,,E,,,,,,,,,,,,.X--
--------------------------------------X..,,.,,,.,...................................,.X--
--------------------------------------X.,.,,.,,.,.E.......E.....E...........E.......,.X--
--------------------------------------X,.,.,,.,.,...................................,.X--
--------------------------------------XXXXXXXXX.,,,,,,E,,,H,,,,,,,,,,,,,,,,,,,,,,,,,,.X--
----------------------------------------------X...........................H...........X--
----------------------------------------------XXXXXXXXXXXXXXXXXXXXXXXXXXXXXXXXXXXXXXXXX--
