------------------------------------------XXXXXXXXXXXXXXX
-------------------------------------XXXXX..,.W.,.......X
--------XXXXXXXXXXXXXXXXXXXXXXXXXXXXX.......,.,.,.......X
--------X...........++.....E...E..,A,,,,,,,,,.,.,E..E...X
--------X.A.........++............,.........,.,.,.......X
--------X......:....++..,,........,,,,,,,,,,,.,.,.......X
--------X,,,,,,,,,,,XXX,,,,,,,,,,,XX.....E..,.XXX.....H.X
--------X.,,,.E.,,,.,.X.,H........X-XXXX....,.X-X.......X
--------X.,,,...,,,.XXX.,.......E.X-----XX,,XXX-XXX,,,XXX
--------X.,,,...,,,.X-X.,....E....X-----X..X------X,,,X--
--------X.,,,...,,,.X-X.,.........X----X..X-------X,,,X--
--------X.,,,.A.,,,.X-XE,.........X---X..X--------X,,,X--
--------X.,,,...,,,.X-X.,.E.......X---X.X---------X,,,X--
--------X.,,,...,,,.X-X.,.........X---X.X---------X,,,X--
--------X,,,,,,,,,,,XXX.,...,,,...X---X.X---------X,,,X--
--------XE,.......,.,.,.,..,...,...X--X+X---------X,,,X--
--------X.,.......,.E.,.,.,.....,...XXX+XXXXXXXXXXX,,,X--
--------X.,...W...,.,.,.,.,..H..,...++..,.....,,,,,,..X--
--------X.,.......,.XXX.,.,.....,...++..,..W..,,,,,,A.X--
--------X.,H....H.,EX-X.,.,.....,...++..,.....,,,,,,,,X--
--------X.,.......,.X-X.,.,.....,...XXXXXXXXX,XXXXXXXXX--
--------X.,.......,.X-X.,..,...,A..X--------X,X----------
--------X+XXX+++XXX+X-X.,...,,,...X-XXX-----X,X----------
--------X+X-X+++X-X+X-X.,.........X-XEX-----X,X----------
--------X.XXX,,,XXX.X-X.,.........XXX.XXXXXXX,X----------
--------X.,:.....:,.X-X.,...:...B.,E,.,,,,,,.,X----------
--------X.,.,,,,,.,.XXX.,.........XXXXXXXXXXXXX----------
--------X:,.,...,.,.,.,E,.......B.X----------------------
--------X.,.,.E.,.,.E.,.,..B......X---XXXXXXXXX----------
--------X.,.,...,.,.,.,.,......B..X---X....W..X----------
--------X.,.,,,,,.,.XXX.,..........X--XA......X----------
--------X.,.......,.X-X.,...,,,,,,,X--X.......X----------
--------X+XXX,,,XXX+X-X.,...,,,,,,,,XXX.......X---XXX----
--------X+X-X...X-X+X-X.,...,,,,,,,,++,....E..X--X:..X---
--------X.XXX,,,XXX.X-X.,...,,,,,,,,++,.......XXX.....X--
--------X.,:.....:,.X-X.,...,,,,,,,,++,.......++,..EH.X--
--------X.,.,,,,,.,.XXX.,...,,,,,,,,++,.......XXX.....X--
--------X.,.,.E.,.,.,.,.,...,,,,,,,,++,.E.....X--X...X---
--------XH,.,E..,.,.E.,.,...,,,,,,,,++,.......X---X,X----
--------X.,.,..E,.,.,.,.,...,,,,,,,,++,.......X---X.X----
--------X.,.,,,,,.,.XXX.,...,,,,,,,,XXX.......X---X.X----
--------X.,.......,.X-XH,...,,,,,,,,X-X...E...X---X.X----
--------X+XXX,,,XXX+X-X.,..........X--X.......X---X.X----
--------X+X-X...X-X+X-X.,.E.....H..X--X.......X---X.X----
--------X.XXX,,,XXX.X-X.,.........X---XXX,,,XXX---X.X----
--------X.,:.....:,.X-X.,.........X-----X...X-----X.X----
--------X.,.......,.XXXE,.........X---XXX,,,XXX---X.X----
--------X.,.......,.,.,.,.....:..X----X.....W.X---X.X----
--------XE,.W.....,.E.,.,........X----X.......X---X,X----
--------X.,....:..,.,.,.,.E......X----X.E.....X--X...X---
--------X.,.......,.XXX,,...B.B..X----X.......XXX.....X--
--------X.,.......,.X-X.,.......X-----X...E...++,..:W.X--
--------X+XXX,,,XXX+X-XXX,XXXXXXX-X>>-X.......XXX.....X--
--------X+X-X,,,X-X+X---X.X-------X.X-XA......X--X...X---
XXXXXXXXX,X-X.A.X-X,XXXXX,XXX-XXXXX,X-X...E...X---X,X----
X,,.......X-X...X-X..E....,,X-X.....X-X.......X---X.X----
X,XXXXXXXXXXX...XXXXXXXXXXX,X-XW..A.X-XXX,,,XXX---X.X----
X,X------XX,,...,,XX------X.X-X.....X---X...X-----X.X----
X,X----XX,,XX...XX,,XX----X,X-XXX,XXX---X,,,X-----X.X----
X.X--XX,,XX-X+++X-XX,,XX--X,X---X.X----X.....X----X.X----
X,XXX,,XX---X,,,XX--XX,,XXX,X-XXX,XXX-X.......X---X,X----
X.,.,XX---XX,,,,,:XX--XX,...X-XA....X-X.E..E..X--X...X---
X,XXX---XX.,,,,,,...X---XXX,X-X.....XXX.......XXX.....X--
X,X----X.:.,,,,,,,...X----X,X-X.E...,+,..E....++,.E...X--
X,X---X....,,,,,,,....X---X,X-X.....XXX.......XXX.....X--
X,X---XE...,,,,,,,..W.X---X.X-X.....X-X....W..X--X...X---
X,X--X....,.H.H...,....X--X,X-XXXXXXX-X.......X---X,X----
X,X--X...,.........,..BX--X,X---------X,.....X----X.X----
X,XXX....,.,,,,,,,.,....XXX,X--------X..XXX,X-----X.X----
X,,E,E..,.,.......,.,...,E,,X--------X..X-X,X-----X.X----
X,,E,...,.,.......,.,..,,.,,X-------X..X--X.X-----X.X----
X,,.,...,.,E...E..,.,..,,.,,X-------X..X--X.X-----X.X----
XXX.,...,.,.......,.,..,,.XXX-------X.X---X,XXXXXXX.X----
--X.,...,.,.....H.,.,...,.X--------X..X---X.......,.X----
XXX,X...,.,.......,.,.B.X,X--------X..X---XXXXXXXXXXX----
X...X...,..,,,,,,,..,...X,X-------X..X-------------------
X,XXXX.A.,,.......,,...X-X,X------X..X-------------------
X.X--X.....,,,,,,,.....X-X,X------X,X--------------------
X,XXXXX.....,,,,,..<..X---X,X-----X.X--------------------
X.,..+,..E...........X----X,X-----X.X--------------------
X.XXXXXX............X------X,X----X.X--------------------
X.X-----XXX.......XX-------X,X----X.X--------------------
X.X--------XX,,,XX----------X,XXXXX.X--------------------
X.X---------<...X-----------X.,...,.X--------------------
X,XXXXXXXXXXX,,,XXXXXXXXXXXXX,,.:.,.X--------------------
X.......,.,.........,,,,,,,,.,,...,.X--------------------
XXXXXXXXXXXXXXXXXXXXXXXXXXXXXXXXXXXXX--------------------
