--------------------------------------------XXXXXXXXX------------------------------------------------------------------------------
--------------------------------------------X.......X------------------------------------------------------------------------------
--------------------------------------------XE..E..EX------------------------------------------------------------------------------
--------------------------------------------X..,,,..X------------------------------------------------------------------------------
--------------------------------------------X,,>>>,.X------------------------------------------------------------------------------
--------------------------------------------X,>..>,.X------------------------------------------------------------------------------
--------------------------------------------X,>..>,.X------------------------------------------------------------------------------
--------------------------------------------X.,>>>,.X------------------------------------------------------------------------------
--------------------------------------------X..,,,..X------------------------------------------------------------------------------
---------------------------------------------X.....X-------------------------------------------------------------------------------
---------------------------------------------X..E..X-------------------------------------------------------------------------------
----------------------------------------------X...X--------------------------------------------------------------------------------
----------------------------------------------X...X--------------------------------------------------------------------------------
----------------------------------------------X...X--------------------------------------------------------------------------------
--------------------X-------------------------X+++X--------------------------------------------------------------------------------
-------------------X.XX-----------------------X,,,X--------------------------------------------------------------------------------
------------------XA.E.XXXXXXXXXXXXXXXXXXXXXXXX,,,XXXXXXXXXXXXXXXXXXXXXXXXXXX------------------------------------------------------
-----------------X..E.,........................,,.......................,...X------------------------------------------------------
------------------XX.,..................:......,,.....................:.,.E.X------------------------------------------------------
--------------------X...................................................,...X------------------------------------------------------
--------------------X...A...,,,,,,,,,,,,,,,,,,,,,,,,,,,,,,,,,,,,,,,,,,,,XXXXX------------------------------------------------------
--------------------X......,.................,.A.A,E...............+.AAAX----------------------------------------------------------
--------------------X.....,..................,....,...............+....AX----------------------------------------------------------
--------------------X....,...................,..W.,..............+.....AX-------------XXXXX----------------------------------------
--------------------X...H.....................,,,,,.............+.......X-------------X...X----------------------------------------
--------------------X...,......................................+........X-------------X.E.X----------------------------------------
--------------------X...,.....................................+.........X-------------X...X----------------------------------------
--------------------X...,,,,,,,..............................+..........X-------------X...X----------------------------------------
--------------------X...,,,,,.,.........................,,,,+...........X-------------XE.EX----------------------------------------
--------------------X...,,,,,.,.........................,..,,...........X-------------X...X----------------------------------------
--------------------X...,,,,,.,.........................,.E,,E..........X-------------XE.EX----------------------------------------
--------------------X...,,,,,.,.........................,,,,,...........X---------XXXXX,,,XXXXX------------------------------------
XXXXXXXXX-----------X...,,,,,.,.........................,,,,,...........X---------XA....:....:X------------------------------------
X....,,,X-----------X...,,,,,.,..........................+..............X---------XA..........X------------------------------------
X..,,,,.X-----------X...,.....,.........................+.............:.X---------X...........X------------------------------------
X,,,,...X-----------X...,.....,........................+................XXXXXXXXX-XE..........XXXXXXXXXXXXXXXXX--------------------
X,:,....XXXXXXXXXXXXX...,.....,.......................+.................,+,.....X-X....E......:,,,,,,,,E..A..EX--------------------
X,.,............,...,...,.....,.........,,,,,...A....+..................,+,.E...XXX...........,,,,,,,,,.......XXXXXX---------------
X,.,............,<..,...,.....,,,,,,,,,,,,.,,.......+...................,+,.....++,...........,,,,,,,,,.......,.tttX---------------
X,.,............,<<.W...,:.:..,,,,,,,,,,,,.+,...W..E+H..................,+,.....++,...........,,,,,,,,,...W...,Et.tX---------------
X,.,............,<..,...,.....,.........,,.+,.......+...................,+,.....++,...........,,,,,,,,,.......,.tttX---------------
X,.,............,...,...,.....,.........,,,,,...A....+..................,+,.E...XXX...........,,,,,,,,,.......XXXXXX---------------
X,.,..:.XXXXXXXXXXXXX...,.....,.......................+.................,+,.....X-X....E......:,..,,,,,E..A..EX--------------------
X,,.,,..X-----------X...,.....,........................+................XXXXXXXXX-XE..........XXXXXXXXXXXXXXXXX--------------------
X..,,.,,X-----------X...,.....,.........................+.............:.X---------XA..........X------------------------------------
X....,,.X-----------X...,,,,,.,..........................+..............X---------X...........X------------------------------------
XXXXXXXXX-----------X...,,,,,.,.........................,,,,,...........X---------XH....:....:X------------------------------------
--------------------X...,,,,,.,.........................,..,,...........X---------XXXXX,,,XXXXX------------------------------------
--------------------X...,,,,,.,.........................,.E,,E..........X-------------XE.EX----------------------------------------
--------------------X...,,,,,.,.........................,,,,,...........X-------------X...X----------------------------------------
--------------------X...,,,,,.,.........................,,,,+...........X-------------XE.EX----------------------------------------
--------------------X...,,,,,,,..............................+..........X-------------X...X----------------------------------------
--------------------X...,.....................................+.........X-------------X...X----------------------------------------
--------------------X...H......................................+........X-------------X.E.X----------------------------------------
--------------------X...,....................,,,,,,.............+.......X-------------X...X----------------------------------------
--------------------X....,...................,..W.,..............+.....AX-------------XXXXX----------------------------------------
--------------------X.....,..................,....,...............+....AX----------------------------------------------------------
--------------------X...A..,.................,.A.A,E...............+.AAAX----------------------------------------------------------
--------------------X.......,,,,,,,,,,,,,,,,,,,,,,,,,,,,,,,,,,,,,,,,,,,,XXXXX------------------------------------------------------
-------------------X.,..................................................,...X------------------------------------------------------
-------------------XE.,.................:.......H.....................:.,.E.X------------------------------------------------------
------------------X....X................................................,...X------------------------------------------------------
-------------------XAEX-XXXXXXXXXXXXXXXXXXXXXXX,,,XXXXXXXXXXXXXXXXXXXXXXXXXXX------------------------------------------------------
--------------------X.X-----------------------X,,,X--------------------------------------------------------------------------------
---------------------X------------------------X...X--------------------------------------------------------------------------------
----------------------------------------------X...+--------------------------------------------------------------------------------
----------------------------------------------X.E.X--------------------------------------------------------------------------------
----------------------------------------------X,,,X--------------------------------------------------------------------------------
------------------------------------------XXXXX...XXXXX----------------------------------------------------------------------------
------------------------------------------XH.........AX----------------------------------------------------------------------------
------------------------------------------X.,,E,E,E,,.X----------------------------------------------------------------------------
-----------------------------------------XX.,.......,.X----------------------------------------------------------------------------
-----------------------------------------X..,.,,,,,.,.X----------------------------------------------------------------------------
-----------------------------------------X..,.,...,.,.X----------------------------------------------------------------------------
-----------------------------------------X..,.,.:.,.,.X----------------------------------------------------------------------------
-----------------------------------------X.E,.,...,.,EX----------------------------------------------------------------------------
-----------------------------------------X..,.,,,,,.,.X----------------------------------------------------------------------------
-----------------------------------------XXE,.......,EX----------------------------------------------------------------------------
------------------------------------------X.,,,,,,,,,.X----------------------------------------------------------------------------
------------------------------------------XE.........EX----------------------------------------------------------------------------
------------------------------------------XXXXX.H.XXXXX----------------------------------------------------------------------------
----------------------------------------------X.H.X--------------------------------------------------------------------------------
----------------------------------------------X...X--------------------------------------------------------------------------------
----------------------------------------------X.H.X--------------------------------------------------------------------------------
----------------------------------------------X.H.X--------------------------------------------------------------------------------
----------------------------------------------X...X--------------------------------------------------------------------------------
----------------------------------------------X.H.X--------------------------------------------------------------------------------
----------------------------------------------X.H.X--------------------------------------------------------------------------------
------------------------------------------XXXXX,,,XXXXX----------------------------------------------------------------------------
------------------------------------------X:.........:X----------------------------------------------------------------------------
------------------------------------------X.......E.E..X---------------------------------------------------------------------------
------------------------------------------X..E.........X---------------------------------------------------------------------------
--------------------------------------XXXXX...........E.X--------------------------------------------------------------------------
--------------------------------------X..,,A...........+X--------------------------------------------------------------------------
--------------------------------------X.E,,.....W.....+..X-------------------------------------------------------------------------
--------------------------------------X..,,A.........+..,.X------------------------------------------------------------------------
--------------------------------------XXXXX.........+..,.,X------------------------------------------------------------------------
------------------------------------------X........+..,.,..X-----------------------------------------------------------------------
------------------------------------------X.E.....+..,.,...X-----------------------------------------------------------------------
------------------------------------------X:.....+..,.,...,X-----------------------------------------------------------------------
------------------------------------------XX..E.+..,.,...,..X----------------------------------------------------------------------
--------------------------------------------XX.+..,.,...,..,X----------------------------------------------------------------------
----------------------------------------------XX.,.,...,..,..X---------------------------------------------------------------------
------------------------------------------------X.,...,..,..,X---------------------------------------------------------------------
-------------------------------------------------XX..,..,..,.,X--------------------------------------------------------------------
---------------------------------------------------XXX.,..,,,.XXXXX----------------------------------------------------------------
------------------------------------------------------XX.,.,....E..X---------------------------------------------------------------
--------------------------------------------------------XX,..E.....X--------------------------X:X----------------------------------
----------------------------------------------------------XX......E.X-------------------------X.X----------------------------------
-----------------------------------------------------------X......XX--------------------------XEX----------------------------------
-----------------------------------------------------------XE...A,.X----XXXXXXXXXXXXXXXXXXXXXXX,XXXXXXXXBBX------------------------
-----------------------------------------------------------X....,.+.X-XX................,.,A.............BX------------------------
-----------------------------------------------------------X..EX..+L.X,...........E.E.E.,.,A......E...E...X------------------------
------------------------------------------------------------XX.XXXL.,..................H,.,..............:X------------------------
--------------------------------------------------------------X--X.,....................,.,A..............X------------------------
------------------------------------------------------------------X,...................H,.,.........BB....X------------------------
-----------------------------------------------------------------X,,.........E,,,.....EH,.,.....,,,,,,....X------------------------
-----------------------------------------------------------------X............,:,....,,,,.,.....,....,....X------------------------
----------------------------------------------------------------X.............,,,....,....,.....,E,,.,....X------------------------
----------------------------------------------------------------X....................,,,,,,.....,.,,.,....X------------------------
----------------------------------------------------------------X....................,,,,,......,.,,.,,,..X------------------------
----------------------------------------------------------------X....................,,,,,......,.,:.,.,..X------------------------
--------------------------------------------------------XXXXXXXXX....................,,,,,......,.,,.,,,..XXXXXXXXX----------------
--------------------------------------------------------XA...........................,,,,,......,.,,.,,,..E.W....:X----------------
--------------------------------------------------------X.....:......................,,,,,......,E,,.,,,..XXXXA,,,X----------------
--------------------------------------------------------XA...........................,,,,,,.....,....,,,..X---X...X----------------
--------------------------------------------------------X............................,....,.E...,,,,,,....X---A...X----------------
--------------------------------------------------------XA...........................,,,,.,...............X---H...X----------------
--------------------------------------------------------X.......,.................:....H,.,...............X---H...X----------------
--------------------------------------------------------X.....,,.,......................,.,......W........X---H...X----------------
--------------------------------------------------------X....,..,.......................,.,...............XXXXX,,,X----------------
--------------------------------------------------------X....,.,...................E....,.,......A........E.,....AX----------------
--------------------------------------------------------X.....,.........................,.,...............XXXXX,XXX----------------
--------------------------------------------------------X...............................,.B............A.AX---X,X------------------
--------------------------------------------------------X...........................XXXXXXXXXXXXX+++XXXXXX----X,X------------------
--------------------------------------------------------X...........................X-----------X+++X---------X,X------------------
--------------------------------------------------------X.........,,,,,,,,,,,,,.....X-------:XEXX,,,XXE:X-----X,X------------------
--------------------------------------------------------X.........,,,,,,,,,,,,,.....X-------E...........X-----X,X------------------
--------------------------------------------------------X.........,,W.......A,,.....X-------X..........EX-----X,XX-----------------
--------------------------------------------------------X.........,,.........,,.....X-------X...........X----X....X----------------
--------------------------------------------------------X.........,,.........,,.....X----XXXX...........XXXXX.E..E.X---------------
--------------------------------------------------------X.........,,.........,,.....X----XW,,...........,,,,,......X---------------
--------------------------------------------------------X......E..,,....E....,,..E..X----XH,,...........,,,,,..E...X---------------
--------------------------------------------------------X.........,,.........,,.....X----XA,,...........,,,,,......X---------------
--------------------------------------------------------X.........,,.........,,.....X----XXXX...........XXXXX.E....X---------------
--------------------------------------------------------X.........,,.........,,.....X-------X...........X----X.:..X----------------
--------------------------------------------------------X.........,,A........,,.....X-------X...........X-----XXXX-----------------
--------------------------------------------------------X.........,,,,,,,,,,,,,.....X-------X...........X--------------------------
--------------------------------------------------------X.........,,,,,,,,,,,,,.....X-------XA....E....AX--------------------------
--------------------------------------------------------X...........................X--------XA.......AX---------------------------
--------------------------------------------------------X......E.................E..X--------X.A.....A.X---------------------------
--------------------------------------------------------X...........................X---------X.......X----------------------------
--------------------------------------------------------X.,,,...........E...........X----------XX...XX-----------------------------
--------------------------------------------------------X.,H,.......................X-----------X,,,X------------------------------
--------------------------------------------------------X.,.,.......................X-----------X...X---------XXX------------------
--------------------------------------------------------X.,W,..,,...................X-----------XE.EX---------X.X-----XXXX---------
--------------------------------------------------------X.,,,.,..,...........,,,,,XXX-----------X...X---------XtX-XXXX..E.X--------
--------------------------------------------------------X....,..,...........,.,,,,X-------------X...X---------XHX-XE..E.,,X--------
--------------------------------------------------------X...,,.,............,,,.E.XXX-----------X...X--------X..XX..,,,,,,XXXXX----
--------------------------------------------------------X.....,,,,..........,,.....EX-XXX-------X+++X--------XX+XX,,,,......t.X----
--------------------------------------------------------X......,.,..........,+E+....XXXEX----XX-X+++X-X----XX.,.............ttX----
--------------------------------------------------------X......,,,,.........,,,+....,,,.X---X..XX,,,XX.E---X.:,...............X----
--------------------------------------------------------X...E....,,.........,,,A.:.A,,,.X--XXE,.......,.X--XE.,...............X----
--------------------------------------------------------X...................,,,+....,,,EX----X.........X---XE.,...............X----
--------------------------------------------------------X...................,,E+....XXX.XXXXX...A...A..XXXXX..,..............,XXX--
--------------------------------------------------------X...................,,......X-X...L.,..........,.+.,..,,,,,,,,,,,,,,,,,.,XX
--------------------------------------------------------X...................,,,A.AXXX-X.E.L.,..........,.+.,T.,,,,,,,,.,,,,,,,,E,KX
--------------------------------------------------------X......,,,,.........,.,,,,X---X...L.,.....H....,.+.,..,......,,,.....,,..XX
--------------------------------------------------------X......,,,,..........,,,,,XXX-X,XXXXX..........XXXXX..,...............XXX--
--------------------------------------------------------X......,,K,....W.........E.HX-XEX----X.........X---XE.,...............X----
--------------------------------------------------------X.,,,.E,,,,................:X-XEX---X.,.A...A.,X---X..,...............X----
--------------------------------------------------------X.,.,......................:X-XEX--X.E.X.....XE.X--XE.,...............X----
--------------------------------------------------------X.,,,.......................X-A.H---X.X-X,,,XX.X---XXXXXX,,,,,......ttX----
--------------------------------------------------------XH,:,....E.................AX-XXX----X--XE.EX-X---------X,,,,,,,,,XXt.X----
--------------------------------------------------------X.,,,.......................X-----------X,..XXXXXXX-----E.....,,,,X-XXX----
--------------------------------------------------------XA.....................A.A.AX-----------X.E,,E.....XXXXXX......E..X--------
--------------------------------------------------------XXXXXXXXXXXXXXXXXXXXXXXXXXXXX-----------X...,......,,..+,...E.:,,,X--------
------------------------------------------------------------------------------------------------X...,......,,..+,......,A,X--------
------------------------------------------------------------------------------------------------X.:.,.....XXXXXX:.E.E..,,,X--------
------------------------------------------------------------------------------------------------X...,....:X-----XXXXXX...:X--------
------------------------------------------------------------------------------------------------XXXXX.....X-----------XXXXX--------
----------------------------------------------------------------------------------------------------XE.E.X-------------------------
----------------------------------------------------------------------------------------------------XXXXX--------------------------
