---------------------XXXX-X:XX-----------------------
---------------------X...X.,,X-----------------------
--------------------X....,:.:X-----------------------
-------------------X......,,,XX----------------------
------------------X,...E...H...X---------------------
------------------X.,..,,......X---------------------
-------------------X,.,.,.......X--------------------
-------------------X,.,..,..:...X--------------------
-------------------X.,,..,....E.X--------------------
------------------XX.,.,,..,,,...X---XX--------------
------------------X.,.,:,..,.,...X-X:,,XX------------
------------------X.,.,,.,..,,..:XX.,.,.X------------
-------------------X.,,.,.,.......X,..,.X------------
--------------XXXXXXX,.,,..,.,,...,,..,,,X-----------
-------------X.H....:X.,,..,,..,E.,E..>.,X-----------
-----------XXH......+X,,,..:,..,..,,..>,X------------
-----------X......E.+,,.,,..,,,...X,..,.X------------
-----------X........+,.,,,..,.....X,..,.X------------
-----------X.......:X,.,.,..,....XXX:.,,X------------
--------XXXX.......XXX..,,,,,H..X---XXXX-------------
------XXAA,,...XX:.X-X.XX,.X.XXXX--------------------
------XAE.,XXXXXXXX--XXXXXXXX-XXXXX-XXXX-------------
-----X....XX.XX.XXHX-X.E....,X.....X....XX-----------
-----XE...XX:.W.XX.:-X.....,.,..........H.X----------
-----X..E.XX...HH...XXX...EXX......:...,,,X----------
------X...XX..X.,H,,.,,.....XX.........,.,:X---------
------XE..XX..XX,.E,.XX...E.XX.......,,,,,.X---------
------X..EX...XX...,.XXXXX...XX.:....T,..XX---XXX----
-XXXX-X,..XE.EX,...,X--XXXX.EXX....,,,,,,X---X...XX--
-X...XX,XXX.HHX,.E.,XXX...XX..HX...T,.AT,X--X,,,,.X--
-XE......XX..X-X...XXX.,..:XXXXX...,,,,,,X--X,,,,,X--
-X..E....:XA.X-X,..XXH.,.....XXX.....T,..X--X,,,,.,X-
-XE.......X.X-X.,.EXX.,......,.,.E...,,.HXXX....,,,X-
-X.......XXAXX...,,,XX.......,.W,...XXXXXXX.....,,,X-
-X........XXX......:.X.......,,.XXXXX:XXX.,,...E,,,X-
--XXX...,.,HX..E.E...XX.......,XXXXX....A,.,.....XXX-
-----XX,,XXXX........XX....<...,,........,.,:...X----
------X...X-X........XX........,.,......E,.,....X----
------X.E..XX,,,,,,EXX........,,,X.......,,,..E..X---
------X....XX...,,,XXX.......,,.HX........,,......X--
-----X.....XX.EXX,,XXXX...,,,,.HXX...X..E.,,.....:X--
---XX..:...EXXX-X....:XXX.,HHHHXX...X-XX..,,......X--
--X.......XXX----X.....X-XXXXXXXX....XXX..,,...E..X--
--X.......X-X----X...,..XXX..XXXX.E...XX.XX,......X--
--X......X-X:X--X..,,.,,...,...XX........XX,......X--
--X......XX:,XXX...,....,.,.,.:X-XH..WAAAXX......X---
--XH.XXX.XXX:,.....,...E.,..,...XX.......XXX.,,,X----
-X..X--XAX-X,,H.A..,.,,,,...,..,.X....XX.X-XXX,.X----
X,..X-X...XX,...A.,,.,...,,,..XX.,...X-XHHX--X.AXX---
X.,,XXX..,XX..H.A...,.X......X--X.....XXHHX--X....X--
X...X,,..,,XX........X-XXX.:X--X.:...E..HHX--X....X--
X.....:,,,AXX..XXXXXX-----XXX-X-XXX..XXXXXX--X.....X-
-XX....,,,.XXXXXXX..X--XXXX---XX---XX-------XX.:..X--
--X,,..,,.AXXX:......X-X:..XXXXXXXXX--------X.....X--
--X,.X,,.AX-X.....,,.XX,....,.....E.X------X......X--
--X.,XX...XXH...:,.,,,,,....,.......XXXX---X......X--
--X..XX.AXX...,,..,.XXX,...,....A..XX:..XXX,..,,,.X--
--X..X-X.XXH.,,..,..X-X.,.EXXX..A.X-X.......,.,E,.X--
--X.E.X-XX....,.,..X-X..,..X--X...,X........H,X,,.X--
--X...XX-X..,..,.XX-XX.E,..HXX-X..X,...X....HXX....X-
-X......X.,,,.:..XXX....,,.HHEXX..XX...XX...H--X.:,X-
-X...,,E,,..H,,.XX.:A.XXX.XH.HXX..XX.EX-X...H--X.,,X-
-X.,,.......E.,.XXXXXXXX.,XXHHHXX.XX...XX..HX--X.,:X-
-X.,...E.....,..,X--XXAA...XX.HXX.XX.,E,....H-X..,,,X
-X..,........,,,.X--A..A..AAXX....XX,...,,,,,XE..,,:X
--X.,..E....,A..:.X-XXAA..A.AXXXXX-X.........E...,KX-
--X.:...,,,,.,..,,X---X.:.AAX-------XX...........,.X-
--X..,,,.....,:.,:X----XXXXX----------XX..:......,X--
---XHHHHHHHHH,..:X----------------------XXX...XXXX---
-----XXXX----XXXX--------------------------XXX-------
-----------------------------------------------------
-----------------------------------------------------
-----------------------------------------------------
-----------------------------------------------------
-----------------------------------------------------
-----------------------------------------------------
-----------------------------------------------------
-----------------------------------------------------
-------------------------------------------XXXXXXX---
-------------------------------------------X.tEt.X---
-------------------------------------------XtttttX---
-------------------------------------------XEt.tEX---
-------------------------------------------XtttttX---
-------------------------------------------X.tEt.X---
-------------------------------------------XXXXXXX---
