------------------------------------------------XXX----------------XXXXXXXXXXXXXXXXXXXXXXXXX--------------------------------------------------------------------------------------------------------------------------
------------------------------------------------X,X----------------X:..........H..........AX--------------------------------------------------------------------------------------------------------------------------
------------------------------------------------XXX----------------X.........,,,,,.........X--------------------------------------------------------------------------------------------------------------------------
-------------------------------------------------------------------X..XX,XX,,,,,,,,,XX,XX..X--------------------------------------------------------------------------------------------------------------------------
-------------------------------------------------------------------X..XX,XX.,,,,,,,.XX,XX..X--------------------------------------------------------------------------------------------------------------------------
------------------------------------------------XXX----------------X..K.E.,...,,,...,E.,,..X--------------------------------------------------------------------------------------------------------------------------
------------------------------------------------X,X----------------X..X..XX,.......,X..XX..X--------------------------------------------------------------------------------------------------------------------------
------------------------------------------------XXX----------------X..XX,XX,.......,XX,XX..X--------------------------------------------------------------------------------------------------------------------------
-------------------------------------------------------------------X..,,.,,,...H...,,,.,,..X--------------------------------------------------------------------------------------------------------------------------
-------------------------------------------------------------------X.,,,...............,,,.X------------------------------------------------------------------------------------ttX-----------------------------------
------------------------------------------------XXX----------------X.,,,,.H....E....W.,,,,.X-----------------------------------------------------X:XXXXXXXXXXXXAAAXXXXXXXXXXXXXXX,XXXXXXXXXXXXXAXAAXXXXXXXXXXXXX:X----
------------------------------------------------X,X----------------X.,,,...............,,,.X-----------------------------------------------------X...............................................................X----
------------------------------------------------XXX----------------X..,,.,,,.......,,,.,,..X-----------------------------------------------------X...............................H...............................X----
-------------------------------------------------------------------X..XX,XX,...:...,XX,XX..X-----------------------------------------------------X..............W................................W...............X----
-------------------------------------------------------------------X..XX.XX,.......,XX.XX..X-----------------------------------------------------X...............................................................X----
------------------------------------------------XXX----------------X..,.E.,...,,,...,E.,,..X-----------------------------------------------------X.........................H.....................................X----
------------------------------------------------X-X----------------X..X..XX.,,,,,,,.X..XX..X-----------------------------------------------------X...............................................................X----
------------------------------------------------XXX----------------X..XX,XX,,,,,,,,,XX,XX..X-----------------------------------------------------X..............................................:..........E.....X----
-------------------------------------------------------------------X.........,,,,,.........X-----------------------------------------------------X.......E.......................................................X----
-------------------------------------------------------------------XH,,,,,,,,,,,,,,,,,,,,,HX-----------------------------------------------------X...............................................................X----
-------------------------------------------------------------------XXXXXXXXXXX,,,XXXXXXXXXXX-----------------------------------------------------X......................,,,,,,,,,,,,,,,,,,,......................X----
-----------------------------------------------------------------------------XLLLX---------------------------------------------------------------X.....................,...................,.....................X----
-----------------------------------------------------------------------------XLLLX---------------------------------------------------------------X....................,.....................,........:...........X----
:XXXXXXXXXXXXXXXXXXXXXXXXXXXXXXXXXXXXXXXX:X---------------:XXHXXXXHXHHXXXXXX:X,,,XXXXXXHXXXXWXXXXHX:X--------------------------------------------X...................,.......................,...................X----
X.........................................X---------------Xt.......................................tX--------------------------------------------X..................,.........................,..................X----
X.........................................X---------------X.t..................W..................t.X--------------------------------------------X.................,......,,,,,,,,,,,,,,,......,.................X----
X.....................H...................X---------------XE.t...................................tE.X--------------------------------------------X................,......,......,.,......,......,................X----
X..............H..........................X---------------X...t.................................t...X----------XXX-------------------------------X...............,......,.......,.,.......,......,...............X----
X.........................................X---------------Xttttt,,,,,,,,,,,,,,,,,,,,,,,,,,,,,,,tttttX----------XWX-------------------------------X..............,......,........,.,........,...H..,..............X----
X.........................................X---------------X....,,,,,,,,,,,,,,,,,,,,,,,,,,,,,,,,,...AX----------X+X-------------------------------X.............,......,.........,.,.........,......,.............X----
X.....................,...................XXXXXXXXXXXXXXXXX....,,,............................,,....X-XXXXXXXXXX+XXXXXXXXXX----------------------X............,.......,,........,.,........,.,......,............X----
X......A,,,,A........,,......H,,,,A.......,,+E..,W.,.:..E+,....,K,............................,,...AX-XH.................AX----------------------X...........,.......,..,.......,.,.......,...,......,...........X----
X.......,...,........,.,......,...,.......XXXXXXXXXXXXXXXXX....,,,...........................W,,...AX-X,.......,,,........X----------------------X..........,.......,.,..,......,.,......,...,.,......,..........X----
W......A,.E.:..,,,..,..,.,,,.H,.E.A.......X---------------X....,,.............................,,..:AX-X,.XX,XX,,,,,XX,XX..X----------------------X.........,.......,...,..,.....,.,......,..,...,......,.........X----
X......A,...A..,T,E.,...,,T,.H,...A......AX---------------A....,,.....................:.......,,....X-X,.XX..X,,,,,XX..X..X----------------------X.........,......,.....,..,..,,,,,,,...,.,,.....,.....,.........X----
X.......,,,,,..,,,.,....,,,,..,,,,,.......X---------------A....,,.............................,,...AX-X,.,,E.,..,..,.E.,..X----------------------X.........,.....,.......,..,.,......,.,.,........,....,.........X----
X..................,....,................AX---------------X....,,....H........................,,...AX-X,.XX.XX,.H.,XX.XX..X----------------------X.........,.....,........,..,........,.,.........,....,.........X----
X..................,....,................AX---------------A....,,.............................,,....X-X,.XX,XX,...,XX,XX..X----------------------X.........,.....,.........,,..........,..........,....,.........X----
X.................,,,,,,,,...............AX---------------A....,,.............................,,....X-X,,,..,,,...,,,..,..X----------------------X.........,.....,.........,....,,,,....,.........,....,.........X----
X.................,,....,,................X---------------A....,,.............................,,...:X-X,,,,...........,,..X----------------------X.........,.....,........,...,,....,....,........,....,.........X----
X...<.............,......,...............AX---------------X....,,.................E...........,,....XXX,,,,...........,,,.XXXXXXXXXXXXXXXXXXXXXXXX.........,.....,........,..,.......,...,........,....,.........XXXXX
XE<,,,,,,,,.......,.,,,,.,...............AX---------------A.W..,,.............................,,.H..,L,,,,,,.........,,,,.,L......E...t.........+,.........,.....,,,,,,,,,,..,.......,...,,,,,,,,,,....,.........+,..>
X.,...,,,,,.....E.,,.T..,,......:...H...WAX---------------A....,,..........E..................,,....,L,,,,,,.:..E..H.,,,,.,L....E...E.t...W...H.+,....H....,..T..,........,.W,...H...,...,........,.E..,...E.....+,HH>
XH,..<,,,,,.......,.,,,,.,................X---------------A....,,.............................,,....,L,,,,,,.........,,,,.,L..........t.........+,.........,.....,,,,,,,,,,..,.......,...,,,,,,,,,,....,.........+,..X
XEA.AW<...........,......,...............AX---------------X....,,:A...............E...........,,....XXX,,,,...........,,,.XXXXXXXXXXXXXXXXXXXXXXXX.........,.....,........,...,,....,....,........,....,.........XXXXX
X.,,,,,...........,,,..,,,...............AX---------------A....,,AA.....................,,,,,,H,....X-X,,,,...........,,..X----------------------X.........,.....,........,.....,,,,.....,........,....,.........X----
X..................,.,,.,................AX---------------A....,,A:.....................,,,,,.,,....X-X,,,..,,,...,,,..,..X----------------------X.........,.....,.........,...........,,.........,....,.........X----
X..............,,,.,....,,,,..............X---------------A....,,.......................,,,,,.,,...AX-X,,XX,XX,.W.,XX,XX..X----------------------X.........,.....,........,.,..........,,.........,....,.........X----
X..............,T,.,...,.,T,.............AX---------------X....,,.......................,,,,,.,,.:..X-X,.XXE.X,...,XXE.X..X----------------------X.........,.....,.......,...,........,..,........,....,.........X----
X..............,,,.,...,.,,,.A,,,,A......AX---------------A....,,....:..................,,,,,,,,...AX-X,.,,..,..,..,...,..X----------------------X.........,.....,......,...,.,,,,,,,,.,..,.......,....,.........X----
X.................E.,..,......,...,.......X---------------X....,,.............................,,...AX-X,.XX,XX,,,,,XX,XX..X----------------------X.........,......,.....,..,....,.,.....,..,.....,.....,.........X----
XW,,,...............,.,......H,.E.E.......X---------------X....,,.....................H.......,,..:AX-X,.XX,XX,,,,,XX,XX..X----------------------X.........,.......,...,.,,.....,.,......,..,...,......,.........X----
XH,,,....HH..........,,......A,...A.......XXXXXXXXXXXXXXXXX,,,,,W.............................,,....X-X,.......,,,........X----------------------X..........,.......,.,.,.......,.,.......,..,.,......,..........X----
HHE,,....HH..........,........,,,,,.......++.E..,.W.,..+.,E...,,,.............................,,...AX-XH.................AX----------------------X...........,.......,.,........,.,........,..,......,...........X----
X:,,,....HH...............................XXXXXXXXXXXXXXXXX,,,,,,.............................,,...AX-XXXXXXXXXXLLXXXXXXXXX----------------------X............,.......,.........,.,.........,,......,............X----
X,,,,.....................................X---------------X....,,,,,,,,,,,,,,,,,,,,,,,,,,,,,,,,,....X--------------------------------------------X.............,.......,........,.,........,...H...,.............X----
X.........................................X---------------Xttttt,,,,,,,,,,,,,,,,,,,,,,,,,,,,,,,tttttX--------------------------------------------X..............,.......,.......,.,.......,.......,..............X----
X..............:.....H....................X---------------X.E.t.................................t.E.X--------------------------------------------X...............,.......,......,.,......,.......,...............X----
X.........................................X---------------X..t................W..................t..X--------------------------------------------X................,.......,,,,,,,,,,,,,,,.......,................X----
X.........................................X---------------X.t.....................................t.X--------------------------------------------X.................,...........................,.................X----
:........................................:X---------------:t.H...W....H.....:...........HHH......H.:X--------------------------------------------X..................,.........................,..................X----
XXXXXXXXXXXXXXXXXXXXXXXXXXXXXXXXXXXXXXXXXXX---------------XXXXXXXXXXXXXXXXXXXX,,,XXXXXXXXXXXXXXXXXXXX--------------------------------------------X...................,.......................,...................X----
-----------------------------------------------------------------------------XLLLX---------------------------------------------------------------X....................,.....................,....................X----
-------------------------------------------------------------------XXXXXXXXXXX,,,XXXXXXXXXXX-----------------------------------------------------X.....................,...................,.....................X----
-------------------------------------------------------------------XH,,,,,,,,,,,,,,,,,,,,,HX-----------------------------------------------------X......................,,,,,,,,,,,,,,,,,,,................E.....X----
-------------------------------------------------------------------X.......,,,,,,,,,,......X-----------------------------------------------------X.......E.......................................................X----
-------------------------------------------------------------------X..XX,XX,,,,,,,,,XX,XX..X-----------------------------------------------------X...............................................................X----
-------------------------------------------------------------------X..XX,XX.,,,,,,,.XX,XX..X-----------------------------------------------------X...............................................................X----
-------------------------------------------------------------------X..,.E.,...,,,...,.E,,..X-----------------------------------------------------X...............................................................X----
-------------------------------------------------------------------X..X..XX,.......,X..XX..X-----------------------------------------------------X......................................H........................X----
-------------------------------------------------------------------X..XX,XX,...:...,XX,XX..X-----------------------------------------------------X..............W.................................W..............X----
-------------------------------------------------------------------X..,,.,,,.......,,,.,,..X-----------------------------------------------------X...............................W...............................X----
-------------------------------------------------------------------X.,,,...............,,,.X-----------------------------------------------------X...............................................................X----
-------------------------------------------------------------------X.,,,,.H....E....W.,,,,.X-----------------------------------------------------X:............AAA...............................AAA............:X----
-------------------------------------------------------------------X.,,,...............,,,.X-----------------------------------------------------XXXXXXXXXXXXXXXXXXXXXXXXXXXXXXXXXXXXXXXXXXXXXXXXXXXXXXXXXXXXXXXXX----
-------------------------------------------------------------------X..,,.,,,.......,,,.,,..X--------------------------------------------------------------------------------------------------------------------------
-------------------------------------------------------------------X..XX,XX,.......,XX,XX..X--------------------------------------------------------------------------------------------------------------------------
-------------------------------------------------------------------X..XX.XX,...H...,XX.XX..X--------------------------------------------------------------------------------------------------------------------------
-------------------------------------------------------------------X..,.E.,...,,,...,.E,,..X--------------------------------------------------------------------------------------------------------------------------
-------------------------------------------------------------------X..X..XX.,,,,,,,.X..XX..X--------------------------------------------------------------------------------------------------------------------------
-------------------------------------------------------------------X..XX,XX,,,,,,,,,XX,XX..X--------------------------------------------------------------------------------------------------------------------------
-------------------------------------------------------------------X.........,,,,,.........X--------------------------------------------------------------------------------------------------------------------------
-------------------------------------------------------------------X:..........H..........AX--------------------------------------------------------------------------------------------------------------------------
-------------------------------------------------------------------XXXXXXXXXXXX,XXXXXXXXXXXX--------------------------------------------------------------------------------------------------------------------------
------------------------------------------------------------------------------XKX-------------------------------------------------------------------------------------------------------------------------------------
------------------------------------------------------------------------------XXX-------------------------------------------------------------------------------------------------------------------------------------
