------------------------------XXXXX------------------------------------------------------------------
------------------------------XAA.X------------------------------------------------------------------
------------------------------X...X------------------------------------------------------------------
------------------------------X.E.X------------------------------------------------------------------
------------------------------X...X--XXXXX-----------------------------------------------------------
------------------------------X...X--A.AAX-----------------------------------------------------------
------------------------------X.E.X--X+++X-----------------------------------------------------------
------------------------------X...X-X:..:X-----------------------------------------------------------
------------------------------X.E.XX.E.E.X-----------------------------------------------------------
------------------------------X...X..,,..X-----------------------------------------------------------
------------------------------X...X:.,W,.XXXXX-------------------------------------------------------
------------------------------X.E.X..,,..,.,.,XXXXXX-------------------------------------------------
------------------------------X...XX:...E,E,.,,,.,.X-------------------------------------------------
------------------------------X...XX...:.XXXXXXXXXX.X------------------------------------------------
------------------------------X..EXXXXXXX---------X,X------------------------------------------------
------------------------------X,,,XXXXX-XXXXXXXXXXX,X-X++XXXXXXXXXXXXXXXXXXXXXXXXXX------------------
------------------------------X:....,HX-X:..,,,HX:X,X-XEXX,,,,,,,,,,,,,,,,,,,,,,,,X------------------
------------------------------X...,,,,X-X...,,,,X...X-X.XX,:..:.............B.B..,X------------------
------------------------------X...,.,HX-X...,.,,X...:XX.XX,..:.......,,,,,.....B.,X------------------
-------------------------XAAXAX...,,,,X-X.E.,,,XXX,,,,X.XX,.:...,,,,,.....,.H...B,X------------------
-------------------------:,,,:X..A...,X-X.......+.+...,.XX,...,,..........,...A..,X------------------
-------------------------X.EXXX...,,,.XXX...,,,.+.+...,.XX,:.,.............,.....,X------------------
-------------------------X..XXX..A,.,..:..E.,.,.+.+...XXXX,..,............,,..H..,X------------------
-------------------------X...+....,,,....E..,,,XXX,,,,XXXX,.,........,,..,,.,....,X------------------
-------------------------X.EXXX........E.......XXX.E.E..XX,.,,,,,,..,E.E,,,.,..A.,X------------------
-------------------------X...XX:.........:.....:X:.....:XX,,,.....,.E...E,,,.,...,X------------------
-------------------------XX,XXXXXXXX,,,,XXX,,,,XXX,,,,XXXX,,,.H...,,..:..,,,.,.A.,X------------------
-------------------------X...........B.B.B................,,,,..H,.,....::.,..,..,X------------------
-------------------------X,,,,,,,,,,,,,,,,,,,,,,,,,,,,,,,,,,..,,,,.,......,...,A.,X------------------
-------------------------X,............,,,,,,,,,,,,,,.......,.......,.....,...,..,X------------------
-------------------------X,E,,,,,,,,,,,..............,,,,,..,........,,.A,....,..,X------------------
-------------------------X,,..............................,,,..........,.,....,..,X------------------
-------------------------X,E..........,,,,,,,,,,,,....,,,.....,,,,,,....,.....,..,X------------------
-------------------------X,,....,,,,,,....,,,,,...,,,,..,....,....E.,,,,,.....,..,X------------------
-------------------------X,,..,,...:..:.E.,EEH,.H....:.,.....,E.....E..,......,..,X------------------
-------------------------X,E.,,,...:......,.E.,...:....,....,..E,,,..:.,......,:.,X------------------
-------------------------XA,....,,,,,.E.E.,H..,.A.....,....,.:..,.,...,.......,..,X------------------
-------------------------X,,.........,,,,,,,,H,.H..:..,....,...E,,,:.,........,..,XXX----------------
-------------------------A,E,.............,,,,,...:..B.,..,,..:..:..,....E..,,,A.,..X----------------
-------------------------X,.,,,,,,,,,,,,,,,,,,.,,,B..B.,....,,,,..,,....,,,,.....,,,X----------------
------------------XXXX---X,E.E..E.............,,,,...B.,........,,..,,,A...A.......,X----------------
------------------XttXXXX-XXXXXXXXXX,,,XXXXXXX..,.,.B...,...,,,,,,,,..A.....H..E...,X----------------
------------------XE.EX.X----------X+++X-----X..,.,....,,.,,........A....H........:,X----------------
------------------XE.EXtX----------X,,,X-----X..,..,.,,..,.........XXX,,,,,XXX,,,,,X-----------------
------------------XE.EX.X----XXXXX-:.E:X-----X...,.,,...,.XXXXXXXBBX-X,,,,,XXX,,,,,X-----------------
--------------XXXXXE.EX.X----X..AX-X+++X-----X...,....,,..X-----BBBX-X:..H...EE...:X-----------------
--------------XA.AXE.EX.X----X<<.X-:.E:X--XXXX...,..,,....X-XXX-BBBX-X.,,,,,,,,,,,.X-----------------
----XXX-------X...XE.EX.X----X<<.X-X,,,X--XEXX...,,,......X-XEX-XHHX-X.,.........,.XEXH--------------
---X...XX-----X...XXXXXEX-+XXX,.AX-X.E.X--XEXXE..E......E.X-X.X-XXXX-X:,.....E.E.,.,E.X--------------
XX-X.E...XXXXXX+++XXXXX.X-E.,,,..X-:..:X--X.XXXE..XXXXXXXXXHX.X------X.,...+++...,.,E.A--------------
:.X.....E,,..:+...:.EXXEX-X.XX,.WX-X,E,X--XEX-X...X--------XXEX------X.,...+.+E..,.,E.X--------------
X,..E....,,..+......EXXEX-XHXX...X-X...X--XEX-X,,,XXXXXXXXXXX,X-XXXXXXH,...,,,...,.,E.X--------------
X....E.E.,,..+..E...EXX,XXXXXX,,,XXX,,,XXXX,X-X...XXE......XXEX-X:AHXX.,...,W,...,.,E.X--------------
+.E......,,..+,,..XXXXX:.TE.E+...+..EE...HH.X-X...XX.,,,,,.XX.X-X...XX.,...,,,.E.,.,EAX--------------
+...E....,,.+.:,..X---X,,,,,,+,+++,,,,,,,,,,X-X...XX.,..,,....X-X:E:XA.,.........,.,E.X--------------
X.E...EE.,,.+.,,..X---X.......,.,...........X-X,H,XX.,..,,,,..XXX...XA.,.....EE..,.,.AX--------------
XA.......,,.+.E,E.X---X.......,.,...........X-X,,,XX.,:.E.,,..,,+.E.XX.,.........,.,..X--------------
X,..E...E,,+.E,,..XXXXX.......,E,.....E.EE..X-X...XX.,....,,..,,+..:XA.,,,,,,,,,,,.XXXX--------------
:.X...E..,,+..A,..,.++,.......,.,...........X-X...XX.,..:.,,..,,+E..XX.E.........H.X-----------------
XX-XE....XX+..:,..,.++,.......,.,...,,,,,,,,XXXXXXXX.,.E..,,.XXXXE:.XXXXXXXXXXX,,,,X-----------------
---X...XX-X.E.,,..,.++,.......,E,...,T.,H...,..HH+.,.,...E,,AX--XXXXX---------X,,,,X-----------------
----XXX---X.......XXXXX...A...,.,...,,,,,,,,XXXXXXXX.,.:..,,.XXXXXXXXXXX:-----X,,,,X-----------------
----------X..E..E.X----X......,E,.........XXXXXXXXXX.,....,,..+,.,,,E,E.X----X.E...X-----------------
----------X,,,,,,,X---X.,.....,.,........X-X:....:XX.,,AA,A,..+,,,,,,,..XXXXX...E.:X-----------------
----------X+++++++X----:,.....,E,.......,:XX.,,,,.XX..........+,.,,,E,,.,.++,.E...HX-----------------
----------X.......X----XH,....,.,......,HXX.,..A,.XXXX.......XXX.,,.,,,EXXXXXX.,,,,X-----------------
----------X.......X-----XA,...,.,....,H.XX,,AA..,.XXXX.....XXX-X..,.....X-----XX:HHX-----------------
----------X,,,,,,,X------X,...,.,...,.XXX,.,,,AA,.XX.....,,X---XXXXXXXXX:------XX--------------------
-------XXX.......E.XXX---X:X..W.,..X:X--X,,A...,,EXXE.A.XX:X-----------------XA..X-------------------
-------E.....E.E....EX----X-XXX,XXX-X--XE....X,XX.XX,,,,X-------XXXXXXXXXXXXXX...X-------------------
-------X......E......X--------X+X-----XXXXXXXX+X-XXX..EEX-XXXXXXX...,E..,...XA...X-------------------
------X....E....E.....X-------XEX-XXXXXXXXXXXX,XXXXX:..,X-XH.HH.X,XXX,,,XXX.XX,XX--------------------
------:,,,,,,,,,,,,,,:X-------XEX-ABBB+...........XX..:,X-X.....XEX-XE..X-X.XX.X---------------------
------:,,,,,,,,,,,,,,:X-------XEX-BBB.+..........AXXH..,X-XB.BBBX.X-X,,,X-X.XX.X---------------------
------:,,,,,,,E,,,,,,:X-------XEX-B...+...........XX.H.WX-X.....XEX-X.E.X-X.XX.X---------------------
------:,,,,,,,,,E,E,,:X-------XEX-XH..XX,,,,,,XXX,XXXXXXX-XBB.BBX.X-X,,,X-X.XX.X---------------------
------:,,,,,,,,,,,,,,:X-------XXX-X...XX,,,,,,XXX.X-------XBBB.BX.X-X...X-X...EX---------------------
------:,,,,,,,,,,,,,,:XXXXXXXXXXX-XH..X...E....XXAX-------BB.B..XHX-X,,,X-XXXXXX---------------------
------X..................K,.,H,HX-X...,...,,.E.,,.X-------XX+XXXXXX-X...X----------------------------
------X...................,....HX-X...,.E.,H,..,,AXXXXXXXXXX+XXXXXXXX+++XXXXXXX----------------------
------X...................,A.A.,X-X...,...,,...,A.XX...............:....:....AX----------------------
------X...................,,,..,X-X...,..E...E.XX.XX.E..E..E.........E.E..E...X----------------------
------X...................,.E.E.X-X...X........XX.XX.........XX,XX...........HX----------------------
------X,,,,...............,,,,,,X-X...XX,,,,,,XXX,XXXXXXXXXXXXX+XXXXX,,,,,,XXXX----------------------
------X...,...BBBBB............KX-X...,...............,.,.,.,...........,,,...X----------------------
------X,,,,,,,,,,,,,XXXXX.......XXX...,...........E...,.,.,.,..H.H.H....,E,...XXXXXXXXXXXXXXXXXXX----
------X:.E.:...:...:X---X.......,+,...,...A...........,.,.,.,...........,,,...,,,,,,........+..,.XX--
------X......E...E..X---X.......XXX..E,...............,.,.,.,.................,,...,E..E..E.+.E,...X-
------X.A..E.......HX---X.......X-X...,A.......E....E.,.,.,.,...E.......,,,...,,...,........+..,...X-
------X,,,,,,,,,,,,,XX--XXXXX+++X-X.A.,...............,.,.,.,...........,E,...XXXXXXXXXXXXXXXXXX...X-
------XHHH..........+.XXX--XX+++X-X...,...............,.,.,.,...........,,,...X----------------X...X-
------X....A.E.A.E..+.,,,XXX.E,.X-X...XXXXX,,,,,,,,XXXXXXXXXXXX,,,,,XXXXX,,,XXX----------------X....X
------XHHH........E.+.,,E,E,E,E,X-X...XXXXX,,,,,,,,XXXXXXXXXXXX,,,,,XXXXX+++XXX---------------X.....X
------XXXXXXXXXXXXXXXX,,.,,,..,.X-XA..X.:,..............................,..A.,.X-------------XX.....X
----------------------X,.,E,,..X--X...X..,..............................,....,.X------XXXXXXX:.....X-
-----------------------XXXXXXXX---X...X..,..............................,.HA.,..X-----X............X-
----------------XXXXXXXXXXXXXX----X...X.E,..............................,,..,,...X----X...........X--
----------------XA.A.,.......XXXXXX...,..,..............................,,,,,,...X---X..E.....E...X--
----------------X...:,.......,,,,,,...,..,..............................,....,...X---X:..........X---
----------------X....,.....E.XXXXXX...,.E,..........E..................,.....,..E.X--X.........B.X---
----------------X....,.E.....X----X...,..,..............E..............,....,.....X--X.E........X----
----------------XE..:,...,...X----XH..,..,............................,.....,.....X-X......B.BXX-----
----------------X....,.,EEE..X----X...,.E,...................E........,.....,...E.X-X...XXXXXX-------
----------------X..,,,.,..,..X----XH..,..,..........................,,......,....X--X...X------------
----------------X..,,,,E.EE,.X----X...X.H,..........E..............,.......,...E.X--X..X-------------
----------------XH.,,,.,EEE,.X----X...X..,.......................,,.......,,.....X--XE.X-------------
----------------X..,,,...,,E.XXXXXX...X.H,..............E......,,.......,,.......X--X..X-------------
----------------X.E,,,.......,,,,,,...X..,....................,.......,,......E.X--X...X-------------
----------------XH.,,,.E.....XXXXXX...X.A,..................,,......,,..........X--X..EX-------------
----------------X..,E,....E..X----X...X.:,.................,......,,........E...X--X...X-------------
----------------X..,,,.......X----X...X..,...............,,.....,,..............X--X...X-------------
----------------X.H..,,,,,,,,X----X,,,XXXX..............,.....,,............E..X---X...:-------------
--------------XXX.......:...:X----X,,,X---XX..........,,....,,.................X--X....X-------------
--------------XA,.E.........AX----XE.EX-----X.......,,....,,..................X---X.E..X-------------
--------------X.,....E...E...X----X...X------X.....,....,,..................XX--XX....X--------------
--------------+.,...........AX----XE.EX-------XX.,,...,,......::::::::,....X---X......X--------------
--------------XXXXXXXXXXXXXXXX----X...X---------X,,,X,........:......:,...X--XB.E....X---------------
----------------------------------XE.EX---------X...XX........:....H.:,.XX--XB......:X---------------
----------------------------------X...X---------X...XX........:......:,X---X.B......X----------------
----------------------------------XE.EX---------X...X-XXXXXXXXXXX,,,,,X---X.B.....BX-----------------
----------------------------------X...X---------X..AX-----------X...XXX-XX........X------------------
----------------------------------XH.AX---------H...X-----------X,,,XXXX...E....XX-------------------
----------------------------------XXXXX---------X..AX-----------X..............X---------------------
------------------------------------------------A..AX------------X.E.E........X----------------------
------------------------------------------------A..AX------------X........:.XX-----------------------
------------------------------------------------A..AX-------------X........X-------------------------
------------------------------------------------A...X-------------X......XX--------------------------
------------------------------------------------X..AX--------------XXXX,X----------------------------
------------------------------------------------A..AX-----------------X.X----------------------------
------------------------------------------------A..AX-----------------X..X---------------------------
------------------------------------------------A..AX-----------------X..X---XXX---------------------
------------------------------------------------X...X------------------X..X-X..X---------------------
------------------------------------------------X..EX------------------X...X....X--------------------
------------------------------------------------H...X-------------------X...E.B.X--------------------
------------------------------------------------H..EX-------------------X.....B.X--------------------
------------------------------------------------H...X--------------------X...B.X---------------------
------------------------------------------------H..EX--------------------X.E...X---------------------
------------------------------------------------X+++X---------------------X..XXX---------------------
------------------------------------------------X+++X---------------------XXX------------------------
-----------------------------------------------XX,,,XX-----------------------------------------------
--------------------------------------------XXX.......XXX--------------------------------------------
-----------------------------------------XXX.............XXX-----------------------------------------
---------------------------------------XX,,,,,,,,,,,,,,,,,,,XX---------------------------------------
--------------------------------------X.......................X--------------------------------------
-------------------------------------X.........................X-------------------------------------
------------------------------------X...........................X------------------------------------
-----------------------------------X.............................X-----------------------------------
----------------------------------X.......,,,,,.......,,,,,,......X----------------------------------
---------------------------------X.......,....,.......,.....,,.....X---------------------------------
--------------------------------X........,....,.......,...E...,,....X--------------------------------
-------------------------------X........,.....,........,....E...,,...X-------------------------------
------------------------------X........,...E..,...,....,.EA.......,...X------------------------------
------------------------------X........,......,...,....,....EE....,...X------------------------------
------------------------------X.......,..E....,...,,...,..E..A.E..,...XX-----------------------------
------------------------------X......,........,..,.,....,..A......,...,XX----------------------------
------------------------------X......,..E...E.,..,..,...,..EE.A...,...,,X----------------------------
------------------------------X.....,........,...,..,...,....E.E..,...,XX----------------------------
-----------------------------XX....,..E......,...,E..,...,..E.....,.E.XX-----------------------------
---------------------------XXX,....,.....E..,...,..E.,...,...E....,...X------------------------------
---------------------------XLL,...,........,....,E....,...,....E..,...X------------------------------
---------------------------XXX,.E.,..E..A..,...,....E.,..E,..EE...,E..X------------------------------
-----------------------------XX....,......,.E.,.E.E....,...,.....,....XX-----------------------------
------------------------------X....,...A.,...,.E...,,,,,...,.E...,....,XX----------------------------
------------------------------X.E.E.,....,E.,...,,,....,,.E.,...,.E.E.,LX----------------------------
------------------------------X.....,...,..,,,,,....EE......,...,.....,XX----------------------------
------------------------------X.E.E..,.,..E...E.E.E........E.,.,..E...XX-----------------------------
------------------------------X......,.,.....................,.,......X------------------------------
------------------------------X...E.E.,.E...,,,,,,,,,,,,,.....,.E.....X------------------------------
-------------------------------XX...........,::::.K.::::,...........XX-------------------------------
---------------------------------X....E.....:.,,,,,,,,,:,..........X---------------------------------
----------------------------------XX........:.,...K...,:,........XX----------------------------------
------------------------------------X...E...:.,.,,,,,.,:,.......X------------------------------------
-------------------------------------XX.....:.,.,.K.,.,:,.....XX-------------------------------------
---------------------------------------X....::::,...::::,....X---------------------------------------
----------------------------------------XX...A.H,...,H.A...XX----------------------------------------
------------------------------------------XXXXXXX,,,XXXXXXX------------------------------------------
------------------------------------------------X...X------------------------------------------------
------------------------------------------------X,,,X------------------------------------------------
------------------------------------------------X,,,X------------------------------------------------
------------------------------------------------X...X------------------------------------------------
------------------------------------------------X,,,X------------------------------------------------
------------------------------------------------X,,,X------------------------------------------------
------------------------------------------------X...X------------------------------------------------
------------------------------------------------X,,,X------------------------------------------------
------------------------------------------------X,,,X------------------------------------------------
------------------------------------------------X...X------------------------------------------------
------------------------------------------------X,,.X------------------------------------------------
------------------------------------------------X,,>X------------------------------------------------
------------------------------------------------X...X------------------------------------------------
------------------------------------------------X...X------------------------------------------------
------------------------------------------------X...X------------------------------------------------
------------------------------------------------X...X------------------------------------------------
------------------------------------------------X,,,X------------------------------------------------
------------------------------------------------XXXXX------------------------------------------------
