----------------------------------------------------------------------------------------------------------------XXXXXXXXXXXXXXXXXXXXXXXXXXXXXXXXXXXX
----------------------------------------------------------------------------XXXXXXXXXXXXXXXXXXXXXXXXXXXXXXXXXXXX,,,,,,,,,,,,,,,,,,,,,,,,,,,,,,,,,,,X
----------------------------------------------------------------------------X..................,,,,,,,,,,,,,,,,,..................................,X
------------------------------------XXXXXXXXXXXXXXXXXXXXXXXXXXXXX-----------X...XXXXXXXXXXXXX..,XXXXXXXXXXXXXXX,,,,,,,,,,,,,,,,,,,,,,.............,X
------------------------------------X,,,,,,,,,,,,,,:::,,,,,,,,,,X-----------X...X-----------X..,X-------------X,,...................,.............,X
------------------------------------X,,,,,,,,,,,,,,,,,,,,,,,,,,,X-----------X...X-----------X..,X-------------X,,.,,,,,,,,,,,,,,,,,.,.............,X
------------------------------------X.........:.:...:.::........X-----------X...X-----------X..,X-------------X,,.,...............,.,.............,X
------------------------------------X.........:.:.:.:...........X-----------X...X-----------X..,X-------------X,,.,.,,,,,,,,,,,,,.,.,.............,X
------------------------------------X,,,,,,,,,::,,,,,::,,,,,,,,,X-----------X...X-----------X..,X-------------X,,.,.,...........,.,.,.............,X
------------------------------------X............:..:...........X-----------X...X-----------X..,X-------------X,,.,.,...........,.,.,.............,X
------------------------------------X...........................X-----------X...X-----------X..,X-------------X,,.,.,...........,.,.,.............,X
------------------------------------XXXXXXXXXXXXX,,,XXXXXXXXXXXXX-----------X...X-----------X..,X-------------X,,.,.,...........,.,.,.............,X
------------------------------------------------X>>>X-----------------------X...X-----------X..,X-------------X,,.,.,...........,.,.,.............,X
------------------------------------------------X...X-----------------------X...X-----------X..,X-------------X,,.,.,,,,,,,,,,,,,.,.,.............,X
------------------------------------------------X...X-----------------------X...X-----------X..,X-------------X,,.,...............,.,.............,X
------------------------------------------------X...X-----------------------X...X-----------X..,X-XXX---------X,,.,,,,,,,,,,,,,,,,,.,.............,X
-----------------------------------------------XX...XX---XXXXXXXXX----------X...X-----------X..,X-------------X,,...................,.............,X
-----------------------------------------------X,...,X---X,,,,,,,XX---------X...XXXXXXXXXXXXX..,XXXXXXXXXXXXXXX,,,,,,,,,,,,,,,,,,,,,,.............,X
-----------------------------------------------XX...XX-XXX,,,,..E.XX--------X..................,,,,,,,,,,,,,,,,,..................................,X
------------------------------------------------X,,,X--:,,E.E,.....X--------X,,,,,,,,,,,,,,,,,,,,,,,,,,,,,,,,,,,,,,,,,,,,,,.......................,X
------------------------------------------------X,,,X--XXX,,,,....XX--------X.............................................,,,,,,,,,,,,............,X
------------------------------------------------XEEEX----XX,,,XX,XX---------X.............................................,,XXXXXXXXX,............,X
------------------------------------------------X,,,XX----X...XX,X----------X.............................................,,X-------X,............,X
------------------------XXXXXXXXXXXXXXXXXXXXXXXXX,,,XXXXXXX,,,XX,XXXXXXXXXXXX,,,,,,,,,,,,,,,,,,,,,,,,,,,,,,,,,,,,,,,,,,...,,X-------X,............,X
------------------------X.............................................................................................,...,,X-------X,............,X
------------------------X...........................................................................................E.,...,,X-------X,............,X
------------------------X.............................................................................................,...,,X-------X,............,X
------------------------X...E......................................................E.......,,,,,,.....................,...,,X-------X,............,X
------------------------X............................E...................................,,.,,,,.,,...................,...,,X-------X,............,X
------------------------X................................,,,,,,,,,,,,,,,,,,,,,,,........,.,,....,,.,,.................,...,,X-------X,............,X
------------------------X................................,.,,,,,,,,,XX,,XX,,,,.,........,,.,,,,...,,.,,...............,...,,X-------X,............,X
------------------------X................................,,XXXXX,XXXXXXXXXXX,,,,.......,,.,,,.:,,...,,.,,.............,...,,X-------X,............,X
------------------------X.......,,,,,,,,,,,,,,,,,,,......,,X---XLX-------XX,.,,,.......,,.,HE,,,.,....,,.,............,...,,X-------X,............,X
------------------------X.......,.................,......,,X---X.X------X,,,,X,,.......,,.,,,,,,,,XXL...,,,,..........,...,,X-------X,.XXXXXXXXX..,X
------------------------X.......,.XXX,,,,,,,,,XXX.,......,,X---XEX----XX,,,XXX,,.......,,.:,,.,,..XXLLL...,,,,........,...,,X-------X,.X-------X..,X
------------------------X.......,.X-X....H....X-X.,......,XX---X,X----Xt,XX--XX,.......,,.,,,,..,...,LXX,...,,,,......,...,,X-------X,.X-------X..,X
------------------------X.......,.XXX,,,,,,,,,XXX.,......,XX---XEX----XTXX---XX,.......,,.,,,,..,.....XX,,,...,,,.....,...,,X-------X,.X-------X..,X
------------------------X.......,.,.,HHHHHHHHH,.,.,......,HX---X,X----XXX----H,,.......,,.,...,,.,..,,,..,,,,...,.....,...,,XXXXXXXXX,.X-------X..,X
------------------------X.......,.,.,H,,,,,,,H,.,.,......,,X---XEX-----------X,,.......,,.,.....,...,:,...,,:,..,,....,...,,,,,,,,,,,,.X-------X..,X
------------------------X.A.....,.,.,H,:...:,H,.,.,......,XX---X,XXXXXXXXXXX-XX,.......,,.,........E,.,...,,,,,.,,....,...,............X-------X..,X
------------------------X.......,.,.,H,.,,,.,H,.,.,......,XX---XE,E,E,E,E,EX-XX,.......,,,,...,,,,,,,.,,,.,..,,.,,....,...,............X-------X..,X
------------------------X.W.....,.,H,H,.,:,.,H,H,.,......,HX---XXXXXXXXXXX,X-H,,.......,,,,..W,.........,.,.E,K.,,....,...,............XXXXXXXXX..,X
------------------------X.......,.,.,H,.,,,.,H,.,.,......,XX-------------XEX-XX,.......,,.,...,,,,,,,.,,,.,,,,,.,,....,...,,,,,,,,,,,,............,X
XXXXXXXXX---------------X.A.....,.,.,H,:...:,H,.,.,......,XX---XXXXXXXXXXX,X-XX,.......,,.,.....,..E,:,...,,:,,.,,....,...,,XXXXXXXXX,............,X
X.......X---------------X.......,.,.,H,,,,,,,H,.,.,......,HX---XE,E,E,E,E,EX-H,,.......,,.,....,,...,,,..,,,,...,,....,...,,X-------X,............,X
X.......X---------------X.......,.,.,HHHHHHHHH,.,.,......,,X---X,XXXXXXXXXXX-X,,.......,,.,,,.,..,.....X,,,...,,,.....,...,,X-------X,............,X
X.......X---------------X.......,.XXX,,,,,,,,,XXX.,......,XX---XEX-----------XX,.......,,.,,,,..,....,XX,...,,,,......,...,,X-------X,............,X
X.......X---------------X.......,.X-X....H....X-X.,......,XX---X,XXXXXXXXXXX-XX,.......,,.:,,.,,...XLLLX..,,,,........,...,,X-------X,............,X
X.......X---------------X.......,.XXX,,,,,,,,,XXX.,......,,X---XE,E,E,E,E,EX-X,,.......,,.,,,,,,.,XXL...,,,,..........,...,,X-------X,............,X
X.......X---------------X.......,.................,......,,X---XXXXXXXXXXX,X-X,,.......,,.,,E,,,,.X...,,.,............,...,,X-------X,............,X
X.......X---------------X.......,,,,,,,,,,,,,,,,,,,......,,X-------------XEX-X:,.......,,.,H,.:,,,..,,.,,.............,...,,X-------X,............,X
X.......X---------------X................................,,XXXXXXXAXXAXXXX,XXX,,.......,,..,,,,,..,,.,,...............,...,,X-------X,............,X
X.......X---------------X................................,.,,,,XX,,XX,XX,,,,,,W,........,,......,,.,,.................,...,,X-------X,............,X
X.......X---------------X........................E.......,,,,,,,,,,,,,,,,,,,,,,,.........,,,,,,,.,,...................,...,,X-------X,............,X
X.......X---------------X..................................................................,,,,,,.....................,...,,X-------X,............,X
X.......XXXXXXXXXXXXXXXXX.............................................................................................,...,,X-------X,............,X
X....................,.,,...E.........................................................................................,...,,X-------X,............,X
X....................,..,.....................................................................................E.......,...,,XXXXXXXXX,............,X
X....................,..,................................:............................................................,...,,,,,,,,,,,,............,X
X....................,..,...............................,,,,,,,,,,,,,,,,,,,,,,,,,.....................................,...,............XXXXXXXXX..,X
X....................,..,...............................,W.....................,,.....................................,...,............X-------X..,X
X....................,.,,.........,,,,,,,,,,,,,.........,.XXXXXXXXXXXXXX,,,,XXX,,.....................................,...,.XXXXXXXXX..X-------X..,X
X....................,.,,........,.............,........,.X,,H,E,E,E,,+,,,,.,AX,,.....................................,...,.X-------X..X-------X..,X
X.......XXXXXXXXXXXXXXXXX.......,...,,,,,,,,,...,.......,.X,,,,,:,,,,XXX,E,E,XX,,...........XX,,,,,,,,,,,,,,XX,.......,...,.X-------X..X-------X..,X
X.......X---------------X......,...,.........,...,......,.X,XXXXXXXXXX-XEE,,,XX,,...........XX,.............XX,.......,...,.X-------X..X-------X..,X
X.......X---------------X.....,...,....,,.....,...,.....,.X,XXXXXXX----X,,,,KXX,,...........,,,.............,,,.......,...,.X-------X..X-------X..,X
X.......X---------------X.....,..,....,XX,.....,..,.....,AX,,,H,EE.XXXXXE,,,.XX,,...........,.................,.......,...,.X-------X..X-------X..,X
X.......X---------------X.....,.,....,,XX,,.....,.,.....,.X,XXXXXX,,,,,,,,,W.XX,,...........,...XXX,XXX,XXX...,.......,...,.X-------X..XXXXXXXXX..,X
X.......X---------------X.....,.,....E,XX,E,....,.,.....,AX,XX.,,,,,,,,,,E,,,XX,,...........,...X-XEX-XEX-X...,.......,...,.X-------X.............,X
X.......X---------------X.....,.,...,,,:X:,,,...,.,.....,.X,XXEXXXXXXXXXXXXXXXX,,...........,...XXXXXXXXXXX...,.......,...,.X-------X.............,X
X.......X---------------X.....,.,..XXXXXXXXXX,..,.,.....,AX,XX,X------X,XXXKXXX,,...........,...,EXHHHHHXE,...,.......,...,.X-------X.............,X
X.......X---------------X.....,.,.,XXXXXXXXXX,,.,.,.....,.X,XX.X--XXXXXEXX,,,XX,,...........,...XXXHttHHXXX...,.......,...,.XXXXXXXXX.............,X
X.......X---------------X.....,.,,.,,..XX...,..,,.,.....,AXHXX,XXXX,,,X,XX,,,XX,,....E......,...X-XHtTHH--X...,....E..,...,.......................,X
X.......X---------------X.....,.,..,,.EXX.E.,...,.,.....,.XXXX..,,..E..E.E,,,XX,,...........,...XXXHHHHHXXX...,.......,...,.......................,X
X.......X---------------X.....,,,..,,..XX...,...,,,.....,.X..,:.,,,L,,,,,,,,.XX,,...........,...,EXHHHHHXE,...,.......,...,.......................,X
X.......X---------------X.....,.,..XXXXXXXXXX...,.,.....,.XE.,..,,,H,H,H,H,H.XX,,...........,...XXXXX-XXXXX...,.......,...,.....,,,,,,,,,,,.......,X
X.......X---------------X.....,.,..XXXXXXXXXX...,.,.....,.X.XX.::..E.E.E.E.E.XX,,...........,...X-XEX-XEX-X...,.......,...,.....,,,,,,,,,,,.......,X
X.......X---------------X.....,.,..,,..XX...,...,.,A....,.XAXX..............EXX,,...........,...XXX,XXX,XXX...,.......,...,.....,,.......,,.......,X
X.......X---------------X.....,.,..,,.EXX.E.,...,.,.....,.X.XX.HH,..X.HH,.HH,XX,,...........,.................,.......,...,.....,,.......,,.......,X
X.......X---------------X.....,.,..,,..XX...,...,.,A....,.XAXX.H:,,,XXH:,.H:,XX,,...........XX,.............XX,.......,...,.....,,.......,,.......,X
X.......X---------------X.....,.,..XXXXXXXXXX.W.,.,.....,.XAXX.,E,,,,X,,,E,,EXX,,...........XX,.............XX,.......,...,.....,,.......,,.......,X
X.......X---------------X.....,.,..XXXXXXXXXX...,.,A....,.XXXXXXXXX,,XXXXXXXXXX,,...........,,,,,,,,,,,,,,,,,,,.......,...,.....,,.......,,.......,X
X.......X---------------X.....,.,..,,..XX...,...,.,.....,.XXXXXXXXX,,,XXXXXXXXX,,.....................................,...,.....,,.......,,.......,X
X.......X---------------X.....,.,..,,.EXX.E.,.:.,.,A....,.,.......,,,,,...W.:.,,,.....................................,...,.....,,.......,,.......,X
X.......X---------------X.....,.,..,,..XX...,...,.,.....,.XX.................XX,,.....................................,...,.....,,.......,,.......,X
X.......XXXXXXXXXXXXXXXXX.....,.,..XXXXXXXXXX...,.,.....,.XX,,,,,,,,,,,,,,,,,XX,,.....................E...............,...,.....,,.......,,.......,X
X....................,.,,.....,,,..XXXXXXXXXX...,,,.....,<,,,,,,,,,,,,,,,,,,,,,,,.....................................,...,.....,,.......,,.......,X
X....................,..,.....,.,..,,..XX...,...,.,.....,,,,,,,,,,,,,,,,,,,,,,,,,.....................................,...,.....,,.......,,.......,X
X....................,..,.....,.,,.,,.EXX.E.,..,,.,...................................................................,...,.....,,.......,,.......,X
X....................,..,.....,.,,.,,..XX...,.,.,.,.....................................XXXXXXXXXXXXXXXXXXXXXXXX,.....,...,.....,,.......,,.......,X
X....................,..,.....,.,.,XXXXXXXXXX,..,.,.....................................X----------------------X,.....,...,.....,,.......,,.......,X
X....................,.,,.....,.,..XXXX:X:XXX,..,.,.................................E...X-:XXXXXXXXXXXXXXXXXXHXX,.....,...,.....,,.......,,.......,X
X....................,.,,.....,.,...,,,XX,,,,...,.,.....................................X-X...................XX,.....,...,.....,,.......,,.......,X
X.......XXXXXXXXXXXXXXXXX.....,.,....E,XX,E,....,.,.....................................X-X.A...A...A...A...A.XX,.....,...,.....,,.......,,.......,X
X.......X---------------X.....,.,.....,XX,......,.,.....................................X-X...................XX,.....,...,.....,,,,,,,,,,,.......,X
X.......X---------------X.....,..,.....XX......,..,.....................................X-X...A...A...A...A...XX,.....,...,.....,,,,,,,,,,,.......,X
X.......X---------------X.....,...,...........,...,.........,,,,,,,,,,,,,,,,,...........X-X...................XX,.....,...,.......................,X
X.......X---------------X.....,....,.........,....,.........,....XX...XX...,,...........X-X.A...E.E.E.E.E.E.E.XX,.....,...,.......................,X
X.......X---------------X......,....,,,,,,,,,....,..........,....XX...XX...,,...........X-X...................XX,.....,...,.........X.............,X
X.......X---------------X.......,...............,...........,..E.XX.E.XX.E.,,...........X-X....,,,,,,,,,,,,,,,XX,.....,...,........X-X............,X
X.......X---------------X........,.............,............,...AXX...XA...,,...........XXX..E.,..............+,,.....,...,.......X---X...........,X
X.......X---------------X.........,,,,,,,,,,,,,.............,XXXXXX+++XXXXXX,...........XX,:W..,...E..........+,,.....,...,......X-----X..........,X
X.......X---------------X..E................................,XXXXXX+++XXXXXX,...........XXX..E.,..............+,,.....,...,.....X-------X.........,X
X.......X---------------X...................................,....++,,.++...,,...........X-X....,,,,,,,,,,,,,,,XX,.....,...,....X--------X.........,X
X.......X---------------X...................................,..E.++,W.++.E.,,...........X-X...................XX,.....,...,...X----------X........,X
XXXXXXXXX---------------X.......XX...XX...XX...XX...........,....++...++...,,...........X-X.A...E.E.E.E.E.E.E.XX,.....,...,..X------------X.......,X
------------------------XXX,,,XXXXXXXXXXXXXXXXXXXXX.........,XXXXXX+++XXXXXX,...........X-X...................XX,.....,...,.X--------------X......,X
--------------------------X,,,XXXXXXXXXXXXXXXXXXX-X.........,XXXAXX+++XAXXXX,...........X-X...A...A...A...A...XX,.....,...,X----------------X.....,X
--------------------------X.W.XX.:...,....,..,..XXXX........,....XX...XX...,,...........X-X...................XX,.....,...,.X--------------X......,X
-------------------XXXXXXXX,,,XX.....,..E.,..,.E.XXX........,..E.XX.E.XX.E.,,...........X-X.A...A...A...A...A.XX,.....,...,..X------------X.......,X
-------------------X,,,,,...:........,,..,,..,,..XX.........,....XX...XX...,,...........X-:..................HXX,.....,...,...X----------X........,X
------------------X,,,,,,:...XX,,XX..XX..+X..XX..XX....E....,,,,,XX,,,XX,,,,,....E......X-XXXXXXXXXXXXXXXXXXXXXX,.....,...,....XX-------X.........,X
------------------H,,,,,,....XX..XX..XX,,+X,,X:,XXX.........,,,,,,,,,,,,,,,,,...........XXXXXXXXXXXXXXXXXXXXXXXX,.....,...,......X-----X..........,X
------------------X,,,,,,....,..E.,,,,,,,.,:,,:.XXXX....................................,,,,,,,,,,,,,,,,,,,,,,,,,.....,...,.......X---X...........,X
-------------------X,,,,,..E.,,..,,,,...,.,,,,:..XXX..................................................................,...,........X-X............,X
-------------------XXXXXXXX..XX..XX..XX,,+X,,XX.EXX................................................................E..,...,.........X.............,X
------------------------XXX..XX,,XX..XX..XX..XX..XX...................................................................,...,.......................,X
------------------------XE,....E...E.,..E.,.E.:..XX,,,,,,,,,,,,,,,,,,,,,,,,,,,,,,,,,,,,,,,,,,,,,,,,,,,,,,,,,,,,,,,,,,,,...,.......................,X
------------------------XX,..........,....,.....XXXX......................................................................,.......................,X
-------------------------XXXX,,,XXX:XXXXXXXXXXXXX-XX......................................................................,.......................,X
----------------------------X,,,XX-----XX---------X.......................................................................,.......................,X
------------------------XXXXX,,,,XXXXXXXXXXXXXXXXXX,,,,,,,,,,,,,,,,,,,,,,,,,,,,,,,,,,,,,,,,,,,,,,,,,,,,,,,,,,,,,,,,,,,,,,,,.......................,X
------------------------X..........................................................................................................X..............,X
------------------------X..............................,,,,,,,,,,,,,,,,,,,......................................,.................X-X.............,X
------------------------X..............................,XXXXXXXXXXXXXXXXX,.....................................,X,...............X---X............,X
------------------------X......,.......................,X---------------X,....,,,,,,,,,,,,,,,,,,,,,...........,X-X,.............X-----X...........,X
------------------------X.....,.,......................,X---------------X,....,...................,..........,X---X,...........X-------X..........,X
------------------------X....,.,.,.....................,X---------------X,....,.XXXXXXXXXXXXXXXXX.,.........,X-----X,..........X--------X.........,X
------------------------X...,.,.,.,,...................,X---------------X,....,.X---------------X.,........,X-------X,........X----------X........,X
------------------------X..,.,...,..,..................,X---------------X,....,.X---------------X.,.......,X--------X.,......X------------X.......,X
------------------------X.,..,....,..,.................,X---------------X,....,.X---------------X.,......,X----------X.,....X--------------X......,X
------------------------X,..,,,,...,..,................,X---------------X,....,.X---------------X.,.....,X------------X.,..X----------------X.....,X
------------------------X..,..,.,...,..,...............,X---------------X,....,.X---------------X.,....,X--------------X.,..X--------------X......,X
------------------------X,..,..,,..,..,................,X---------------X,....,.X---------------X.,...,X----------------X.,..X------------X.......,X
------------------------X.,..,..,,,..,.................,XXXXXXXXXXXXXXXXX,....,.X---------------X.,....,X--------------X.,....X----------X........,X
------------------------X..,..,.,...,..................,,,,,,,,,,,,,,,,,,,....,.X---------------X.,.....,X------------X.,......X-------XX.........,X
------------------------X...,..,..,,.....,,,,,,,,,,,,,,,,,,,,.................,.X---------------X.,......,X----------X.,........X-----X...........,X
------------------------X....,...,.......,XXXXXXXXXXXXXXXXXX,.................,.X---------------X.,.......,XX-------X.,..........X---X............,X
------------------------X.....,.,........,X----------------X,.................,.X---------------X.,........,.X-----X.,............X-X.............,X
------------------------X......,.........,X----------------X,.................,.XXXXXXXXXXXXXXXXX.,.........,.X---X.,..............X..............,X
------------------------X................,X----------------X,.................,...................,..........,.X-X.,..............................,X
------------------------X................,X----------------X,.................,,,,,,,,,,,,,,,,,,,,,...........,.X.,...............................,X
------------------------X................,X----------------X,..................................................,.,................................,X
------------------------X................,X----------------X,...................................................,.................................,X
------------------------X................,X----------------X,.....................................................................................,X
------------------------X................,XXXXXXXXXXXXXXXXXX,.....................................................................................,X
------------------------X................,,,,,,,,,,,,,,,,,,,,.....................................................................................,X
------------------------XXXXXXXXXXXXXXXXXXXXXXXXXXXXXXXXXXXXXXXXXXXXXXXXXXXXXXXXXXXXXX,,,,,,,,,,,,,,,,,,,,,,,,,,,,,,,,,,,,,,,,,,,,,,,,,,,,,,,,,,,,,X
--------------------------------------------------------------------------------------XXXXXXXXXXXXXXXXXXXXXXXXXXXXXXXXXXXXXXXXXXXXXXXXXXXXXXXXXXXXXX
