--------------XXX------------------------------------------------
-------------X...XXX---------------------------------------------
------------X,....t.X--------------------------------------------
----------XX..,,,.t.X--------------------------------------------
----------X.....:,,,.X-------------------------------------------
---------X..........,X-------------------------------------------
---------X...........X-------------------------------------------
--------X....E.A......X------------------------------------------
--------X........,,...X------------------------------------------
--------XE..,,,..,,..A.X-----------------------------------------
XXX-----X..,..,E.,H,...X-----------------------------------------
X..XXXXX...,K.,.,..,E...X----------------------------------------
X....E....E,..,.,.,.....X----------------------------------------
X,XXX.....,...,,,,.E,,...X---------------------------------------
X.X-X...:.,.....,...,H,..X---------------------------------------
XXX-X......,,,..,E.,..,..X------------------------------XXXX-----
---X.......,.E,..,,...,..X------------------------------XE.X-----
--X.A....E....,,..,..,...X------------------------------X..X-----
-X..........E.A.,,,..,...X------------------------------E.EX-----
-X.E....E.,,,,,....,,....X--XXX---:X--------------------X.EX-----
X........,....,,,,.......X--X.X---XXXXXX--------XW------X,,X-----
X.......E,,..,.,,,,,.....X--XtX---X...EX----XXXXXXX:X--:X,,XXXX:X
X.:.......E,,,,EE,,.,...X---X,X---H....X----<.......X-X.....B...X
X....,,,...,,,.,A,,.A,..XXXXX,XXXXX....XXXXXX.......XX......,.EBX
X....,..,H.,,A,,.E.,,...A..,....,L.....,,.,.,.......,E......,.,BX
X...,W..,.,,..,.,.E.....,..,....,LE...E,,:,.,<....E.,.......,,WAX
X...,.,,.,,,.E.,,E......A..,....,L.....,,.,.,.......,E.....BB.,.X
X...,,E.,.,...H,,......XXWXXX,,,XXX....XXXXXX.,,,...XX.....B,BEBX
X....E.E,,.E...,,.E....X-X--X,,,X-H....X----X<,.,<.:X-X:.,,.,...X
-X.....A,,...,,.,......X----XLL,X-X...EX----XXXXXXXXX--XXX.XXXX:X
-X......,W.E,.T,.......X----X,,,X-XXXXXX----XXXXXXX------X.X-----
--X.....,,...,,........X----X>>>X-:X--------XEXXX.XXXXXXXX.X-----
---XX................E..X---X...X-------XXXXXXXAXE+E..EAXXEX-----
-----XX........E.......EX---XXXXX-----XXXE.:.XXEX.XXXXXXXX,X-----
-------XX........T..XX.:.X-----------XE.XXXXXXXXX.X------X.X-----
---------X..X......X-XXXXX----------X...XXX-XXXXX.XXXXXXXX+HX----
----------XX-XX....X---------------X:...XEX-XXXXX..E..H:,E..X----
---------------XX,X---------------X.....X.XXXXXXX.XXX,,,,...X----
----------------X.X---------------E.E:..E.E......EX-E,,E....X----
----------------XXX---------------X.....X.XX.XXXX.X-X,,...E.X----
-----------------------------------X:...X.XX.X--XXX-X,,.....X----
------------------------------------X...X.XX.XXX----X,,.....X----
-------------------------------------X.EXEXX...E----X,,.....X----
--------------------------------------XXXHXXXXXX-XXXX,,.E.E.X----
-------------------------------------------XE----:W.E,,....AX----
-------------------------------------------XX-----XXXXXXXXXXX----
