--------------------------------------------------------------XXXXXXXXXXXXXXXXXXXXXX--
-------------------------------------------------------------X:,,,,,AXXA,,,HHA,,,,:X--
----------------------------------------------------------XXXX,,,,,,,,,,,,,,,,,,A,,X--
----------------------------------------------------------X.t:E,,.H,,H,,HHH,H,E,A,,X--
----------------------------------------------------------XXXX:,,,,.,,,,,,,,H,,,,E,X--
-------------------------------------------------------------XX,,,,,AXXAXXXHXAXXXX:X--
---------------------------------------------------------------XX,XXXXHXX-XXXXXXXXX---
---------------------------------------------------------------XX,X--------XHXXHWHXHX-
----------------------------------------------------XXXXX------XXAX--------H.E.X,X.E.X
---------------------------------------------------X,,,,X------XX,X--------X,,:A:A.,HX
---------------------------------------------------X,.H,X--XXXXXX,XXXXXX---X,,,,,,,.,X
---------------------------------------------------X,AA,X--XH,,,,,,,,.HX---X,,,,,,,,,X
--------------------XXXXXXXXX----------------------XXX,XX--X.E,,,,,,,EHX---XH,,,,,,,,X
--------------------X,,,,,,,X---------------------XXXX,XXX-X.,,.,,:.,.XX---X,:AA..EH,X
--------------------X,......X---------------------X,,,,,,XXX,,,,,,,,,,,XXXXX,..,,,,,,X
--------------------X,..,,,,X---------------------XH,,,,,,.,,:,,,,,,.,,,,,,,,.,,,,..,X
--------------------X,..XXXXXXXXXXXXXXXXXX--------XH,,A,,,.,,,,,,K,,E,,,,,,,,.,,H,.E,X
--------------------X,..X---X,,,,,,XX,,,,,X-------XH,,,,,,.,,,,,,,,,,,,,,,,,,.,,,:.,,X
--------------------X,..X---X,..H.XXX,.H.,X-------XXXX,X,XXX,,,,:,,,,,XXXXXX,,....E,,X
--------------------X,..X---X,....:XX,.:.,X--------XXX+XXX-X.,:,..,,,.XX---X,,,,,,,H,X
--------------------X,..X---X,.E...H,..E.,X--------X,,,,,X-X.E,,,,,,,A,X---XA,,,,,,,,X
--------------------X,..X---X,..,,,:,,:..,X--------X,,,,AX-X,XXX,,,XX,,X---X,,,,,,,.,X
--------------------X,..X---X,,,,XX:XX,,,,X---XXXXXX,,,,,X-XXX-XX,X-XXXX---X,,,A+A,,,X
--------------------X,..X---X,:,,XXXXX,,,,X---HHHHXH,..,AX-----XX,X--------H........HX
--------------------X,..X--XX,,,,XXXXX,,,,XXX-HHHHXX,.E,,X-----XX,X--------XHEXXXX.HXX
--------------------X,..X--X,,,,,,,,,,,,,,,,X-XX+XXX,..,AX-----XX,X---------XXX---XXX-
--------------------X,..X--X,..............,XXXXHXXX,,,,,X----XXX,XXXXXXX-------------
--------------------X,..X--X,,..,,....E.:A:XX,,,,,,,,,,,,X---X:,,E,A,,E,X-------------
--------------------X,..X--X,A.H,,..,,,....XX,,,...,,...AX--XX,,,,,,,,,,XX------------
--------------------X,..X--X,W,,,.,.,.,....,+,,,.ET,,..,,X--XX,EA,,W:A,THX------------
--------------------X,..X--X,,,,,,:.,,,,...XX,,,,,,,,.,:XX---X:,,,,,,,,,XX------------
--------------------X,..X--X,,,,,,,,.H.,,,.,X,,,,,,,,,,X-----XX,,EXA,XE,X-------------
--------------------X,..X--X,,,,,,,,...A,,.,XXXAHXXHXAXX-------XXXXXXXXX--------------
--------------------X,..X--X,,,,,,,,,,,,,,,,X----XXXXXXX------------------------------
--------------------X,..X--XXXX,,,XXXXXXXXXXX---XX,,,,,XX-----------------------------
--------------------X,:.XX----X,,,X-------------X,..E..,XX----------------------------
--------------------X,..,XXXXXX,,,XX------------X:,H.,H,:X----------------------------
--------------------X,.......XX,..,X------------XXX,,,XXXX----------------------------
--------------------X,.......XXX,E,XXXX---------XXX,,,XXX-----------------------------
--------------------X,.......XXX,,,,,,X---------X:,,A,,,:X----------------------------
--------------------X,..:....XX,,,,,E:X---------X,EHA.H.XX----------------------------
--------------------X,.......,,A.,:AXXX---------X,,,..,,XX----------------------------
--------------------X,.......,,A.,,,XXX---------XXX,,,XXX-----------------------------
--------------------X,..:....,,A.,,,,:X-----------XXLXX-------------------------------
--------------------X,.......XXX,,,,EAX------------X,XXX-XXXXXXXXXXX------------------
--------------------X,.......XXX,.,,,,X------------X,,,,XX,XX,,,,,.HX-----------------
--------------------X,.......XX,,.AXXXX------------X,E,,,,,,,,,,,,..X-----------------
--------------------X,.......XX,,,,X--XXX----------X,H,,,,,,,,,H,,.EX-----------------
--------------------X,.......XX,,,XXXXX,XXX--------X,T,E,,,,E,,.,,.HX-----------------
--------------------X,.......XX,,,XX,,,<,,X--------X,.,,,,,,,,,,,XXXXXX-XXX-----------
--------------------X,.......XX,,,XX,<...<XXXXXXXX-X,A,,,,A,,,,,XXXXX,XXX,XX----------
--------------------X,.......X,,,,XXX,.<.XXXH,,,,X-X,,,,,,,,,,,,X-X,,.,,:.,,X-XX>XX---
--------------------X,.......XX,,,XXX,,,,XXX.,,,,XXX,,,,,,,,,,,,XXX,.:,,,,:,XXX,,,X---
--------------------X,.......XX,,,.,,,,,,,,,W,,,,,,,,,,,,++,,,,,,,,,,,,,,,:,,,,,,,X---
--------------------X,.......XX,,,.H,,,T,,A,.,,,,,,,,,,,A+KA,A,,,,,,,,,:,E.,,,,,E,X---
--------------------X,.......XX,,,,XX,::,,XX.,,,,,,,,,,,,,,,,,,,,,,:.,,,,,.,,,,,:,X---
--------------------X,.:.....X,,,,XXX,.:.:XX.,,,,XXX,,,,,,,,,,:,XXX,.,,,:.,,XXXX,XX---
--------------------X,.......XX,,,,XH,,,,AXXH,,,,X-X,.,,,,,,,,,,X-XXX,XXX,XXX-XXXXX---
--------------------X,.......XXXXXXXXX,,,XXXXXXXXX-X,A,,,,A,,,,,,XXXXXXXXXXX----------
--------------------X,.......,......,,,,,,,,,,,,,X-X,,,E,,,,E,,.,,.HX-----------------
--------------------X,:.......,,,,,,.............X-X,T,,,,,,,,,.,,..X-----------------
--------------------X,.....:.....................X-X,H,.,,.,,,,H,,.EX-----------------
--------------------X,..................,XXXXXXXXX-X,E,,X,,X,,,.,,.HX-----------------
--------------------X,..........:....:..X----------X,,,XXXXXX,XXXXXX------------------
--------------------X,..................X----------X+XXX-----XX-XX--------------------
--------------------X,..................X--------XXX,XXX------------------------------
--------------------X,..................X-------XX,,,,,XX-----------------------------
--------------------X,..................X-------X,...:.,XX----------------------------
--------------------X,..................X-------X::,:,,,:X----------------------------
--------------------X,..................X-------XXX,,,XXXX----------------------------
--------------------X,..................X-------XXX,::XXX-----------------------------
--------------------X,.:................X-------X:,E.,E,:X----------------------------
--------------------X,..................X-------X,..A...XX----------------------------
--------------------X,.........:........X-------X,,,..,,XX----------------------------
--------------------X,..................X-------XXXX,XXXX-----------------------------
--------------------X,..................X---------XX,XXX------------------------------
--------------------X,..................XXXXXX----X,,,XX------------------------------
--------------------X,................:..,,,,XX---XAE,AX------------------------------
--------------------X,..................:....,X---XX+XXX------------------------------
--XX----------------X,,,,,,,,,,,,,,,,,,,,,,,,,X---------------------------------------
--XX----------------XXXXXXXXXXXXXXXXXXXXXXXXXXX---------------------------------------
-XXX----------------------------------------------------------------------------------
--XX----------------------------------------------------------------------------------
XXXXXX--------------------------------------------------------------------------------
XXXXXX--------------------------------------------------------------------------------
--XXXX--------------------------------------------------------------------------------
--XXXX--------------------------------------------------------------------------------
XXXXXX--------------------------------------------------------------------------------
XXXXXX--------------------------------------------------------------------------------
XXXXXX--------------------------------------------------------------------------------
XXXXXX--------------------------------------------------------------------------------
XXXXXX--------------------------------------------------------------------------------
XX--XX--------------------------------------------------------------------------------
XXXXXX--------------------------------------------------------------------------------
XXXXXX--------------------------------------------------------------------------------
XXXXXX--------------------------------------------------------------------------------
XXXXXX--------------------------------------------------------------------------------
XXXXXX--------------------------------------------------------------------------------
XXXXXX--------------------------------------------------------------------------------
XXXXXX--------------------------------------------------------------------------------
XXXXXX--------------------------------------------------------------------------------
XX--XX--------------------------------------------------------------------------------
XXXXXX--------------------------------------------------------------------------------
XXXXXX--------------------------------------------------------------------------------
XX--XX--------------------------------------------------------------------------------
XX--XX--------------------------------------------------------------------------------
XXXXXX-----------------------------------------------------------------------XXX------
XXXXXX-----------------------------------------------------------------------XEX------
XX--XX-----------------------------------------------------------------XXXXXXX.XXX----
XX--XX-----------------------------------------------------------------X.tE.E.E.EX----
XXXXXX-----------------------------------------------------------------X,,,,,XXXXX----
XXXXXX-----------------------------------------------------------------X.tE.EX--------
XX--XX-----------------------------------------------------------------XXXXX.XXX------
XXXXXX------------------------------------------------------------XXXXXXX--XE.EX------
XXXXXX------------------------------------------------------------X.tE.EXXXX.XXX------
XXXXXX------------------------------------------------------------X.t,,,XXE.EX--------
XX--XX------------------------------------------------------------X.tE.EXXXXXX--------
XXXXXX------------------------------------------------------------X.t,XXX-------------
XXXXXX------------------------------------------------------------X.tEX-XXXX----------
XXXXXX------------------------------------------------------------XXXXX-X-,X----------
XXXXXX------------------------------------------------------------------XXXX----------
XX--XX--------------------------------------------------------------------------------
XXXXXX--------------------------------------------------------------------------------
XXXXXX--------------------------------------------------------------------------------
XX--XX--------------------------------------------------------------------------------
