--X------------------------------------
XX.XX----------------------------------
XH.X.XXX-------------------------------
-X,.....XX-----X-----------------------
-X.....XX----XXX-----------------------
-X.....XXXXXX>,X-----------------------
--X....+..+.,,,X-----------------------
--X....XXXXXX.,X-----------------------
-X..,,,X-XXXXXXXXXXXXXXXXX-------------
-X..,,,X-X...............X-------------
X...,K,X-X...............X-------------
X.......XX....EEEEEEE....X-------------
X.......++..........EEEE.X-------------
X.......++..EEE..EEE.....X-------------
X.......++.....EEEEEE.EEEX-------------
X.......XX.EEE...........X-------------
X......X.X....EEE.EEE.EEEX-------------
.X.....X.X....EEEEEEEEEE.X-------------
.X..:.X..XEEE..EEE.......X-------------
.X....X..X...EEEEEEEEE...X-------------
.X.:...X.X...EEEEEE.EEEE.X-------------
.X...:.X.XEEE.EEEEEE.EEE.X-------------
.X..XXX..X...EEEEEEEEEEEEX-------------
.X.:X.X..X......EEEEE....X-------------
.X..X....XEEEEEE..EEEE...X-------------
.X..X....X....EEEEE.EEEEEX-------------
.X..X....XEEE...EEE......X-------------
..X..X...X.....EEEEEEE...X-------------
..X..X...X.EEEEE.EEE.EEE.X-------------
..X.E.X..X...EEE.........X-------------
...X.X...X...............X-------------
....X....XXXXXXXXXXXXX...X-------------
...................XX....X---X---------
..................X.+....X--XX---------
.................X...+...X--XX---------
.................X...+...X-X.X---------
................X.....+..X-X.X---------
.............XXX.......+X-X..X---------
..............XX+.......XX...X---------
..............X..++.....XX...X---------
...............X...++..XX....X-------XX
...............X.....+.XX....X----XXXX.
................X.....XX.....X-XXX...X.
.................X.A........AXX.....X..
.................X.........W.......X...
..................X.A..WW..AA..A...X...
..................X.....W.W.......X....
...................XA......A..W..X.....
...................X..A.....WW...X.....
...................X..W..A...W..X......
..................X.........W...X......
..................X.A..W.A.....X.......
..................X......W..W..X.......
..................X..AW.......X........
..................X...........X........
.................X......XX.W..X........
.................X..XXXX..X.<.X........
.................XXX......X...X........
......................A....X..X........
............................X.X........
............................X..X.......
.............................X.X.......
..............................XX.......
..............................XX.......
...............................X.......
.......................................
