-------------------------------------------------------------------XXXXXXX------------
-------------------------------------------------------------------X<.:.<X------------
-------------------------------------------------------------------X.<.<.X------------
-------------------------------------------------------------------XA,,,AX------------
-------------------------------------------------------------------X.....X------------
-------------------------------------------------------------------X......X-----------
-------------------------------------------------------------------X......X-----------
------------------------------------------------------------------X.......X-----------
------------------------------------------------------------------X........X----------
------------------------------------------------------------------X,,,,,,,,X----------
------------------------------------------------------------------X,,,,,,,,X----------
------------------------------------------------------------------X........X----------
-----------------------------------------------------------------X..A.W....X----------
------------------------------XXXXXXXXXXXXXXXXXXXXXXXX------X----X.........XX----X----
-----------------------------X..,,,,,,,,,,,,,,,,,,,,,X-----X.X-XX:,,,,,,,,,.:XX-X.X---
----------------------------X,,,.........H.H.........X----X...X................X...X--
---------------------------X,..:...............:.....X----X...,,......E.......,,...X--
--------------------------X,.........................X----X.E.,.,............,.,.E.X--
--------------------------X,...:.....................X-----X,,...,..........,...,.X---
--------------------------X.:........................X------X,...,.........,.....X----
--------------------------X..................,.....,:X------X.,,..,.......,....,,X----
--------------------------X...:.A.........,,,,,,,,,,,X------X...,,.,.....,...,,..X----
--------------------------X..........,,,,,...,.....,.X------X.....E,,,,,,..,,....X----
--------------------------X...........,...E..X..E..X.XXXXXXXX.......,,,,,,,......X----
--------------------------X.........,,,X...,X-X,,,X-XX.A.EXX,.......,.T.,,.......X----
--------------------------X.........,.X-X,,,XXX,,,XXXX....XXX.......,.:.,,.......X----
--------------------------X........,..XXX,,.......,:.X.E.EX-X.......,A.W,,.......X----
--------------------------X........,E.,,:.........,..,....X-XH,H,H,:,.H.,:,,.,H,HX----
--------------------------X........,..,............,.,.E.EX-X.......,,,,,,.,,,...X----
--------------------------X........,.,,............,.,....X-X.......,,,,,,.,.,...X----
--------------------------X.......,.XXX.....,,,....,.,.E.EX-XXX.....,,,,,,.,,,.XXX----
--------------------------X......,,,X-X....,,.,,...,.XXXXXX-X--X...,,.,,,.,...X--X----
--------------------------X.:.....,.XXX...,,,,,,,...,XXXXX--X--X...,,.,,.,,...X--X----
--------------------------X.......,..,....,,,K,,,...,++...X-XXX.,..,,.,,.,,..,.XXX----
--------------------------X.:.....,E.,....,.,,,.,...,++...X-:..,.,,,..,,.,.,,.,.:X----
--------------------------X.......,..,.....,,,,,....,++..AX-X...,.,,..,,..,,,,...X----
--------------------------X.......,.XXX..............XX,,XX-X....,.,,,,,,,,,.....X----
--------------------------X......,,,X-X:.............XX,,XX-X....,,,,,,,,,,,.....X----
--------------------------X.......,.XXX......,,,,XXXXXX..,X-X....,,.,,..,,,.,....X----
--------------------------X.......,..,.....,,,,,,X-XXXX,,,X-X...,.,.,,..,,.,,....X----
--------------------------X.......,.E,.....,,.,,,XX:E,...,X-X...,,..,,..,,.,.,...X----
--------------------------X.......,..,....,,.,,,,X-X.XX,,,X-XH.H,,..,,,,,,..,,H.HX----
----------XXXX------------X.......,.XXXA,.,,,,,..X-X,XX,,,X-XXXXX,,X,,,,,X,,.XXXXX----
---------XXXXX-XXXXXXXXXXXXHHH.HHHHHX-XXXXXXXX,,,XX:E,...,X-----X,,XX,...XXXX---------
---------X.H.X-X..........XXXXXXXXXXXXXXXXX--X+++X-X.XX,,,X-----X,,XX....X------------
---------XX,XX-X..........XXH,,,,,,,,,,,,,,X-X...X-X,XX,,,X-----XW,XX....X------------
----------X+X--XX.........X,,..,,..,,..A,:,X-:,..:X:E,...,X-----XE,XX...X-------------
----------X,XXXXXX........X,,.E.,E..,,..,,,XXX...X-X.XX,,,XXXXXXX,,XX+++X-------------
----XXXXXXXE.EE.,X........XX,...,,..,,..,,,,.,...X-X.XX...,,,,..,A,XX...X-------------
----X....XXE..,,..X.......XXX,,,,XXXXXX,.,,,H,...X-XE,....,.,,..,,,XX...X-------------
----X....XXEE.,..E,,.......X-X,,,XXXXX:X.,,XXX...X-X.XX...,.,...,,,X-X...X------XXXXXX
---X,....XX.E,.E..,.....E.XXXX,,,XH...XX..,X-XX,,X-X,XKX.XX.XXXXXXXX-X...XXXXXXX,,,,,X
---X,....XXE.,E..,........X.XX...X,,..XX..,X-X...X-X,EXX,XX,X------XXX,,,XXK.........X
---X,.....XXXX,X,........XX,.X,,,X,,.,XX,.,X-X.E.X-X.,,.E.,EX---XXX,.,..,X.....:..:..X
---X,.......,,,,.........,,E.,...X,,.LL,,.,X-X...X-:XXXXXXX:X---X,,,,,,,.,,..........X
--X.,......,,E.,,........XX,.X,,,Xtt.,XX,,,X-XX,,X-XXXXXXXXXX-:X,.,,.,....,.E........X
--X.,.......,..,.........XX.,X...X,,W.XX,,,X-XX,,XXXXW,A,,XXXXXX,,,,,,...,,..........X
--X,........,E.,........E.XXXX,,,X,XXX::X::X-XA...+,,,....,,,+,.,.,,.,,,,X,....E....HX
--X,.......,,..,,..........X-X,,,X,XXXXX-----X.A..+,,......,,+,.,.,,.,...X.:.........X
-X,.........,.E,..........XXXX,,,X,.,EXX-----X....+,,......,,+,.,.,,.,...X...........X
-X,........,,..,,.........X.XX...XXXX.XX-----X:XXXXXX,....XXXXX.,.,,,,,,,X,......E...X
-X,.........,,E,.........XX,.X,,,HX--XXX----XX-----XX,,,,,XXX-XX,,,,.,....,..E.......X
-X,.......XXXX,X,........,,E.,...,XXXXXXXXXX,,XX---XXXXX,,XX--:X,,,,.,....,..........X
X.,......X:..EE..,.......XX,.X,,,,XX.....,,HH.HX--------XLX-----XX,,,,,,.X,.......E..X
X.,......XXE....E,.......XX.,X...,L,.....,,..E.X--------XLX-------XXX,..,X....:......X
X.,......XX.E.EE.E,,....E.XXXX...,XX.....,,E...X-:XXXXXXX,:X---------X,,,XXH.........X
-X,......XX.....W.X........X+X...,XX,,,XX,,....XXX.H.......X---------X,.,XX.....E..:.X
-X,......XXE.EE.EXX........X+,W.HXXX,,EXX,,...A,X,:........X---------X,.,XX..........X
-X,......XXX,,,XXX.........XXX...X-X..,XX,,.E.E,X,.........XXXXXXX---X,.,XXW.E.....:.X
-X,.......XX,,,XX..........X-XX,XXXX.....,,...E,X,W..E...:.XXH.HEX---X,,.XX..........X
--X,......,,H,,,...........X-XttttXX.....,,.E..,.,.A.......,,,.EEX---XXLX-X:...E....:X
--X.,.....,,,,,,...........X-E.E.EXX.....,,.E.E,XXXXXXXXXXXX,,...X----X,X-X,.........X
--X.,......,,,,,...........X-X....XX,,,XX,,....,XXXXXXXXXX,X,,E.AX----X,X-XXXXX......X
---X,......,...,.......ttt.X-E.E.EXX,,AXX,,.E.E.,,,,,,,,,,,,.EE..XXX:XX,X:X---X......X
---X,.....,,...,.......t.t.X-X.E..XX..,XX,,.....E.E.EAE.E.E........,,..A..X---XX.....X
---X,......,...,.......ttt.X-E...EXX.....,,...........E.E..........,,..A..XXXXXX.....X
---X,.....,,,,A,..........X--E.E.EXX.....,,.......E................,,.....,,.,,......X
----X.....,,,,,,.........X---X....XX.....,,.........,:,,,,,,,:,....,,X,,,,XXXXXX.....X
----X.....,,,,,,.........X---E.E.EXX,,,XX,,....T....,,,,,,,,,,,....,,XE.,,X---XX.....X
-----XXXXXXX,,XXXXXXXXXXX----X.E..XX,,EXX,,..........,,.....,,..A..,,X,,..X---XXXXXXXX
-----------X,,,X-------------E...EXX..,XX,,..........,.......,.....,,.....X-----------
-----------X,..X--XXXXX------E.E.EXX.....,,..........,...T...,.....,,.....X-----------
---------XXX,,,XXXX,,,XX-----XXXXXXW.....,,HH.H.....,,,.....,,,....,,.....X-----------
---------:..,..,....H.,:XXXXXXXXXXX:.....AXXXXXX....,:,,,,,,,:,....,,X,,,,X-----------
---------X:..,.,......,.XH.EE.E.E.XXXX,,XXXXH.,H....,,,.....,,,....,,XE.,,X-----------
---------:.A.,,,.......,,.........X--X,EX-XX.WXXH..........A.......,,X,,..X-----------
---------XXXXX,XXXXX.E.,,EE.EEE.E.X--X,,XXXX,H,,...................,,.....X-----------
--------------X-----X..,,.........X---X,E,W,.XXH...................,,.....X-----------
-------------------XX..,XH.EE.E.E.XXXXXXXXXXX-X,,,,,,,,,,,,,,,,,,,,,,.....X-----------
-------------------X,..,XXXXXXXXXX-XAX----X---:,,,,,,,,,,,,,,,,,,,,,:X,,..X-----------
-------------------X,..,XXXXXXXXXXXX,XXXXXXXXXX...XXX...XXX...XXX...XX..,,X-----------
-------------------X,A..,..,.,,..,,......,,,,L,...XAX...XXX...XXX...XX....X-----------
-------------------XX...,E,...,.,.,......,,,,L,...,E,...,E,...,E,...,.E...X-----------
--------------------:...,,,...,,,.,...W..,,,,L,...,.,...,.,...,.,...,...A.X-----------
--------------------XXXXX,XXXXX,XXXXXXXXXXXXXX:...,,....,,....,,.....,....X-----------
-------------------------X-----X--------------XXXXXXXXXXXXXXXXXXXXXXXXXXXX------------
