--------------------------------------------------------------------------------XXXXX----------
--------------------------------------------------------------------------XX----X.tEX----------
-------------------------------------------------------------------XXX---XXAX---X.t,X----------
-------------------------------------------------------------------XWX---XEEX---X.tEX----------
-------------------------------------------------------------------XXX-XXX,,.X--XXXXX----------
------------------------------------------------------------------XX+XX,,.,,X------XX----------
-----------------------------------------------------------------X,,,,,..,,,.XXX---XX----------
-----------------------------------------------------XX--------X-X,.........,,,,XXXXXX---------
-------------------------------------------XXX-------HX-------XXXX.,..,,,..T..<,XXXXXXXX-------
-------------------------------------------XEX------XXXX----------X,..,T,...,,,.X-----XX-------
-------------------------------------------X,X-----XXAtX----------X,..,,,,,,.XXX------X,XXXXXXX
------------------------------------------XX,XXXXX-X,..XX---------X.,...,.XXX---------XE,E,E,EX
------------------------------------------X,,,,,EX-X....X---------XX,...,X------------XtttttttX
-------------------------------XXXXXX-----X,,,,,,XXX,,,,XXXXX-----H,,...,X------------X.......X
-----------XXXXXXXXXX---------X.E..EX-----X..,..,...,,,,...,X-----XX,...,X------------XXXXXXXXX
-----------X,H,,.,E.XXX--X-X--XX,,,.X----XX.XXXX.E..,,,,....X------X,...,X---------------------
-------XXXXX,,,,.,.,,XXXXXXXXXXX,,,.X----X,.X--X.........E.TX------XX,,,XX---------------------
-------X....,,,XXXX,...,,...,+....,.X----XX.XXXXXXXX,XXXXXX.X------XX,,,XX---------------------
-------X.E.....X--XX.H.,,...,+....,EX-----X.XXEX-XXX+XXXX-XHX------X,,,,,X--------------XXX----
-------X,,,,,,XX--XX...,,...,+....XXX-----X,XX,XXX.....,X-XXX-----XX,,E,,XX-------------X:X----
-----XXX,,,,,,X----X,,,XXXXXXXX.XXX----XXXX.XX.XX,.,,,,,X-------X-A,,,.,,AXX-----------XX.X----
-----X........XXX--X,,,X--XXXXX.XXXXX--AE,,..,.E,,.,T.,,,X-----X,XXX,,E,,XX,X----------X,EX----
-----X........,EA-XX...X-XX...,E.,..XX-XXXXA,..E,,.,..,,,X-----XE,XX,,.,,XXEX---------XX,+XXX--
-----X........XXXXXX...X-X....,..E...XXXXXXXX..E,,.,..,,,X-----XX,.,,,E,,,..X---------X,,,,,AX-
-----X,,,,,,,,X-X.XX...X-X....,.E,...t,,,,T,+T.E,,.,..,,,X------XXXX,,,,,XXX----------X,...,,X-
-----X,,,,,,,,XXX.,,...X-X...XXXXXX..t,,,,,XX..E,,.,..,,XXXX-------XX,,,XX-XXX-------XA,,..,HX-
-----X,,,,,,,,,,t.,,...XXX..X-----XE.t,,,..XX,,EXX.,..,,XE.XX------XX,,,XX-XEX------XX,,,,.,,X-
-----A,,,H,H,,,,t.,,...++,..XXXXXXXE.t,,,..XX,,,XX.,..,,X..TX-----XX,...,XXXAX-XXXXXX,,T,,.,AX-
-----XW,,,E,,,,,tE,,EH.++,A..E,EHEX,,,,,,..XX,,,XX.,..,,,,.EW-----A,,.E.,AXXEX-XE.EXXX,,,,.,XX-
-----A,,,H,H,,,,t.,,...,+,..XXXXXXXE.t,,,..XX,,,XX.,..,..,.EX-----XX,...,XXXAX-XXXAX-X,...,AX--
-----X.,,,,,,,XXX.,,...XXX...X----XE.t,,,,,XX,.E,,.,..,..,XXX------XX,,,XX-XEX---X.XX,,,,.,XX--
-----X,,,,,,,,X-X.XX...X-X....XXXX...t,,,,T,+T.E,,.,..,..,XXX-XXXX--X,,,X--XtXX-XX,,,.,,,.,XXX-
-----X,,,,,,,,X-XXXX...X-X....,.E,.T.t,,,XXXX..E,,.,..,.....XXXH,XXXX,,,XXXXH,XXX.....,,,,AXX--
-----X........XXX--X...X-X....,..E...XXXXXXXX..E,,.,..,,,,,.,+,,,,E,....,,,,E,++,.T....,,,X----
-----X........,EA-XX...X-XX...,E.,..XX-AE,,....E,,.,..HH.H,T,+,,,,,..HHH.,,,,,++,...,.,,,,X----
-----X........XXX--X,,,X-XXXXXX.XXXXX--X.,,....E,,.,......,.,+,,,,,.HX-H.,,,,,++,..,,,,T,,X----
-----XXX,,,,,,X----X,,,XXXXXXX....XXXXXXXXXX,XXXXX.,,,,,,,,.XXX,,,,,X--X,,,,T,XXX.,,T,,,,,X----
-------X,,,,,,XX--XX...,,...,+....XX...,.X-X,X-X-X,,,,,,,,,XX-XHXX,,X--XXXXXHXX-XX,,,,,,,AX----
-------X.E.....X--XX.H.,,...,+....L,...,AX-XEX---XX...XXX,XX-----X..X------------X,,,,.XXX-----
-------X....,,,XXXX,,..,,...,+..T.XXXXXX,X-XHX----X+++X-X.X-XX---X.EX------------XXXXXX--------
-------XXXXX,H,,.,E,,XXXXXXXXXXXLXX----X,X--XX----XAA,A-X.XX+.X--XXXX--------------------------
-----------X,,,,.,..XX--------XX,X-----X,X--------XXKXX-X.E.,WX--------------------------------
-----------XXXXXXXXXX-XXXXXXXXX,,XXXXXXX,X----------XX--XXXX..X--------------------------------
-----------------XXXXXX.........A....HXX,XX---------XX------XX---------------------------------
-----------------X,,,,,,,,,,,,,,,,,,..,...X---------XXXXXXXXXXXXXXXXXXXXXXXXXXX----------------
-----XXXXXX--XX+XX,,,,,,,,,,,,,,,,,,..,...X---------XXXXXXXXXXXXXXXXXXXXXXXXXXX----------------
-----X..,,XXXX.A,,,,,,XXX,,,,,XXX,,,..,.E.X----------------------------------XX----------------
---XXX....,,,,..,,,,,EX-XE,,,EX-XE,,..,...X--X++XXX--------------------------XX----------------
---XE....A,,,,..,,,,XXX-XX,,XXX-XX,,..H...XXXX,,..X-----------------------XXXXX----------------
---XXX....,,,,.EH,,,X----X,,X----X,,..,...,,,,....XXX----XXXXXXXXXXX------X.tEX----------------
-----X,,,,XXXX..,,,,XXX-XX,,XXX-XX,,..,.E.,,,,.....EX---X.E,,.,,,.EXX-----X.,,X----------------
-----X,,..X--X.E,,,,,EXXXE,,,EXXXE,,..,...,,,,....XXX--X..,,..E.,,,.XX----X.tEX----------------
-----X....X--X..,,,,,,,,,,,,,,,,,,,,..,.A.XXXX,,,,X----X,,,...,...,,,X----X.t,X----------------
-----X....X--X..,,,,,,,,,,,,,,,,,,,,..X++XX--X..,,X----X,,.T..,..T.,,X----X.tEX----------------
-----X..H.X--XX,XX....................X------X....X----X,,,,,,,,,,,,,X----X.t,X----------------
--XXXX,,..X---X.XX....................X------X....X----X.............X----X.tEX----------------
--XA.,.,..X---X.XXXX,XXX,XXX,,,XXX,XXXX------X....X----XE...........EX----X.t,X----------------
--XXXX,,..X---X.X--X,X-XE.XX,,,X-XH.X--------X....X----XX,,,,,,,,,,,XX----X.tEX----------------
-----X....X---X.X--X,X-XXXXX,,,X-X,XX--------X....XXXXXXX,,,,,.,,,,,XXXX--X.,,X----------------
XXXXXX....X---X.XXXX,X-----X,,.XXX,XXXXXXX---X.E..,,,.,.,,,H,,.,,H,,.,,X--X.tEX----------------
+.........X---X...,,.X-----X...,.....,...X---X....,,,.,.,,,,,,.,,,,,.XXX--XXX,X----------------
+......E..X---XXXXXXXX-----X...,.....,...X---X....XXXXXXX.,,,,..,,,,XX------X.X----------------
+.........X----------------X..,,....,...,X---XX,XXXAXA-XX,,,,,,,,,,,XX-XXXXXX,XXXX-------------
X.........X----------------XXXXXXX,XXX,,,X----X.X-X.AX-XE...........EX-X....t....X-------------
XXXXXXXXXXX----------------------XEX-X...X----X.X-XA.A-X.............X-X....t.E..X-------------
---------------------------------XXX-X...X---XX,XXX,,XXX,,,,,,,,,,,,,X-X....t....X-------------
-------------------------------------X...X---X,,,,E,EE,,,,.T..,..T,,,X-X....t....X-------------
----------------------------------XX-X,,,X-XXX,A,H,,,,,,.,,,..,..,,,.X-X....t,,,,X-------------
---------------------------------XXXXX,,,XXXXX,,,,E,EE,,...,,.E,,,.XXX-X....t....X-------------
---------------------------------XX.........XX,,,,,,,,XX..E..XX,..EX---X....t.E..X-------------
---------------------------------XX....E....XXXXXXXX++XXXXXXXX-XXXXX---X....t....X-------------
---------------------------------XX..,,.,,..X--------------------------X....t....X-------------
----------------------------------XXX,,,,,XXX--------------------------X....t,,,,X-------------
------------------------------------X,,,,,X----------------------------X....t....X-------------
----------------------------------XXX,,,,,XXX--------------------------X....t.E..X-------------
----------------------------------X,.......,X--------------------------X....t....X-------------
----------------------------------X,,,,,,,.,X--------------------------X....t....X-------------
----------------------------------X,,,,,,,.,X--------------------------X....,,,,,X-------------
---------------------------------XX,,,,>,,,,X--------------------------X....t....X-------------
---------------------------------X,,,,t.,,,,XX-------------------------X....t.E..X-------------
----------------------------------X,,,,,,,.,X--------------------------X....t....X-------------
----------------------------------X,,,,,,,.,X--------------------------X....t....X-------------
----------------------------------X,..,,...,X--------------------------XXXXXX,XXXX-------------
----------------------------------X,,,,,,,,,X-------------------------------X.X----------------
----------------------------------XXXXXXXXXX------------------------------XXX,X----------------
---------------------------------------X----------------------------------X.tEX----------------
--------------------------------------------------------------------------X.,,X----------------
--------------------------------------------------------------------------X.tEX----------------
--------------------------------------------------------------------------XXXXX----------------
