-----------------------XXXXX---------------------------------------------------------------------------
-----------------------X...X---------------------------------------------------------------------------
-----------------------XtttX---------------------------------------------------------------------------
-----------------------X.E.X---------------------------------------------------------------------------
-----------------------X,,,X---------------------------------------------------------------------------
-----------XXXXXXXXXXXXX,,,XXXXXXXXXXX-----------------------------------------------------------------
-----------X:.......................:X-----------------------------------------------------------------
-----------X,,,,,,,,,,,,,,,,,,,,,,,,,X-----------------------------------------------------------------
-----------X...........,...,.........X-----------------------------------------------------------------
-----------X.E.......E.,...,..E....E.X-----------------------------------------------------------------
-----------X...........,...,.........X-----------------------------------------------------------------
-----------X...........,...,.........X-----------------------------------------------------------------
-----------X...........,...,.........X-----------------------------------------------------------------
-----------X...........,...,.........X-----------------------------------------------------------------
-----------X...........,...,.......E.X-----------------------------------------------------------------
-----------X...........,...,.........X-----------------------------------------------------------------
-----------X...........,...,.........X-----------------------------------------------------------------
------XXXXXX...........,...,.........X-----------------------------------------------------------------
------X...,,...........,...,.........XXXXXXX-----------------------------------------------------------
------X...,,...........,...,.........,.,...X-----------------------------------------------------------
------X...XX...........,,,,,.....E...,.,...X-----------------------------------------------------------
------X,,,XX..E......................,.,...X-----------------------------------------------------------
------X...XX.........................XXX,XXX-----------------------------------------------------------
------X...XX,,,,,,,,,,,,,,,,,,,,,,,,,X-XEX-------------------------------------------------------------
------X,,,XXXXXXXXXXXXXX+++XXXXXXXXXXX-X.X-------------------------------------------------------------
------X...X-----------XX+++XX----------X.X-------------------------------------------------------------
------X,,,XXXXXXXXXXXXX.....XXXXXXXXXXXX,X---------------------X++XX-----------------------------------
------X...,,.,.,.,,.,.+.....XX,,,.,,,,.,.X---------------------X...X-----------------------------------
------X...,,.,.,.,,.,.+..W..++,,,.,,,,.,EX---------XXXXXXXXXXXXX+++X-XXXXXXXXXXXXXXXXX-----------------
------X...,,.,.,.,,.,.+.....++,,,.,,,,.,.X---------X......E........X-X.......E.....H.X-----------------
------X...,,.,.,.,,.,.X.....++,,,.,,,,.,.X---------X...............X-X...............X-----------------
------XXXXXXXXXXXXXXXXX.....XXXXXXXXXXXXXX---------X...............X-X...............X-----------------
-----------------XXXXXXXXXLLXXXXX------------------X.,,,...........X-X.,,,...........X-----------------
-----------------X....X,,,,,,,..X------------------X.,.,...........X-X.,.,...........X-----------------
-----------------X....X..,..,...X------------------X.,.,...........X-X.,.,...........X-----------------
-----------------X,,,,X..,..,...X------------------X.,.,...........X-X.,.,...........X-----------------
-----------------X,,T.X..,..,...X------------------X.,,,...........X-X.,,,...........X-----------------
-----------------X,,,,X..,..,...X------------------X...............X-X...............X-----------------
-----------------X....X..,..,...X------------------X...............X-X.............E.X-----------------
-----------------X....X..,..,...X------------------XE.............EX-X.E.............X-----------------
-----------------X....X..,..,...X------------------XXXXXXX+++XXXXXXX-XXXXXXX,,,XXXXXXX-----------------
-----------------X....X..,..,...X------------------------X+++X-------------X+++X-----------------------
-----------------X,,,,X..,..,...X----------------------XXX,,,XXXXXXXXXXXXXXX,,,X-----------------------
-----------------X,,..X..,..,...X----------------------X.B....B................X-----------------------
-----------------X,,W,X..,..,...X----------------------X.......................X-----------------------
-----------------X....X..,..,...X----------------------X.......................X-----------------------
-----------------X....X..,..,...X----------------------X.......................X-----------------------
-----------------X....X..,..,...X----------------------X......B..B.......B.....X-----------------------
-----------------X....X..,..,...X----------------------X.....,,,,,,,,,,,,,.....XXXXXXXX----------------
---------XXXXXXXXX..A.X..,..,...X----------------------X....B,...........,.....,,++...X>---------------
---------X.:.W.HXX,,ttX..,..,...XXXXXXXXXXXXXXX--------X.....,...........,.....,,++.E.,>---------------
---------X......XX,,..X..,..,...,:X...........X--------X.....,...E....E..,.....,,++...XX---------------
---------X.....HXX,,,,X..,..,...XXX...........X--------X.....,...........,.....XXXXXXXX----------------
---------X.....HXX....X..,..,...XXX...........X--------X....B,...........,.....X-----------------------
-------XXXXX+++XXXXH..XX.,..,...,XX...........X--------X.....,,,,,,,,,,,,B.....X-----------------------
-------X.........XX,,,XX,,,,,,,,,XX...........X--------X......B..B.............X-----------------------
-------X.........XX...XX.,..,,,,,,............X--XXXXXXX.......................X-----------------------
-------X<........+,.T.,T.,..,,,,,,............XXX,,.,,,,.......................X-----------------------
-------X.........+,...,..,..,,,,,,............,L,,,.,,,,.......................X-----------------------
-------X.........XX...XX.,..,,,,,XX...........XXX,,.,,,,.......................X-----------------------
-------XXXXXXXXXXXX,,,XX,,,,,,,,,XX...........X--XXXXXXXXXXXXXXXXXXXXXXXXXXXXXXX-----------------------
-----------------X....X..,..,...XXX...........X----------XXXXX-----------------------------------------
-----------------X,,ttX..,..,...X-X...........X----------XE.EX-----------------------------------------
-----------------X,H..X..,..,...XXX...........X----------X...X-----------------------------------------
-----------------X,,ttX..,..,...,:X...........X----------XE.HX-----------------------------------------
-----------------X....X..,..,...XXXXX,XXXXXXXXX----------X,,,X-------------------XXXXX-----------------
-----------------X....X..,..,...X---X..X---------------XXX,,,XXXXXXXXXXXXXXXXXXXXX,,,X---XXXXX---------
-----------------X....X..,..,...X--X,,,X---------------X.........,...,.........,H,.E.X---X...X---------
-----------------X....X..,..,...X--X,,.X---------------X.........,...,.........,.,...X---X.K.X---------
-----------------X....X..,..,...X-X,..,X---------------X...E.....,...,.........,H,...X---X...X---------
-----------------X....X..,..,...X-X.,,.X---------------X.........,,,,,...,,,...,.,...X---X,,,XXXXX-----
-----------------X,H,,X..,..,...X-X...X----------------X...,,,,,.........,.,...,H,...X---X...,...X-----
-----------------X,,..X..,..,...X-X,,X-----------------X...,...,.........,,,...,.,...X---X...,.E.X-----
-----------------X,,,,X..,..,...X-X,,,X----------------X...,...,.........,,,...,H,...X---X...,...X-----
-----------------X....X..,..,...X-X.,,X----------------X...,...,.,,,,,...,,,...,H,...XXXXX,,,,...X-----
-----------------X....X..,..,...X-X,,,.X---------------X...,,,,,.,...,...,,,...,.,.......,...,...X-----
-----------------X....X..,..,...X--X..,.XX-------------X...,,,,,.,...,...,,,...,,,.......,...,...X-----
-----------------X....X..,..,...X--X.,.,.,XXXXXXXX-----X..E,...,.,...,...,.,...,.,.......,...,...X-----
-----------------X....X..,..,...X---XX.,,,,,.,...X-----X...,...,.,...,...,.,...,,,.......,,,,,...X-----
-----------------X,,,,X..,..,...X-----X.,,,,.,...X-----X...,...,.,...,...,,,.............,...,...X-----
-----------------X,H..X..,..,.,,.XX----XXX,.,,...X-----+,,,,,,,,.,...,.E.,,,.E...........,...,...X-----
-----------------X,,,,X..,..,,.....XX-----XXXX,,,X-----+,...,....,...,...,,,.............,...,...X-----
-----------------X....X..,,,.,,......XX------X..,XX----X,...,....,,,,,,,,,,,,,,,,,,,,,,,,,,,,,...X-----
-----------------X....X.,,.....,,......X------X,,,X----X,...,....,.......................,...,...X-----
-----------------X....X,..,,.....,......XX----X,,,.XX--X,,,,,....,.......................,...,...X-----
-----------------X....XXX...,,....,,......XX---X..,,.XXX.........,.......................,...,...X-----
-----------------X..,,.XXXX...,.....,.......XX-X.,.,,.,,.........,,,,,,,,,,,,,,,,,,,,,,,,,,,,,...XXXXXX
-----------------X,,..,.,XXXX..,,....,,.......X-XXX.,.,,.........................................,,.E.X
-----------------XX...,H,..XXXX..,,....,,.....X----XX,.,,........................................,,H..X
----------------X..XX,,,.....XXX...,,....,...,.X-----XXXX........................................,,.E.X
---------------X,.E..XX,....,.,XXX...,....,,.,.X--------X........................................,,...X
---------------X,,,.X--XX...,H,.XXXX..,,....,,.X---------X.....,,,,,.........,,,,,...............,,.E.X
---------------X.,,X-----XX,,,....XXXX..,,.,..,X---------X.....,...,.........,...,...............,,...X
--------------X,...XX------XX,.....,XXXX..,,...X----------X....,...,.E.......,...,...............,,...X
-------------X,.,.,..XX------XX...,.,.XXXX,.,,X-----------X....,...,.........,.H.,...............,,.E.X
------------X.,.,,..,..XX------XX.,H,...X-X...X-----------X....,,,,,..,,,,,..,,,,,...,,,,,.......,,H..X
-----------X,..,X...,..,.XX------X,,..K.XX.,,.X------------X..........,...,..........,...,.......,,.E.X
-----------X.,.,XX.,..,..,.XX---X..,X..,,....X-------------X..........,...,..........,...,.......,,...X
----------X..,.X--XX..,.,..,.XXX,...XX.,.....X--------------X.........,...,..,,,,,...,...,.......XXXXXX
---------X.,..,X----XXX.,.,..,.,.,,X--XX....X---------------X..,,,,,..,,,,,..,...,...,,,,,.......X-----
--------X..,..X--------XX.,..,.,...X-XXX,,..X---------------X..,...,.........,.W.,.......XXXXX...X-----
--------X+..XX-----------XX.,.,....X-X..,,XX-----------------X.,.W.,.........,...,.......X+--X...X-----
-------X..+.X--------------XXX,....X-X....X------------------X.,...,.........,,,,,.......,+--X.E.X-----
------X.,..X------------------XXX.X--X....X-------------------X,,,,,E..............E.....XX--X...X-----
------X..,.X---------------------XX--X..XX--------------------XXXXXXXXXXXXXXXXXXXXXXXXXXXX---XXXXX-----
XXXXXX,,..X-----------------------XXX.XX---------------------------------------------------------------
X...,,..,X---------------------XXX..,.X----------------------------------------------------------------
X...,,...X---------------------X.....,X----------------------------------------------------------------
X.E.,,...X---------------------X......XX---------------------------------------------------------------
X...,,...X---------------------X.......X---------------------------------------------------------------
XXXXXX...X---------XXXXXXXXXX--X.......X---XXXXXXX-----------------------------------------------------
-----X...X---------X.HHXXE.EX--X.......X---X.....+-----------------------------------------------------
-----X...X---------X...XX...X--X......HX---X.E.EE+-----------------------------------------------------
-----X...X---------X.AWXXHE.X--X.......X---XH...HX-----------------------------------------------------
-----X...X-------XXX,,,XX,,,XXXXX,,,XXXXXXXX,,,,,XXX---------------------------------------------------
-----X...X-------X.,.....,,,.............,,,.....,.X---------------------------------------------------
-----X...X-------X.,.H..E+.,.............,.+...A.,.X---------------------------------------------------
-----X...X-------X.,.....+.,.............,.+.....,.X---------------------------------------------------
-----X...X-------X.,.....+.,.............,.+.....,.X---------------------------------------------------
-----X...X-------X.,,,...+.,.............,.+.....,.X---------------------------------------------------
-----X...X-------X.,,,...+.,.............,.+.....,.X---------------------------------------------------
-----X...X-------X.,,,...+.,.............,.+.....,.X---------------------------------------------------
-----X...X-------X.,,,...+.,.............,.+.....,.X---------------------------------------------------
-----X...X-------X.,,,...+.,.............,.+.....,.X---------------------------------------------------
-----X...X-------X.,,,...+.,.............,.+.....,.X---------------------------------------------------
-----X,,,X-------X.,,,...+.,.............,.+.....,.X---------------------------------------------------
-----X...X-------X.,,,...+.,.............,.+.....,.X---------------------------------------------------
-----X...X-------X.,,,...+.,.............,.+.....,.X---------------------------------------------------
-----X.E.X-------X.,,,...+.,.............,.+.....,.X---------------------------------------------------
-----X...X-------X.,,,...+.,.............,.+...E.,.X---------------------------------------------------
-----X..XX-------X.,,,...+.,.............,.+.....,.X---------------------------------------------------
----XX,,XXXXXXXXXX.,,,...+.,.............,.+.....,.X---------------------------------------------------
----X...........+,.,,,.E.+.,.............,.+.....,.X---------------------------------------------------
----X...........+,.,,,...+.,.............,.+.....,.X---------------------------------------------------
----XA..........+,.,.,...E.,.............,.+E...:,.X---------------------------------------------------
----XXXXXXXXXXXXXX.,,,.:.+,,.............,,,.....,.X---------------------------------------------------
-----------------XXXXXXXXXXXXXXXXXXXXXXXXXXXXXXXXXXX---------------------------------------------------
