--------------------------------------------------------------XXXXXXX::XXXXX::XXXXX:X--------------
------------------------------------------------------XX-----X....,..XX.....XX......X--------------
----------------------------------------------------XX..XX-XX.....,..XX.....XX......X--------------
--------------------------------------------------XX..:...X,,,,,XXX..XX,,X,,XX,,XX,,X--------------
------------------------------------------------XX..:...........X-X..XX..X..XX..XX..X--------------
------------------------------------------------X.:.............X-X..XX..X..XX..XX..X--------------
-----------------------------------------------X.................XX..XX..X..XX..XX..X--------------
-----------------------------------------------X.................XX,,XX,,X,,XX..XX..X--------------
----------------------------------------------X....E.............XX......X...,..XX..X--------------
----------------------------------------------X..................XX:....:X:..,.:XX..X--------------
---------------------------------------------X.:..................XXXXXXXXXXXXXXXX..X--------------
---------------------------------------------X................E.:.X-------X:XXXXXX,,X--------------
--------------------------------------------X........E,,E.........X-------X........:X--------------
--------------------------------------------X.........,:,........X--------XX,XXXXXXXX--------------
-------------------------------------XXXXXXX..........,,,........X--------X..X---------XXXXXXXXX---
-------------------------------------X:....,.........E..E........X--XXXXXXX,,XXXXXX----X..,....X---
-------------------------------------X.....,...E...............:X---X:............:----X..,XX,,X---
-------------------------------------X:....,....................X---X..,,,,,,,,,,.X---XX..EXX..X---
-------------------------------------X.....,...................X----X..,,,,,,,,,,.X---XE..XXX..XX--
-------------------------------------X:....:......E......E.....X----X..,,,,,,,,,,.X----X,,XXE..EX--
-------------------------------------X.....XX..................X----X.A,,,,,,,,,,AX----X..X-X,,X---
-------------------------------------X:....:-X..............:.X-----X..,E,,E,E,E,.X----X..XXX..XX--
-------------------------------------X..W..X--XX.............XX-----X..,,,,,,,,,,.XXXXXX..XXE..EX--
-------------------------------------X:....:----X......:.XXXX-------X..,,,,,,,,,,.,..,.,..EXX..X---
-------------------------------------X.....X-----X:..XXXX-----------X..,,,,,,,,,,.XXXXXXXXXXX..X---
-------------------------------------X:....:------XXX---------------X..,,,,,,,,,,.X-X:XXXXX:X,,XX:X
-------------------------------------X..A..X------------------------X.............:-X.............X
-------------------------------------X:....:----------XXXX----XXX---XX,,XXXXXX,,XXX-X.............X
-------------------------------------X.....X-------XXX....XXXX,..X---X,,X----X..X---X...,,,,,,,,..X
-------------------------------------X.....X------X,,,,XX,.....XX-X--X,,X----X..XX--X...,,,,,,.,..X
-------------------------------------X:.A..:-------X...XX...XXXXXX,X-X,,X-----X.,,X-X...,,,,,,.,..X
-------------------------------------X.....X--------XW.X-XXXXX.,.HX--X,,X------X,,,XX:..,,,E.,.,.:X
-------------------------------------X:....:--------X..XX,--,-XXXX---X,,X---XXXXX,.XX...,,,..,.,..X
-------------------------------------X.....X---------X..X-XXXX-------X,,X---X...,,,XX...,,,,,,.,..X
-------------------------------------X..A..X----------X.X-XXXXX------X,,X---XE..,,.XX...,......,..X
-------------------------------------X:....:----------X.XX,---X-----XX,,X---X...XXXXX...,,,,,,,,..X
-------------------------------------X.....X----------X.X-XXXX,XXXXX--XX----X...,,,,,.............X
-------------------------------------X.....X----------X.X---X..E...XXX------X...,,,,,......:.....:X
XXXXXXXXXXXXXXXXXXXXXXXX-------------X:....:----------X.XXXXXX,XXXXXXXXXXXXXXX,XXXXXXXXXX,XXXXXXXXX
X:.......E.E..E.......:X-------------X..H..X----------X.X..............................XX,X--------
X......................X-------------X.....X----------X.X................:......:......X..X--------
X......................X-------------X:....:----------X.X..............................,..X--------
X......................X-------------X.....X----------X.X..:.E..E................E.E...X..X--------
X......................X-------------X.....X----------X.X..............................X..X--------
X......................X-------------X:....:----------X.X..............................X..X--------
X......................X-------------X.....X----------X.X...............,,,............X.:X--------
X......................X-------------X:....:----------X.X.....:.........,:,.......:....X..X--------
X......................X-------------X.....X----------X.X...............,,,............X.AX--------
X......................X-------------X:....:----------X.X................W.............X.EX--------
X......................X--:XXX:X:X:X::.....X----------X.X..............................X..X--------
X.E........,,,,........XXX.................:---------X..X..............................,.EX--------
X..........,:.,........+.+.................X--------X...X.......................:......,..X--------
X.E........,..,........+.+.................:-------X....X....:.........................X..X--------
X..........,,,,........+.+.................X------X..E..X..............................X.KX--------
X.E....................XXX:...:.:.:.::.:.:.:-----X......X..............................XXXX--------
X......................X--XXXXXXXXXXXXXXXXXX----X......XXXXXXXXXXXXXXXX,,,,XXXXXXXXXXXXX-----------
X......................X-----------------------X.......X--------------X....X-----------------------
X......................X---------------------XX.......X---------------X,,,,X-----------------------
X......................X--------------------X.........X---------------X,,,,X-----------------------
X......................X-------------------X........XX----------------X,,,,X-----------------------
X......................X-----------------XX.......XX------------------X,,,,X-----------------------
X......................X----------------X.......XX--------------------X,,,,X-----------------------
X......................X---------------X......XX----------------------X,,,,X-----------------------
X......................X-------------XX......X------------------------X,,,,X-----------------------
X......................X------------X......XX------------XXXX---------X,,,,X-----------------------
X:......E..E..E.......:X------------X.....X------------XX....XXXX----XX,,,,X-----------------------
XXXXXXXXX,,,,,XXXXXXXXXX------------X....X-----------XX..........XXXX.....X------------------------
--------X,,,,,X---------------------X....X---------XX......XX.............X------------------------
--------X,,,,,X---------------------X.....X-------X.....XXX--XX..........X-------------------------
--------X,,,,,X---------------------X.....X-------X....X-------XX.....XXX--------------------------
--------X,,,,,X----------------------X.....X-XXXXX....XXXXXXXXXXXXXXXX-----------------------------
--------X,,,,,X----------------------X.....X-X:.....................:X-----------------------------
--------X,,,,,X----------------------X......XX.......................X-----------------------------
--------X,,,,,X----------------------X......XX.......................X-----------------------------
--------X,,,,,X----------------------XX......X.......................X-----------------------------
--------X,,,,,X------------------------XX....,.......................X-----------------------------
--------X,,,,,XXXXXXXXXXXXXXXXXXXXX------XX..,.......................X-----------------------------
--------X..........................XX------XX,.......................X-----------------------------
--------X............................XX------X.......................X-----------------------------
--------X..............................XX----X.......................X-----------------------------
--------X................................XX--X..........E............X-----------------------------
--------X..................................X-X.......................X-----------------------------
--------X..................................X-X.......................,X----------------------------
--------XXXXXXXXXXXXXXXXXXXXXXXXXX.........XXX.......................,.X---------------------------
----------------------------------XX......E,.,.......................,..X--------------------------
------------------------------------X......,.,.......................,...X-------------------------
------------------------------------X...E..,.,.......................,....XX-----------------------
------------------------------------X.:...E,.,.......................,......X----------------------
------------------------------------X...E..,.,.......................,.......X---------------------
------------------------------------X.....E,.,.......................,........X--------------------
------------------------------------X......,.,.......................,.........X-------------------
------------------------------------X......XXX:......................,..........X------------------
------------------------------------X......X-XXXXXX,,,,,,,,XXXXXXXXXXX...........X-----------------
------------------------------------X......X-XXXXXX,,,,,,,,XXXXX------X...........X----------------
------------------------------------X......XXX:...............:X-------X...........X---------------
------------------------------------X......LL.........:........X--------XX..........X--------------
-------------------------------------X.....LL..................X----------X..........XX------------
--------------------------------------X....LL..................X-----------X...........X-----------
---------------------------------------XXXXXXX.....<<.<.<......X------------X...........X----------
----------------------------------XXXXXXXXXXXX.................X-------------X...........X---------
--------------------------------XX........LL...................X--------------X...........X--------
------------------------------XX..........LL...................X---------------XX..........X-------
-----------------------------X............LL...................X-----------------X.........X-------
-----------------------------X....XXXXXXXXXXXX......W..........X------------------X........X-------
-----------------------------X....X----------X.................X-------------------X.......X-------
-----------------------------X....X----------X.................X-------------------X.......X-------
-----------------------------X....XXXXX------X.................X-------------------X.......X-------
-----------------------------X.........XXXX>-X.................X-------------------X.......X-------
------------------------------XX.........:.>-X.................X-------------------X.......X-------
--------------------------------XX.....XXXXX-X.................X-------------------X.......X-------
----------------------------------XXXXX------XXXXXX,,,,,,XXXXXXX-------------------X.......X-------
--------------------------------------------------X......X-------------------------X.......X-------
--------------------------------------------------X......X-------------------------X.......X-------
--------------------------------------------------X......X-------------------------X.......X-------
--------------------------------------------------X......X-------------------------X.......X-------
--------------------------------------------------X......X-------------------------X.......X-------
--------------------------------------------------X......X-------------------------X.......X-------
--------------------------------------------------X......X-------------------------X.......X-------
--------------------------------------------------X......X-------------------------X.......X-------
--------------------------------------------------X......X-------------------------X.......X-------
--------------------------------------------------X..A...X-------------------------X.......X-------
--------------------------------------------------X......X-------------------------X.......X-------
--------------------------------------------------X......X-------------------------X.......X-------
--------------------------------------------------X......X-------------------------X.......X-------
--------------------------------------------------X......X------------------------X........X-------
--------------------------------------------------X......X-----------------------X.........X-------
--------------------------------------------------X.......XX--------------------X..........X-------
--------------------------------------------------X.........XX-----------------X...........X-------
--------------------------------------------------X...........XX-------------XX............X-------
---------------------------------------------------XX....A......XX----------X.............X--------
-----------------------------------------------------X............XX-------X.............X---------
------------------------------------------------------X.............XX----X.............X----------
-------------------------------------------------------XX.............XX-X.............X-----------
---------------------------------------------------------XX.............X.............X------------
-----------------------------------------------------------XX........................X-------------
-------------------------------------------------------------XXX...................XX--------------
----------------------------------------------------------------XX................X----------------
------------------------------------------------------------------XXX............X-----------------
---------------------------------------------------------------------XX.........X------------------
-----------------------------------------------------------------------XXX.....X-------------------
--------------------------------------------------------------------------XX.:X--------------------
----------------------------------------------------------------------------XX---------------------
