XXXXXXXXX-----------------------------------------------------------------------------
X.,.....X-----------------------------------------------------------------------------
XXX.EH.EX-----------------------------------------------------------------------------
--X.....X-----------------------------------------------------------------------------
-XX,,,,,XXXXXXXXXXXXXXXXX-------------------------------------------------------------
-X......................X-------------------------------------------------------------
-X....................A.X-------------------------------------------------------------
-X.................E....X-------------------------------------------------------------
-X..,,,,,,,,,.....,,,...X-------------------------------------------------------------
-X,,H,,,,,,,H,,,.,XXX,..X------------------------XXXXXXXXXXXXXXXXXXXXXXXX-------------
-XH,,.....,.,,.H,X---X,.X------------------------X,,,,,,,,,,,,,,,,,,,,,,X-------------
-X,,,...E,..,,.,,X---X,.X------------------------X,......,,,,,,,.......,X-------------
-X,,,.H.,H..,,.,,X---X,.X------------------------X,.....,.,,,,,.,......,X-------------
-X,,,..,....,,.,.,XXX,..X------------------------X,.....,,..H..,,......,X-------------
-X,,,.,.....,,.,..,,,...X------------------------X,.....,,.,,,.,,......,X-------------
-XH,,.E..H,.,,.,........X------------------------X,.....,,.,,,.,,......,X-------------
-X,,,....,E.,,.,..,,,...X------------------------X,.....,,.....,,......,X-------------
-X,,,...,...,,.,.,XXX,..X------------------------X,.....,,.....,,......,X-------------
-X,,,..,....,,.,,X---X,.X------------------------X,.....,,.....,,......,X-------------
-X,,,.,H....,,.,,X---H,.X------------------------XXXXXXXX,,,,,,,XXXXXXXXX-------------
-X,,,.......,,.,,X---X,.X-------------------------XXXXXXX,,,,,,,XXXXXX----------------
-X,,,.E.....,,.,.,XXX,..X------------------------X....................X---------------
-X,,,.....,.H,.,..,,,...X-----------------------X....,,,,,,.E.,,,,,....X--------------
-X,,,....H..,,.,........X----------------------X.....,,,,,,...,,,,,.....X-------------
-X,,,...,...H,.,..,,,H..X----------------------X..E..,,,,,,.E.,,,,,...E.X-------------
-X,,,..,....,,.,.,XXX,..X----------------------XX.....,.,......,.,......X-------------
-X,,,.,..E..,,.,,X---X,.X-----------------------X.....,,........,.,....XX-------------
-X,,,.H.....,,.,,X---X,.X-----------------------X,,,,,,,,,,,,,,,,,,,,,,X--------------
-X,,,....H..,,.,,X---X,.X----------------------XX.E.,.,....,,,....,.,.E.X-------------
-X,,,.......,,.,.,XXX,..X----------------------X....,.,...,,E,,...,.,...X-------------
-X,,,.......,,.,..,,,...X----------------------X....,.,...,,,,,...,.,...X-------------
-X,,,.......,,.,........X----------------------X...E,.,....,,,....,.,...X-------------
-X,,,.......,,E,..,,,...X-----------------------XX...,.,........,,.,.E.X--------------
-X,,,...E...,,.,.,XXX,..X-------------------------XH..,.,,,,,,,,..,..HX---------------
-X,,,.......,,.,,X---X,.X-------------------------X,,..,.........,..,,X---------------
-X,,,.......,,.,,X---X,.X------------------------X...,..,,,,,,,,,..,...X--------------
-X,,,..H....,,.,,X---X,.X------------------------X...,HE.........EH,...X--------------
-X,,,.....H.,,.,.,XXX,..X------------------------X...XXXXXXXXXXXXXXX...X--------------
-X,,,.......,,.,..,,,...XXXXXXXXX---------------XXX,XXX-----------XXX,XXX-------------
-X,,,.......,,.,...............HX---------------XX...XX-----------XX...XX-------------
-X,,,.......,,.,............,,,.XX--------------XX...X------------XX...X--------------
-X,,,.......,,.,............,H,.,X--------------X+XXXXXXXXXXWXXXXXXXXXX+X-------------
-X,,,.......,,.,............,,,.XX--------------X,XXXXXXX,,,,,,,XXXXXXX,X---X+X-------
-X,,,..H....,,.,................X---------------XH.....................HX--XH,H-------
-X,,,.......,,H,..............A,X---------------X.......................X-XX..X-------
-X,,,.......,,,,..........XXX.,.X---------------X.......................X--XHLH-------
-X,,,.......H,,,,,,,,,,,,HXXX,..XXXXXXXXXXXXXXXXX.......................X--XXLX-------
-X,,,....................A,HX,..XX,,,,,,,,,,,,,,,.......................X--X..X-------
-X,,,.....,.......E..H..H.XXX...XX.H,...H,...H,,,.......................X--X..X-------
-X,,,....,.......H......,,XXX..,XX............,,,.......................X--X..X-------
-X,,,...,.....T.E.E.E...,.,.,..,E,............,,,......,,,,,,,,,,,......XXXXX+XXXXXXX-
-X,,,..,...........H....,,,.,..,XX............,,,.......,.......,.......,.,,....+X..>-
-X,,,.,.........H.E...H..HXXX...XX.H,...H,...H,,,.......,.......,.......,,,,....,,..>-
-X,,,....................A,HX...XX,,,,,,,,,,,,,,,.......,.......,.......,,,,....XX..X-
-XH,H,,,,,,,,,,,,,,,,,,,,HXXX,..XXXXXX,XXXXTXXXXX.......,,,,,,,,,.......XXXTXXXXXXXXX-
-X,,,,,,,,,,,,,,,,,,,,,,,,X-X,..X----X+X--XXX---X......,,,,,,,,,,,......X-XXX---------
-X,,......................XXX.A,X-XXXX,XX-XXX---X..........,,,..........X-------------
-X,,............................X-AE,:.:X-X+XXX-X..........,,,..........X-------------
-X,,........................,,,.XXX.,...X-X.,EX-X..........,,,..........X-------------
-X,,........................,H,.,XAE,.:.X-X.XXX-X..........,,,..........X-------------
-X,,........................,,,.XXX.,...XXX.XXX-X..........,,,..........X-------------
-XH,...........................HX-XE,W........X-X..........,,,..........X-------------
-XXXXXXXXXXXXXXXXXXXXXXXX,XXXXXXX-AXX...XXXXX.X-X..........,,,..........X-------------
-------------XXXXXXXXXXXX,XXXXXXXXX-X...XWX-X.X-X..........,,,..........X-------------
-------------XA..H..H.......H...A.X-X,,,X.:XX.X-X..........,,,..........X-------------
-------------X.E.........A........XXX.A.A,.AX.X-X.........,,,,..........X-------------
-------------X.....................HXXX,,,XXX,XXX...........,...........X-------------
-------------XXXX.H...H......A..H...X-X...X-X.,XX.......................X-------------
---------------X.+.......H.........HX-X.E.X-XE,XX.......................X-------------
------------XXX:..XXXXXXXXXXXXXXXXXXX-X...X-X.,XX.......................X-------------
------------X.A+:X------------XXXXXXXXX,,,X-X.,XX.......................X-------------
------------X..XXXXXXX--------X.,.,E......X-X.,XX.......................X-------------
------------X:.X-X...X---XXXXX..,.XXX...X..XX:,XX.......................X-------------
----------XXX..X-XE..X---X,,,...,.X-X..XX..,..,XX.......................X-------------
----------X....XXX...XXXXX,,,...,..XX.X--XX...,XX.......................X-------------
----------X....,.,...,.EXX..,...,..XXEX-XX...,.XX.......................X-------------
----------X.W..XX,.:.,...,,.,....,..X,XX.E..,..XX.......................X-------------
----------X....XX,...,E..,.,,...E,.........,.E.XX.......................X-------------
----------X.A...,,..XX,XXX,,,.....,,,,,,,,,....XX.......................X-------------
----------X.....XX..XX,X-X,,,..................XX.......................X-------------
----------X,XXXXXXE.XX,X-X+XXX...W........ttt..XX.......................X-------------
----------X+X-XXXX..XX,X-X,XX-X...........tTt..XX.......E.......E.......X-------------
----------X,X-XHXXEEXX.XXX..X-X...........ttt..XX..,,,.,,,.,,,.,,,.,,,..X-------------
----------X,X-X,XX,XXX.,,,..X-X......XXX.......XX..,A,.,E,.,A,.,E,.,A,..X-------------
------XXXXX,X-X,XXXX-XXXXX..X-X.....,XXX,......XX..,,,.,,,.,,,.,,,.,,,..X-------------
------X.....X-X...AXXA,.XXHXXX.....,.,.,.,.....XX...E.......E.......E...X-------------
------X.,,,.XXX...,,H,,.,XXXX.A.A.,..,,...,....XX..,,,.,,,.,,,.,,,.,,,..X-------------
------X.,.,.,.,H.,H+,,.H,.+,,.....,..,,...,....XX..,E,.,H,.,E,.,H,.,E,..X-------------
------X:,H,.,.,..,,H,,..,.+,,.A.,XX,.,,,..XX.,.XX..,,,.,,,.,,,.,,,.,,,..X-------------
------X.,.,.,.,.,,.,,.W.,.+,,.,,,XX.,,,,,,XX,,.XX.......................X-------------
------X.,,,.XXXH,,H,H...,.XXX,..WXX,.,,,..XX,.,XX.......................X-------------
------X.....X-X.,XXX,..H,X---X...,,..,,...,,..,XX.......................X-------------
------XXXXXXX-X,AX-AXXX,X-----X..,,..,,...,,..,XX.......................X-------------
--------------X:X--XXXX,X-----X...,,.,.,.,,.:.,XX.......................X-------------
--------------XHX--X,XXHX-----X,.,,.XXtXX.,..,.XX.,,................,,..X-------------
--------------X.X-X.HXXXX-----X,,...XXHXX,,,.,.XX.,:,...............,:,.X-------------
--------------X,XX,,,,,XX-----XX,,,XX---XX,,,XXXX.,,,...............,,,.X-------------
--------------X.....H...X-----XX,,,XX---XX,,,XX-X.......................X-------------
--------------X.........X------XXXXX-----XXXXX--X,,,,,,,,,,,,,,,,,,,,,,,X-------------
--------------X..H.....HX----------------XXXXXXXX.......................X-------------
--------------X,,,,,,,,,X----------------X..Et.XX.,,................,,..X-------------
--------------X,,,,,,,,,X----------------XE..t.XX.,:,...............,:,.X-------------
---------XXXXXX.A.....A.X----------------X..Et.XX.,,,...............,,,.X-------------
---------X...,+E.HEEEH.EX----------------X...t.XX.......................X-------------
---------X.XXXXXXXXXXXXXX---XXXXXXXXXXXXXXXXXXXXX.......................X-XXXXX-------
---------X.X----------------X...........X-XH..X-X.......................X-X..HX-------
---------X.X-----------X----X...........X-X.A.XXX.......,,,,,,,,,......XXXX.A.X-------
---------X.X---------XX:XX--X...........X-X...,.,.......XX..A..X,.......,.,...X-------
---------X.X--------X.>>>.XXX.......ttt.X-X.E.,.,.......,.,,,,,.,.......,.,.E.X-------
---------X.XX-------X.>.>.,+,.......tWt.X-X...,.,.......,.,...,.,.......,.,...X-------
---------X...XX-----X.>>>.XXX.......ttt.X-X.A.,.,.......,A,.W.,A,.......,.,.A.X-------
---------XXXX--XXX---X.H.X--X...........X-X...,.,.......,.,...,.,.......,.,...X-------
-------------XX---XXX-X.X---X...........X-X.E.,.,.......,.,,,,,.,.......,.,.E.X-------
---------------XXX---XXX----X...........X-X...,.,.......XX..A..X,.......,.,...X-------
------------------XXX--XXX--XXXXXXXXXXXXX-X.A.XXX.......XX,,,,,X,......XXXX.A.X-------
---------------------XX---XXX-------------XH..X-X......................XX-X..HX-------
-----------------------XXX---XX-----------XXXXX-X.......................X-XXXXX-------
--------------------------XXX--XXX--------------X.......................X-------------
-----------------------------XX---XXX-----XXXXX-X.......................X-XXXXX-------
-------------------------------XXX---XX---X...X-X.......................X-XtttX-------
----------------------------------XXX--XXXX...XXX.......................XXXt.tX-------
-------------------------------------XX.,.,...,.,.......................,.,tttX-------
---------------------------------------XXXX...,.,.......................,.,,,,X-------
------------------------------------------X...,.,.......................,.,...X-------
------------------------------------------X...,.,.......................,.,.K.X-------
------------------------------------------X...,.,.......................,.,...X-------
------------------------------------------X...,.,.,,......<.W.<.....,,..,.,...X-------
------------------------------------------X...,.,.,:,...............,:,.,.,...X-------
------------------------------------------X,,,XXX.,,,.......<.......,,,.XXX...X-------
------------------------------------------X...X-X.......................X-X...X-------
------------------------------------------X...X-XXXXXXXXX,,,,,,,XXXXXXXXX-X...X-------
------------------------------------------X...X---------X.......X---------X...X-------
------------------------------------------X...X-------XXX,,,,,,,XXX-------X...X-------
------------------------------------------X...X-------X...........X-------X...X-------
------------------------------------------X...X-------X.A.E.A.E.A.X-------X...X-------
------------------------------------------X...X-------XH.........HX-------X...X-------
------------------------------------------X...X-------XXXXXXXXXXXXX-------X...X-------
------------------------------------------X...X---------------------------X...X-------
------------------------------------------X,,,XXXXXXXXXXX-XXXXXXXXXXXXXXXXX,,,X-------
------------------------------------------X.............X-X...................X-------
------------------------------------------X.XXX.........X-X...XXX.........XXX.X-------
------------------------------------------X.X-X.........X-X...X-X.........X-X.X-------
------------------------------------------X.XXX.........XXX...X-X.........XXX.X-------
------------------------------------------X...................X-X.............X-------
------------------------------------------XXXXXXXXXXXXXXXXXXXXX-XXXXXXXXXXXXXXX-------
