---------------------------------------------------------------------------------------------------------------XXXXXXXXXXXXXXXXXXXX------------------------
--------------------------------------------------------------------------------------------------------------X..E...E............X------------------------
-------------------------------------------------------------------------------------------------------------X.,,,,,,,,,,,,,,,,,,,.X-----------------------
------------------------------------------------------------------------------------------------------------X.,..................,.X-----------------------
------------------------------------------------------------------------------------------------------------X,....................E.X----------------------
-----------------------------------------------------------------------------------------------------------X.,....................,.X----------------------
----------------------------------------------------------------------------------------------------------X.,..........:...........,X----------------------
---------------------------------------------------------------------------------------------------------X.,.......................,.X---------------------
--------------------------------------------------------------------------------------------------------X.,........................,EX---------------------
-------------------------------------------------------------------------------------------------------X.,..........................,.X--------------------
-------------------------------------------------------------------------------------------------------X.,................,,,,,.....,.X--------------------
------------------------------------------------------------------------------------------------------X.,.....H...........,...,.....,.X--------------------
-----------------------------------------------------------------------------------------------------X.,...........ttt....,.E..,.....,.X-------------------
----------------------------------------------------------------------------------------------------XA,............tTt....,....,.....,.X-------------------
---------------------------------------------------------------------------------------------------X.,.............ttt....,.....,.....E.X------------------
--------------------------------------------------------------------------------------------------XA.,....................,..E..,.....,.X------------------
--------------------------------------------------------------------------------------------------X.,...,.................,......,....,.X------------------
-------------------------------------------------------------------------------------------------XA,...,T,,.....A.........,......,.....,.X-----------------
------------------------------------------------------------------------------------------------X.,....,.,,,..A..A........,.E.....,....,EX-----------------
-----------------------------------------------------------------------------------------------XW,....,.,K,....W..........,....,,,,.....,.X----------------
----------------------------------------------------------------------------------------------X.,......,,,,..A...A........,,,,,.........,.X----------------
---------------------------------------------------------------------------------------------X..,........,.....A........................,.X----------------
---------------------------------------------------------------------------------------------X.,.....................,H..................,.X---------------
--------------------------------------------------------------------------------------------X.,......................,,..................,.X---------------
-------------------------------------------------------------------------------------------X,,...............:.......,H..................,E.X--------------
------------------------------------------------------------------------------------------X.t.....H................,,,H,,...........H.....,.X--------------
-----------------------------------------------------------------------------------------X..,.......................,HHH..................,.X--------------
----------------------------------------------------------------------------------------X..,..........................,....................,.X-------------
----------------------------------------------------------------------------------------X.,,,,,,,,,,,,,,..........................,,,,,,,,,,.X-------------
---------------------------------------------------------------------------------------X................,,,,,,,,,,,,,,,,,,,,,,,,,,............X------------
--------------------------------------------------------------------------------------X...........................XXXXXXXXXXXXXXXXXXXXXXXXXXXXX------------
-------------------------------------------------------------------------------------XXXXXXXXXXXXXXXXXXXXXXXXXXXXX-----------------------------------------
-----------------------------------------------------------------------------------------------------------------------------------------------------------
-----------------------------------------------------------------------------------------------------------------------------------------------------------
-----------------------------------------------------------------------------------------------------------------------------------------------------------
-----------------------------------------------------------------------------------------------------------------------------------------------------------
-----------------------------------------------------------------------------------------------------------------------------------------------------------
-----------------------------------------------------------------------------------------------------------------------------------------------------------
-----------------------------------------------------------------------------------------------------------------------------------------------------------
-----------------------------------------------------------------------------------------------------------------------------------------------------------
-----------------------------------------------------------------------------------------------------------------------------------------------------------
-----------------------------------------------------------------------------------------------------------------------------------------------------------
-----------------------------------------------------------------------------------------------------------------------------------------------------------
-----------------------------------------------------------------------------------------------------------------------------------------------------------
-----------------------------------------------------------------------------------------------------------------------------------------------------------
-----------------------------------------------------------------------------------------------------------------------------------------------------------
----------------------------------------------------------------------------------------XXXXXXXXXXXXXXXXXXXXXXXXX------------------------XX----------------
----------------------------------------------------------------------------------------X........................XXXXXXXXXXXXXXXXXXXXXXXXXXXX--------------
----------------------------------------------------------------------------------------X..A................................................X--------------
----------------------------------------------------------------------------------------X.................................................A.X--------------
----------------------------------------------------------------------------------------X...A............................................A..X--------------
----------------------------------------------------------------------------------------X....................,..............................X--------------
----------------------------------------------------------------------------------------X...................,.,.............................X--------------
----------------------------------------------------------------------------------------X..................,...,.............W..............X--------------
----------------------------------------------------------------------------------------X.................,.W.,.............................X-----XXXXXXXXX
----------------------------------------------------------------------------------------X..................,,.,.............................X-----X..t.t..X
----------------------------------------------------------------------------------------X....................,..............................X-----X..tTt..X
----------------------------------------------------------------------------------------X...................................................X-----X.......X
----------------------------------------------------------------------------------------X...................................................X-----X.......X
----------------------------------------------------------------------------------------X.........................................H.........X-----X.......X
----------------------------------------------------------------------------------------X...................................................X-----X.......X
----------------------------------------------------------------------------------------X...................................................X-----X.......X
----------------------------------------------------------------------------------------X..XXXXXXXXXXXXXXXXXXXXXXXXX........................X-----X.......X
----------------------------------------------------------------------------------------X.AXXXXXXXXXXXXXXXXXXXXXXXXX........................X-----X.......X
----------------------------------------------------------------------------------------X..XX....E.E.........E..E..X........................X-----X...:...X
----------------------------------------------------------------------------------------X.AXX.E......EE.E.E.E....E.X........................X-----X.......X
----------------------------------------------------------------------------------------X..XX...E.E............E...X........................X-----X.......X
----------------------------------------------------------------------------------------X.AXX.E....E.EE.E.E.EE....EX........................X-----X.......X
----------------------------------------------------------------------------------------X..XX...EE............E....X........................XXXXXXX.......X
----------------------------------------------------------------------------------------X..XX.E....E.EE.E.EE.E..E.EX.............A..........LL....,.W.....X
----------------------------------------------------------------------------------------X..XX...EE..............E.EX........................LL....,.......X
----------------------------------------------------------------------------------------X..XX.E.EE.EE.E.EE.E..E....X........................LL....,.......X
----------------------------------------------------------------------------------------X..XX........,,,<,,....E.E.X........................XXXXXXX.......X
----------------------------------------------------------------------------------------X.AXX.EE.E.EE,....,E.E.....X........................X-----X.......X
----------------------------------------------------------------------------------------X..XX........,....,.....................W...........X-----X.......X
----------------------------------------------------------------------------------------X.AXX.KE.E.EE,<.<.,.................................X-----X....H..X
----------------------------------------------------------------------------------------X..XX........,....,........XX.......................X-----X.......X
----------------------------------------------------------------------------------------X..XX.EE.E.EE,.:<.,E.E.E.E.XX............A..........X-----X.......X
----------------------------------------------------------------------------------------X.AXX.EE...E.,,,,,,..E.E.E.XX.......................X-----X...H...X
----------------------------------------------------------------------------------------X..XX....E..E.E.EE.E.......XX.......................X-----X.......X
----------------------------------------------------------------------------------------X..XX.E..............E.E..EXX.......................X-----X.......X
----------------------------------------------------------------------------------------X..XX..E...EE.E.E.E........XX.......................X-----X...H...X
----------------------------------------------------------------------------------------X..XX....E..........E.E..E.XX.......................X-----X.......X
----------------------------------------------------------------------------------------X.AXX..E...EE.E.E.E........X........................X-----X.......X
----------------------------------------------------------------------------------------X..XX...E.....E.....EE..E..X........................X-----X.......X
----------------------------------------------------------------------------------------X.AXX.E..E.E....E.E......E.X........................X-----X.......X
----------------------------------------------------------------------------------------X..XX........E......E.EE...X........................X-----X.,,,,..X
----------------------------------------------------------------------------------------X.AXXXXXXXXXXXXXXXXXXXXXXXXX........................X-----X.,H,,..X
----------------------------------------------------------------------------------------X..X-----------------------X.........A.......W......X-----X:,E,,:.X
----------------------------------------------------------------------------------------X..XXXXXXXXXXXXXXXXXXXXXXXXX........................X-----X.,,,,..X
----------------------------------------------------------------------------------------X................A.A.A.A............................X-----XXXXXXXXX
----------------------------------------------------------------------------------------X...................................................X--------------
----------------------------------------------------------------------------------------X...................................................X--------------
----------------------------------------------------------------------------------------X...................................................X--------------
----------------------------------------------------------------------------------------X...................................................X--------------
----------------------------------------------------------------------------------------X...................................................X--------------
----------------------------------------------------------------------------------------X..A................................................X--------------
----------------------------------------------------------------------------------------X................................................A..X--------------
----------------------------------------------------------------------------------------X.A................................................AX--------------
----------------------------------------------------------------------------------------X...................................................X--------------
----------------------------------------------------------------------------------------XXXXXXXXXXXXXXXXXXXXXXXXXXX,,,XXXXXXXXXXXXXXXXXXXXXXX--------------
------------------------------------------------------------------------------------------------------------------XLLLX------------------------------------
------------------------------------------------------------------------------------------------------------------X...X------------------------------------
------------------------------------------------------------------------------------------------------------------X.E.X------------------------------------
------------------------------------------------------------------------------------------------------------------X...X------------------------------------
------------------------------------------------------------------------------------------------------------------X...X------------------------------------
------------------------------------------------------------------------------------------------------------------X...X------------------------------------
-------------------------------------------------------------X----------------------------------------------------X.E.X------------------------------------
-------------------------------------------------------------XXX--------------------------------------------------X...X------------------------------------
-------------------------------------------------------------X..XX------------------------------------------------X...X------------------------------------
-------------------------------------------------------------X.E..XX----------------------------------------------X...X------------------------------------
---------------------------XXXXXXXXXXXXXX--------------------X......X---------------------------------------XXXXXXX,,,XXXXXX-------------------------------
---------------------------X.............XXXXXXXXXXXXX-------X.......XX-------------------------------------X:.............X-------------------------------
---------------------------X..........,,.............X-------X.E.......XX-----------------------------------X............:.X-------------------------------
---------------------XXXXXXX.........,.,,............X-------X...........XX---------------------------------X..............X-------------------------------
-------------------XX......,......E..,,Ht,...E.......X-------X.E...........XX-----------------------XXXXXXXXX.......:......X-------------------------------
------------------X........,.........,tt.............X-------X...............X-------------------XXX.,,:....,..W...........X-------------------------------
----------------XX.........,.........................X-------X.........,,.....XX-----------------X.WA.A.....,..............X-------------------------------
---------------X.....XXXXXXX.........................X-------X.........,.,,.....XX---------------X,,XXXXXXXXX..............X-------------------------------
--------------X.tE..X------X.........................X-------X.........,...,......XX-------------X..X-------X..............X-------------------------------
-----------+-X..t.XX-------X.........................X-------X........H,...,.....H.HX------------X.AX-------X..............X-------------------------------
----------X.XX...X---------X.........................X-------X.........,...,........X------------X..XX------X..............X-------------------------------
---------X..,+X.X----------X.........................X-------X........H,...,........X------------X.A,:------XA...........:.X-------------------------------
---------X...XXX-----------X.........................X-------X........H,...,...H....X------------X..,X------X..............X-------------------------------
--------X.....X------------X.........................X-------X........H,...,........X------------X..XX------XXXXXXXXXXXXXXXX-------------------------------
-------X......X------------X.........................X-------X.....H...,,..,........X------------X.AX------------------------------------------------------
------X........X-----------X.........................X-------X...........,,,........X------------X..X------------------------------------------------------
------X.........X----------X.....,,.........,,.......X-------X.............,........X------------X.AX------------------------------------------------------
-----X..........X----------X..:..,,....K....,,.......X-------X.......................X-----------X..X------------------------------------------------------
----X............X---------X.....,,.........,,...:...X-------X......H................X-----------X..X------------------------------------------------------
---X..............X--------X.....,,.........,,.......X-------X..........H...H........X-----------X.AX------------------------------------------------------
--X...t...........X--------X.....,,.........,,.......X-------X.......................X-----------X..X------------------------------------------------------
--X.ttt............XXXXX---X.....,,.........,,.......X-------X.......................X-----------X..X------------------------------------------------------
-Xtt..t............,....XXXX,,,,,,,,,,,,,,,,,,,,,,...X-------X.......................X-----------X,,X------------------------------------------------------
X.t...t,...W.......,.......,.....,,.........,,....,,,XXXXXXXXX.......................X----------X...X------------------------------------------------------
-Xt..t.,...........,.......,.....,,.........,,.......,.......,.......................XXXXXXXXXXX...,X------------------------------------------------------
-X.ttt.............,.......,.....,,....T....,,.......,.......,.......................,......++...,,.X------------------------------------------------------
--X..t.............,.......,.....,,.........,,.......,.......,..W.................E..,......++...,:X-------------------------------------------------------
--X................,.......,.....,,.........,,.......,.......,.......................,......++...XX--------------------------------------------------------
---X...............XXXXXXXXX,,,,,,,,,,,,,,,,,,,,,,,,,XXXXXXXXX.......................XXXXXXXXXXXX----------------------------------------------------------
----X.............X--------X.....,,.........,,.......X-------X.......................X---------------------------------------------------------------------
----X............X---------X.....,,.........,,.......X-------X.......................X---------------------------------------------------------------------
-----X..........X----------X.....,,.........,,.......X-------X.......................X---------------------------------------------------------------------
-----X.........X-----------X.:...,,....:....,,.......X-------X.......................X---------------------------------------------------------------------
------X.......X--XXXXXXXX--X.....,,.........,,...:...X-------X.......................X---------------------------------------------------------------------
-------X.....X---X.E....X--X................,,.......X-------X.......................X---------------------------------------------------------------------
-------X....X----X...E..X--X.........................X-------X.......................X---------------------------------------------------------------------
--------X..X-----X......X--X.........................X-------X.......................X---------------------------------------------------------------------
--------X.X------XE.E.E.X--X.........................X-------X..........H...H........X---------------------------------------------------------------------
---------X-------X.,,,..X--X.........................X-------X.............,.........X---------------------------------------------------------------------
-----------------E.,.,..X--X.........................X-------X.......H...,,,.....E...X---------------------------------------------------------------------
----------------X.,.T,E.X-X..........................X-------X..........,..,.........X---------------------------------------------------------------------
----------------X.,,,,.X--X..........................X-------X.........H,..,.........X---------------------------------------------------------------------
----------------XE..E..X--X..........................X-------X.....H...H,..,.....E...X---------------------------------------------------------------------
----------------X....E.X--X..........................X--------X........H,..,.........X---------------------------------------------------------------------
----------------X......X--X..........................X--------X........H,..,.........X---------------------------------------------------------------------
----------------XE..E..X--X..........................X--------X.........,..,.....E...X---------------------------------------------------------------------
----------------XXXX.E.X--X......E...,tHt,...........X--------X.........,..,.........X---------------------------------------------------------------------
--------------------XXXX--X..........,,,,,...E.......X--------X.E.......,.,,.........X---------------------------------------------------------------------
--------------------------X...........,,,........T...X--------X.........,,.........HHX---------------------------------------------------------------------
--------------------------X.............XXXXXXXXXXXXXX--------X.....................XX---------------------------------------------------------------------
--------------------------XXXXXXXXXXXXXX----------------------X.E................XXX-----------------------------------------------------------------------
--------------------------------------------------------------X..............XXXX--------------------------------------------------------------------------
--------------------------------------------------------------X.........H.XXX------------------------------------------------------------------------------
--------------------------------------------------------------X.E......XXX---------------------------------------------------------------------------------
--------------------------------------------------------------X....XXXX------------------------------------------------------------------------------------
--------------------------------------------------------------X.XXX----------------------------------------------------------------------------------------
--------------------------------------------------------------XX-------------------------------------------------------------------------------------------
