--------------------------------XXXXXXXXX------------------------
--------------------------------XE,.W.,EX------------------------
--------------------------------X.,,,,,.X------------------------
--------------------------------X.X,,XX.X------------------------
--------------------------------X.X,,HX.X------------------------
--------------------------------X.H,,XX:X------------------------
--------------------------------X.X,,HX.X------------------------
--------------------------------X.H,,XX.X------------------------
--------------------------------X.X,,HX.X------------------------
--------------------------------X.H,,XX.X------------------------
--------------------------------XAX,,HXAX------------------------
--------------------------------X.H,,XX.X------------------------
--------------------------XXXXXXX++X,XX+XXXXXXX------------------
-------------------------X:..,,....,.,....,,..:X-----------------
------------------------X...,,.....,,,.....,,,.X-----------------
-----------------------X,,,,,......,.,......,,,,X----------------
----------------------X,,,,,......E,W,E.......,,,X---------------
---------------------X.............,.,............XX-------------
----------------XXXXX..............,,,..............X------------
-----------XXXXX,..................,.,...............XXXXX-------
-----------X:,,W,..................,W,...................,XXXXX--
-----------XXXXX,..................,.,...................,W,,:X--
----------------X..................,,,...................,XXXXX--
---------------X...................,.,...................X-------
--------------X...................E,A,E...................X------
-------------X.....................,.,.....................X-----
------------X......................,,,......................X----
-----------X.......................,.,.......................X---
---------XX...................XXXXXX,XXXXXXX..................X--
---------X,A................XX..............X................AX--
---------X,................X.................X................XXX
---------X,................XA.......,.......AX................+AX
---------X,...............X...E.....,.....E..XX...............+WX
---------X,...............X........,,,.......XX...............+AX
---------X,...............X,.................XX.....:.........XAX
---------X,.........W.....,.,.....,,,,......,,,...............X--
---------X,A.....XX,,,X...,W,HHHHHH,H,HHHHHH,W,..XX,,,X......AX--
---------X,.......X...X...,.,.....,,,,......,,,...X...X.......X--
-------XXX,.........W.....X,......,,,,.......XX.....W.........XXX
XXXXXXXXHt,...............X........,,,.......XX...............tHX
XE.E.E+,Tt,...............X...E....,.,....E..XX...............tTX
XXXXXXXXHt,...............X.........,........XX...............tHX
-------XXX,................XA...............AX................XXX
---------X,A................XX..............X................AX--
---------XX...................XXXXXX,XXXXXXX..................X--
-----------X.......................,.,.......................X---
------------X......................,,,......................X----
-------------X.....................,.,.....................X-----
--------------X...................E,A,E...................X------
---------------X...................,.,...................X-------
----------------X..................,,,..................X--------
-----------XXXXX,..................,.,..................,XXXXX---
-----------X:,,W,..................,W,..................,W,,:X---
-----------XXXXX,..................,.,..................,XXXXX---
----------------XXXXX..............,,,..............XXXXX--------
---------------------X.............,.,.............X-------------
---------------------X..,,,,......E,W,E.......,,,.X--------------
----------------------X,,,,,,......,.,......,,,,.X---------------
-----------------------X....,,.....,,,.....,,,..X----------------
------------------------XX:.,,.....,.,.....,,.:X-----------------
--------------------------XXXXXXX+XX,X++XXXXXXX------------------
--------------------------------XAX,,XXAX------------------------
--------------------------------X.X,,AX,X------------------------
--------------------------------X,A,,XX,X------------------------
--------------------------------X.X,,XX,X------------------------
--------------------------------X,X,,AX,X------------------------
--------------------------------X.A,,XX,X------------------------
--------------------------------X,X,,AX,X------------------------
--------------------------------X.A,,XX,X------------------------
--------------------------------X,X,,AX,X------------------------
--------------------------------XE,,,,,EX------------------------
--------------------------------X.,.W.,.X------------------------
--------------------------------XXXXXXXX-------------------------
