---------------XXXXXXXXXXX------------------------------------------------------------------------------------------------------
---------------X.........X----------------------XXXXX---------------------------------------------------------------------------
---------------X.........X----------------------X.K.X---------------------------------------------------------------------------
---------------XEXXXXX..EX----------------------X,,,X---------------------------------------------------------------------------
---------------X.X---X,,,X----------------------X,,,X---------------------------------------------------------------------------
---------------X.X---X,,,X-----------XXXXXXXXXXXX,,,XXXXXXXXXXXX----------------------------------------------------------------
---------------X.X---X,,,XX----------HHHHHHHHHH................X----------------------------------------------------------------
---------------X.X--XX,,,,XXXXXXXXXXXX,,,,,,,,,,.............H.X----------------------------------------------------------------
---------------X.X--X...E..t..,,.X:..,.T.....,..,,,,..........EX----------------------------------------------------------------
---------------XEX--X.E..E.t..,,.X...,,,,,,,,,,..T..,,......E..X----------------------------------------------------------------
---------------X.X--X......t.,,,.,.A.,,,,,,,,,,,,,,..,.........X------++X-------------------------------------------------------
---------------X.X--X.E.E..t.,,,.,...,,,,,,,,,,,,,,,,.,........X------X.X-------------------------------------------------------
---------------X.X--X.....t.,,.,.,.................,,T,.......AX---XXXX,XXXXXXXXXXXXXXXXXXXXXXXXXXXXXX--------------------------
---------------X.X--X.E.Et..,..,.,...XXX...XXX.....,,,.,.......X---X.:...:.........,......E.HHHHHHHHHX--------------------------
---------------X.X--X.E.t..,...,.X...X-X...X-X.....,,,,.,......X---X...............,.................X--------------------------
---------------X.X--X...t..,...,.X..HXXX...XXX...XXX,,.T,......X---X.........,,,E..,.................X--------------------------
---------------X.X--X.E.t.,....,.X.........,,,...X-X.,,,,,.....XX--XHHHHHHHHH,.,...,................AX--------------------------
---------------X.X--X...t.,....,.,.........,H,...XXX.,,.T,.....,XXXX,,,,,,,,,,,,,,,,,HHHHHHHHHH,.....X--------------------------
---------------XEX--X.Et.,,....,.,.........,W,.......,,,,,,....,XX.,.........,,,...,...........,.....X--------------------------
---------------X.X--X.Et.,,....,.,..E......,A,.......,,,T.,....,,,.,.........,,,...,...........,A....X--------------------------
---------------X.X--X..t.,,....,.,.........,A,.......,,,,,,....,XX.,...............E...........,....AX--------------------------
---------------X.X--X.Et.,,....,.,.........,.,...XXX.,,,T.,....,XXXX...............,...........,.....X--------------------------
---------------X.X--X...t.,....,.X.........,A,...X-X.,,,,,.....XX--X,,A,...........,...........,A....X--------------------------
---------------X.X--X.E.t.,....,.X...XXX...XXX...XXX,,,..,.....X---X...,...........,...........,.....X--------------------------
---------------XEX--X..Et..,...,.X...X-X...X-X.....,.,.T,......XXXXX...,..,HHHHHHHHH,..........,A....X--------------------------
---------------X.X--XE..t..,...,.,...XXX...XXX.....,,,,.,,,..H.,.HXX:..,..,,XXXXXXXXE..........,.....X--------------------------
---------------X.X--X..E.t..,..,.X.................,,T.,,,,..H.,..XX...,..,,X------X,..........XXX...X--------------------------
---------------X,X--X.....t..,.,.X...,,,,,,,,,,,,,,,,.,.,,,..H.,..,,...,..,,X------X,..........X-X...X--------------------------
---------------X.X--X.E..E.t.,,,.L,..,,,,,,,,,,,,,,.,.,.,,,..H.,..,,...,,,,,X------X,..........X-E...X--------------------------
---------------X.X--X.....Et..,,.L,..,,,,,,,,,,..T..,,..,,,..H.,..,,.....:..X------X...........X-X,X.X--------------------------
---------------X.X--X.H.E..t..,,.L.,.,.T.....,..,,,,....,,,..H.,..XX:.......X------X...........X-X.X.X--------------------------
---------------X.X--XX,,,,XXXXXXXXXXXX,,,,,,,,,,......E.,,,..H.,.EXX........X------X..,,,,,,...X-X,X.X--------------------------
---------------X.X---XX,,XX--XXXXXXXXXH.................,,,..H.XXXXX...E....X------XE.,E,,.,...X-X.XEX--------------------------
---------------X.X----X..X--+HHHHHH.XXXXXXXXXXXXXXXXXXXXXXXXXXXX---XXXXXX,,,XXXXXXXX,,,,,,,,,,,XXX,XXXXXXX----------------------
---------------X.X----X,,X--+,...E..X------------------------------XE....A...A...,.............XH,.,......X---------------------
---------------X.X----X..X--XX......XXXXXXXXXXXXXXXXXX-------------X.............,,,,,.........X.,,,......X---------------------
---------------XEX----X,,XXXXX............,..........X---------XXXXX.................,.........XE,.,.......X--------------------
---------------X.X----X.,,.E+,.....E...E..,..........X---------:.....................,...XXX...XE,,,........X-------------------
---------------X,X----X,E,.,X,............,..........X---------X...........E.........,...X-XE..X.,.,.........X------------------
---------------X.X----XXXXXX-X,,,,,,,,,,,,,..........X--------XX.........XXX.....XXX.,...XXX...XE,,,.........X------------------
---------------X.X-----------X,,,,,...........:......X--------X,.........X-X.....X-XE,.......H.X.,.,...E......X-----------------
---------------XEX-----------X,...,,.................X--------X,...XXX...XXX.....XXX.,.........X.,,,...........X----------------
---------------X.X-----------X,,,,..,W,,.............X--------X,E..X-XE..............,.........X.,E,............X---------------
---------------X.X-----------X,,,,....,,,,,..........X--------XX...XXX...............,.........X.,,,.....H......X---------------
---------------X.X-----------X,,,,....,,.,,........EEX---------X...........E.........,....E...HX.,.,........E.E..X--------------
---------------X.X-----------X,,,,....,,.,,.....,,,,,X-----XHXXX....A..XXXXXXXXXXXXXXXXXXXXXXXXX.,,,...,,,,,,,,,,X--XXXXXXXX----
---------------X.X-----------X,,,,....,,,,......,H...X-----XH..........X-----------------------X.,.,...XXXXXXXXXXX--XE..H...XX--
---------------X.X-----------X,...,,,,,........E,,...X-----XH..........XXXXXXEXXXXXHHHHHHHHHX--X.,,,...,,,,,,,,,,XXXX.........X+
---------------X.X-----------X,,,,,.............,,...X-----XH..........X.E..,..E.EE...E.E.E.X--X.,.,...,.,.,.,.,.,.+,.........,+
---------------X.X-----------X..................,,..EX-----XH....XXX...X.XXXXXXX,,,,E,,,,XXXXXXX.,,,...,,,,,,,,,,XXXX.........XX
---------------X.XXXXXXXXXXXXX..................,,E..X-----XH....X-XE..X.E-X,,,,,,,,,,,,,,,,,,,X.,.,...XXXXXXXXXXX--X......E.X--
---------------X.,....,.....+,..................,,...X-----XH....XXX...X.E-XA.................,X.,,,...XXXXXXXEXXX--XE...E..X---
---------------X.,....,.....X,.................E,,..EX-----XH..........X.XXX,.................,X.,.,...E.........X--XXXXXXXX----
---------------XXXXXXXXXXXXX-XXXXXXXXXXXXXXXXXXXXX,,,X-----X...........X.,.K,............E....,X.,,,............X---------------
-------------------------------------------------X...X-----X..........HX.,.,,...XX..XX...XX...,X.,.,.......E....X---------------
-------------------------------------------------X.,,XXXXX-X...XXXXXXXXXXXXX,...XX,,XX,,,XH...,X.,,,...........X----------------
---------------XXXXXXXXXXXXXXXXX-----------------X.,.....X-X...X----------XX....,,......E,H...,X.,.,..........X-----------------
---------------X..:............X----------------XXXX...E.XXX...X-----------X....XX..E..,,,H...,X.,,,......A...X-----------------
---------------X...............X-------------XXX..+,.....,E,..:X-XXXXXXXXXXX....XX.....,,,H...,X.,.,.........X------------------
---------------X.E.............X------------X---XXXX.....XXXXXXX-X.E.,.,.+.,....,+.....,,XH...,X.,,,........X-------------------
---------------X...............X------------X-XX---XE....XHHXHXXXX...,.XXXXX....XX....,,,XX...,X.,.,........X-------------------
---------------X:..............X-----------X-X-----XXX,XXXHH.H..,,.XXXXX---X....XX....,,,,....,X.,,,.......X--------------------
XXXXXXXX-------X...............X----------X.X--------XXX-XHH.H.E,,.X--XXXXXX....,,.....,,,....,X.,.,......X---------------------
:,..:>.X-------X..............TX----------X.X------------XHHXHXXXX.X--XE.HXX....XX,,XX,,,XX...,X.,,,....A.X---------------------
X,...>.XXXXXXXXX...............X----------XEX--------------------X.XXXX...XX...,XX,,XX,,,XX..H,XE,.,.XXXXX----------------------
X.,..>E,.......,...............X----------X.X--------------XXXXX-X.,..X...,+..,,,............H,XXX,XXX--------------------------
X..,.>.XXXXXXXXX...............X----------X,X--------------:..HX-X.,..,...XX..,,............EH,X-X.X----------------------------
X..,.>.X-------X...............X----------X.XXXXXXXXXXXXXXXX..HX-X.,..,.E.XX.......E......A..H,X-X.X-XXX------------------------
X...:XXX-------X......E........X----------X.++..........E..,..HX-X.,..,.H.XX.................H,X-X,X-X.H------------------------
X...X----------X:..............X----------XXXXXXX,,,,,,,XXXX..HX-X.,.EX...XXXXXXXXXXXXXXXXXXXXXXXX,XXX.HXXXXXXXXX---------------
X...X----------X...............X----------------XXXXXXXXX--X..HX-X.XXXX.E.XXXXXXXXXXXXXXXXXX,XXXE.A...,H,....E..X---------------
X...X----------X............E..X---------------------------X..HX-X,XXXX...XXE,.,E...A..........X.,,,...HXXXXXXX,X---------------
X...X----------X...............X---------------------------XE.HX-X.,.EXH..XX,,,,,,,,,,,,,,,,,,,X.,,,...HXXXXHXXHX---------------
X...X----------XH..:...........X--------XXXXXXXXXXX--------X...X-X.,..XH..XX.,...........,H+.,HX.,,,...HX..EHXXHX---------------
XXXXX----------XXXXXXXXXXXXXXXXX-------X.A...E..,..XXXXXX--X...X-X.,..XH.AXXE,.++++++++++,,,.,HX,..,...H,E..HXXHX---------------
---------------------------------------X........,........XXX.E.X-X,X..XH..XX.,.+++++++++++.+.,HXE.,....H,...HXXHX---------------
--------------------------------------X..,,,,,,,,,.........,...X-X.X..XHXXXX.,.+++.....E.+.E.,HXX,XXXX.HX..EHXEHX---------------
-------------------------------------X,..,........,,.......,...X-X.XE.X----X.,.+++.,,,...+.+.,HXX,X--XEHE...HXXHX---------------
-------------------------------------X.,,...........,,.....,.A.X-X.XHAX----X.,.+++.,K,...+.+.,HXX.X--X.XX.E.HXXHX---------------
-------------------------------------X..,............,.....XXXXXXX,XXXX----X.,.+++.,,,...+.+.,H,,EXXXX.XXXXXXXX,X---------------
-------------------------------------X..,....E........,.H.,XX---XE.EX------X.,.+++.......+.+.E.,,EXX...,,.......X---------------
-------------------------------------XH.,.............,,,,...XX-X...XX-----X.,.+++++++++++.+.,.,,.X,...,,.......X---------------
-------------------------------------X..,....................,X-X...+XXXXX-X.,.+++++++++++.+.,.,,EXE...,,......AX---------------
-------------------------------------X..,....................XX-X...++E,E.XX.,.+++++++++++++.,.,,.XXXX.,,.......X---------------
-------------------------------------X..,....................XX-X...+XXXX,XX.,E...A...EEE.EA.,EXX,XXXX.,,..E...AX---------------
-------------------------------------X..,...........,,.......,X-X...XX--X.XX,,,,,,,,,,,,,,XX,,,XX,XE,,.,,.......X---------------
-------------------------------------X.,,...........,,.......XX-X..EX---X.X-X,..E.........XX.,EXX.XE,,.,,...H...X---------------
-------------------------------------X,..,,,,,,,,,,,..,......X-XX,,,XXXXX,XXXX,,,,XXXX,,XXXXE,.,..X.,,.XXXXXXHXEX---------------
--------------------------------------X........,......,,,XXX,X+X.....:XA....X:,,,,XXXXLLXXXXXXXXXXXHXXEX------------------------
---------------------------------------X.H......,......E,X-XXX+,E....XXH....XX....XXXX,,X,XXHHHX--XHXX.X------------------------
----------------------------------------XXXXXX,XXXXX,XXXXXXX,XXX....HXXH...EXX....,............X--XHX,.X------------------------
---------------------------------------------X.X---X.XX:,E.,.,.......XXH....HXA....XXE...XX...HX--XHXX.XXXXX--------------------
---------------------------------------------X.X---X.XX.,..,.,.......XXH....HX.....+X....XX...HX--XHXX.,,EEX--------------------
---------------------------------------------X,X---X.XX.,...,.,,,,,,.XXH....HX.....,..........HX--XHXX.XXXXX--------------------
---------------------------------------------X.X---X.XX,,,,.,,,.,,,,.HXH....HX......,.........HX--XHXX.X------------------------
---------------------------------------------X.X---X.,+,,,H,,..,,,,,.XXH....HX......,....E.....XXXXHXX.X------------------------
---------------------------------------------X.X---X.XX,,,H..,,.,,,,.XX....EHX,.....,..........XX,XXXX.X------------------------
---------------------------------------------X.X---X.XX.,,HHHHH,...E.XX.....HX,......,................+X------------------------
---------------------------------------------X.X---X.XX.,,,,,,,,.....XX...E.HX.XXXXXXXXXXXXXXXXXXXXXXXXX------------------------
---------------------------------------------X.X---X.XX:XXXXXXXXXXXXX:X.XXXXXX.XXXXXXXXXXXXXXXX---------------------------------
---------------------------------------------X.X---X.XXXXXXXXXXXXXXXXXX,XXXXXX.,..E,,,,,,,,...X---------------------------------
---------------------------------------------X.X---X..,,.E............,.,,.....XXXXX,,,,,,,,,,XXXX------------------------------
---------------------------------------------X.X---XXXXXXXXXXXXXXXXXXXX,XXX,XX,XXXXXE...........HX------------------------------
---------------------------------------------X.X---------------------XX.X-X.XXXX...X............HX------------------------------
---------------------------------------------X.X---------------------X,.XXX,XXXX...X.....E......HX------------------------------
---------------------------------------------X.X---------------------XX.X...,..,.E.,...E........HX------------------------------
---------------------------------------------X.X-------------------XXXX.X,,,,..,...,............HX------------------------------
---------------------------------------------X.X-------------------XHXX.X......,...,....,,,,....HX------------------------------
---------------------------------------------X+X-------------------XEXX.X......,...X....,...,...HX------------------------------
---------------------------------------------X+X-------------------X.XX,X......,...X...,.....,..HX------------------------------
---------------------------------------------X<X-------------------XEXX.X,,,,,,,...X...,,,,,.,...X------------------------------
---------------------------------------------X.X------------------XX,XX.X..........X...,,XXX.,...X------------------------------
---------------------------------------------X.X------------------X,....X..........,A..,,X-X.,...X------------------------------
---------------------------------------------X<X------------------X,....,..A.......,...,,XXX.,...X------------------------------
---------------------------------------------X<X------------------X,.E..,..........,...,,,,,.,...X------------------------------
---------------------------------------------X.X------------------X,....,........A.X...,.....,...X------------------------------
---------------------------------------------X.X------------------X,....X..........X...,,,,,.,...X------------------------------
---------------------------------------------X<X------------------X,A...X........E.X...,,XXX.,..AX------------------------------
---------------------------------------------X.X------------------X,....XXXXXX,,,XXX...,,X-X.,...X------------------------------
---------------------------------------------X.X------------------XX,XX................,,XXX.,...X------------------------------
---------------------------------------------X.X-------------------XWXX.....E..........,,,,,.,...X------------------------------
---------------------------------------------X.X-------------------X.XX................,.....,...X------------------------------
---------------------------------------------X.X-------------------XEXX................,.....,E..X------------------------------
---------------------------------------------X.X----------------------X.................,,,,,....X------------------------------
---------------------------------------------X.X----------------------X.......E..................X------------------------------
---------------------------------------------X.X----------------------X.......................XXXX------------------------------
---------------------------------------------X.X----------------------X.E....................HX---------------------------------
---------------------------------------------X.X----------------------XXXXXXXXX,,,XXXXX,,,XXXXX---------------------------------
---------------------------------------------X.X------------------------------X...X---X...X-------------------------------------
---------------------------------------------X.X------------------------------XX,XX---XX+XX-------------------------------------
---------------------------------------------X.X-------------------------------X.X-----XWX--------------------------------------
---------------------------------------------X,X-------------------------------XHX-----X.X--------------------------------------
---------------------------------------------X.X-------------------------------X.X-----XAX--------------------------------------
---------------------------------------------X.X-------------------------------X.XXXXXXX.X--------------------------------------
---------------------------------------------X.X-------------------------------X.H.WWH.AAX--------------------------------------
---------------------------------------------X.X-------------------------------XXXXXXXXXXX--------------------------------------
---------------------------------------------X,X--------------------------------------------------------------------------------
---------------------------------------------X.X--------------------------------------------------------------------------------
---------------------------------------------X,X--------------------------------------------------------------------------------
---------------------------------------------X,X--------------------------------------------------------------------------------
---------------------------------------------X.X--------------------------------------------------------------------------------
---------------------------------------------XXX--------------------------------------------------------------------------------
