-------------------XXXXXXXXXXXXXXXXX-------------------------
-------XXXXXXXXXXXX........,....,...XXX----------------------
-------X:E.E,..............,....,..:,..X---------------------
-------XE...,..:............,...,...,.:X---------------------
-------X....,........EXXXXXXXXX.,...,..X---------------------
-------XHA.E,.....XXXX---------XXXXXXX,X---------------------
-XXXXXXXXXXXX,,XXX------------------X..X---------------------
-X..,.,,..,,,..XXXXXXXXXXXXXXXXXXXXXX..X---------------------
-X..,.,H...,,,,XX.....,....,....,...XX,X---------------------
-X..,.,,...,,..XX.....,....,....,...X.EX---------------------
-X..,.,,...,,..XX.....,.E..,....,...X..X---------------------
-X..,.,,...,,,,XX,,,,,XXX,XXXXXXX...XX,X---------------------
-X,,,,,H...,,..XX.....X-X.X....XX..A,..X---------------------
-X....,H.T.,,..XX..:..X-XEX..E.XX,,.,.:X---------------------
-X....,H...,,,,XX.....X-X,XttttXX..,XXXX---------------------
-X....,H..ELL..XX.....X-XHXttttXX...X------------------------
-X.E..,,HH.H,..XX.....X-X,XE...XX...X------------------------
-X,,,,XXXXXXXXXXX,,,,,X-X.XXXXXXX,,,XX-----------------------
-X,,,,X-----XXXXX.....X-X.X-X:,......X-----------------------
-X,,,,X----XX:,:X.....XXX,XXX,,......X-----------------------
-X....EX-XX,..,:X....HXH...AX.......:X---XXXX----------------
-X.:.XXXX,,H..XXX.....X.....X.......,XXXX.,..XX--------------
-X..XXX,,,,,..X-X.....,.....,,,,.....,,...,..,.XX------------
-H..,,,,,,EX,,X-X.....,...E.,K,,.T.E.++.E,..,...,XX----------
-X..,,,,,XXXE.X-X.T...,.....,,,,.....,,..,.,..,,.,,X---------
-X..,,,XX--X,,X-X.....X.....,.......:XXXXXXXXXX,,..X---------
-XXXXXX----X.EX-X.....X,,,,.XE......,X---------X,,,,X--------
-XXXXXXXXXXX,,XXX.....X...,.X........X----------X,,:,X-------
-H.....,,....A.XX.....XXX,XXX:,......X-----------X,,.X-------
-X....E,,......XX,,,,,X-X,X-X,,......X----XXX-----X,,,X------
-X.....,,.....,:X.....X-X.X-XXXX,,,XXX--XXX:X-----X..,,X-----
-:,..A.,,.....,XX.....X-XEX----X...X--XX,.E.XXXX--X,,..X-----
-X,,,,,,,......XX....EX-X.X----X.E.X--XH,XX,XXHX--X,,,,X-----
-X............EXX.....X-X,X----X...X-X,,XX,.X.X----XE,,X-----
-X.......:.,,,,XX.....X-X,X----X,,,X-X,.XXXXXEX----X,.,X-----
-X,........,,,,XX,,,,,XXX,XXXXXX...X-X.XXXXXX,XXXX-X.,,X-----
-:,........,,EEXX.....,....,.E.,...X-X,XX,....H.,X-X,,.X-----
-X...T,,,,E,E..XX.....,....,...,...XXEXX.......,,X-X,,,X-----
-X....,,,,,,,.EXX.....,....,...,...XX,XX...:..X.,X-X,.,X-----
X.....,H...,E.EXXXXXXXXXXXXXXXXXXXXX,X--X,...EX.,.XX,,,X-----
X.....,,...,,..XXXXXXXXXXXXXXXXXXX-X,X--X.,,,.XX,,X..,,X-----
X,,XXE,:,E.,,E,:X:....XX....,....X-X,X--XXX,,,XX.,,,...X-----
X,,X-XXXXXXXXXXXX....W,+....,....X-X-X----X...X-XE,.,.X------
X..X------------XE...HXXE...,.A...X,,X----X,,,X-XX,.XX-------
X...X---------XXXXX,XXXX,,,,,.....XX,X----X...X---XX-----XXX-
X..,X----XXXXXX,XXX,XXXX,,,XX,,,,,XX,X----X...X-X:X-----X,,,X
X,,.X----X,,,,.............XX:....XX-X----X..,XX.XX----X:..:X
-X,,,X---X,,,,.............XX,,,,,X-X,X---X,,,....XX---X....X
-X..,X---X,,,,.............XX....:X-X,X-XXXX,.,,...XX-X.....X
-X,,.X---X,,,,.............XX,,,,,X-X,X-:.,.,,..,,.XXX,.....X
-X,,,X---X,,,,.......,,,,,,XX.....X-X,X--X,,.....,.,,.,..E..X
-X...,X--X........:..,....,XX:....X-X,XXX.,......,.,,.,.....X
--X,,.X--X...........:,,,:,XX,,,,,X-XA,E,.,...,...,,,.,...H.X
--X..,X--X...........,K..E.XX....:XXXXXXX,...,.,..,XXX,..E..X
--X,,,,XXX...........,.,,,,XX,,,,,XX::--X,...,K,.:,X--X.....X
--X,,....X,,,,,,,,,..,E,,,,XX:....X-----X,...,,,..,.XXX.....X
--X......,,:,+++,,,..,.,.EAXX,,,,,X----X,A........,.:XX..E..X
--X......,,,.....,,..,.,tttXX.....:---X:X.,..E...,.XXXX.....X
--X.....E,,.E.E..,,.A,.,t.AXX,,,..X----XX.,,....,,.X--X.....X
--X,...XXXX:XXXXHXXXXX,XX,,XX...,,X------X..,,,,..H---X.....X
--X:XXX------------X-XEXXT,XX:....X------X........X---X,,,,,X
-------------------X-X.,EE.XX,,,,,X-------XX,,,XXX:--X......X
-------------------X-XE,..EXX....:X--------X,,,X-XX--X.E...X-
-------------------X-XXE.EHXX,,,,,XXXXXXXXX,,..X--XXX......X-
-------------------X---XXXXXX.:..E,,...H,,...,,XXX.........X-
-------------------X----XXXXX.....,,>>>.L,.H..........:....X-
---------------XXXXXXXXXX.,.X.,...,,>T>.L,..........E.....X--
---------------XE,t..tEXXE,.X,,...,,>>>AL,..E..EA.E......XX--
---------------X.,t..t.XX.,.XXXX,XXXXXXXXXXXXXX.......XXX----
---------------XE,t..tEXXXXXX--X<XXXXX---------XXXXXXX-------
---------------XE,t..t.X-------X.,<.<X-----------------------
---------------X.,t..tEX-------X<,...X-----------------------
---------------XE,t..tEX-------XXXXXXX-----------------------
---------------X.,t..t.X-------------------------------------
---------------XXXXXXXXX-------------------------------------
