--------------------------------------------------------XXXXXXXXXXXXXXXXXXXXX----------------------------
--------------------------------------------------------X...................X----------------------------
--------------------------------------------------------X...................X----------------------------
--------------------------------------------------------X...................X----------------------------
--------------------------------------------------------X...XXXXX...XXXXX...X----------------------------
--------------------------------------------------------X...X---X...X---X...X----------------------------
--------------------------------------------------------X...X---X...X---X...X----------------------------
--------------------------------------------------------X...X---X...X---X...X----------------------------
--------------------------------------------------------X...X---X,,,X---X...X----------------------------
--------------------------------------------------------X...X---X...X---X...X----------------------------
--------------------------------------------------------X...X---X.H.X---X...X----------------------------
--------------------------------------------------------X...X---X...X---X...X----------------------------
--------------------------------------------------------X...XXXXX.:.XXXXX...X----------------------------
--------------------------------------------------------X.......,...,.......X----------------------------
--------------------------------------------------------X.......,.H.,.......X----------------------------
--------------------------------------------------------X.......,...,.......X----------------------------
--------------------------------------------------------X...XXXXX.:.XXXXX...X----------------------------
--------------------------------------------------------X...X---X...X---X...X----------------------------
--------------------------------------------------------X...X---X.H.X---X...X----------------------------
--------------------------------------------------------X...X---X...X---X...X----------------------------
--------------------------------------------------------XXXXXXXXX...XXXXXXXXX----------------------------
------------------------------------------------------------XH.H.....H.HX--------------------------------
------------------------------------------------------------X.:.......:.X--------------------------------
------------------------------------------------------------X...........X--------------------------------
------------------------------------------------------------X...........X--------------------------------
------------------------------------------------------------X...........X--------------------------------
------------------------------------------------------------X:....W....:X--------------------------------
------------------------------------------------------------X...........X--------------------------------
------------------------------------------------------------X...........X--------------------------------
------------------------------------------------------------X...........X--------------------------------
------------------------------------------------------------X...........X--------------------------------
------------------------------------------------------------XH.........HX--------------------------------
------------------------------------------------------------XXXXX...XXXXX--------------------------------
----------------------------------------------------------------X+++X------------------------------------
----------------------------------------------------------------X+++X------------------------------------
----------------------------------------------------------------X...X------------------------------------
--------------------------------------------------------XXXXXXXXX...XXXXXXXXX----------------------------
--------------------------------------------------------XH.................HX----------------------------
--------------------------------------------------------X...................X----------------------------
--------------------------------------------------------X...................X----------------------------
----------------------------------------------------XXXXX...XXXXX...XXXXX...XXXXX------------------------
----------------------------------------------------X:......X---XB..X---X......:X------------------------
----------------------------------------------------X.......X---X...X---X.......X------------------------
----------------------------------------------------X.......X---X...X---X......BX------------------------
----------------------------------------------------X<.:....XXXXX.W.XXXXX...:...XXXXXXXXXXXXX------------
---------------------------------------------------XX.......................................X------------
---------------------------------------------------X,<.<..................................W.X------------
---------------------------------------------------XX.......................................X------------
----------------------------------------------------X<...........:..............XXXXXXXXX...X------------
----------------------------------------------------X...........................X-------X...X------------
----------------------------------------------------X...........................X-------X...X------------
----------------------------------------------------X:.........................:X-------X...X------------
----------------------------------------------------XXXXX...................XXXXX-------X...X------------
--------------------------------------------------------X...................X-----------X...X------------
--------------------------------------------------------X...................X-----------X...X------------
--------------------------------------------------------XH.......B.........HX-----------X...X------------
--------------------------------------------------------XXXXX...XXXXX...XXXXX-----------X...X------------
------------------------------------------------------------X...X---X...X---------------X...X------------
------------------------------------------------------------X...X---X...X---------------X...X------------
------------------------------------------------------------X...X---X...X---------------X...X------------
------------------------------------------------------------X,,,X---X,,,X---------------X.:.X------------
------------------------------------------------------------X...X---X...X---------------X+++X------------
------------------------------------------------------------X...X---X...X---------------X+++X------------
------------------------------------------------------------X...X---X...X---------------X...X------------
------------------------------------------------XXXXXXXXXXXXX...XXXXX...X---XXXXXXXXXXXXX...XXXXXXXXXXXXX
------------------------------------------------X.......................X---X..........................HX
------------------------------------------------X.......................X---X.............:.............X
------------------------------------------------X.......................X---X...........................X
------------------------------------------------X...,,,,,,,,,,,,,,,,,...X---X...XXXXX...........XXXXX...X
------------------------------------------------X...,...............,...X---X...X---X...........X---X...X
------------------------------------------------X...,...............,...X---X...X---X...A...W...X---X...X
------------------------------------------------X...,...............,...X---X...X---X...........X---X...X
------------------------------------------------X...,...............,...X---X...XXXXX...........XXXXX...X
------------------------------------------------X...,...............,...X---X...........................X
------------------------------------------------X...,...............,...X---X...........................X
------------------------------------------------X...,...............,...X---X.....:.:...........:.:.....X
------------------------------------------------X...,...............,...X---X.............W.............X
------------------------------------------------X...,...............,...X---X.....:.:...........:.:.....X
------------------------------------------------X...,...............,...X---X...........................X
------------------------------------------------X...,...............,...X---X...........................X
------------------------------------XXXXXXXXXXXXX...,...............,...X---X:......XXXXX...XXXXX......:X
------------------------------------X........++.....,...............,...X---X.......X---X...X---X.......X
------------------------------------X........++.....,.......H.......,...X---X.......X---X...X---X.......X
------------------------------------X........++.....,...............,...X---X.......X---XH.HX---X.......X
------------------------------------X...XXXXXXXXX...,...............,...X---X.......X---X.:.X---X.......X
------------------------------------X...X-------X...,...............,...X---X.......X---XH.HX---X.......X
------------------------------------X...X-------X...,...............,...X---X.......X---X...X---X.......X
------------------------------------X..:X-------X...,...............,...X---X.......X---X:H:X---X.......X
------------------------------------X...X-------X...,...............,...X---X...E...X---XXXXX---X...E...X
------------------------------------X...X-------X...,...............,...X---X.......X-----------X.......X
------------------------------------X...X-------X...,...............,...X---X.......X-----------X.......X
------------------------------------X...X-------X...,...............,...X---X.......X-----------X.......X
------------------------------------X...X-------X...,...............,...X---X.......XXXXXXXXXXXXX.......X
------------------------------------X...X-------X...,...............,...X---X...........................X
------------------------------------X:..X-------X...,...............,...X---X.W.........:.:.:...........X
------------------------------------X...X-------X...,...............,...X---X..........................HX
------------------------------------X...X-------X...,,,,,,,,,,,,,,,,,...X---XXXXX...XXXXXXXXXXXXXXXXXXXXX
------------------------------------X...X-------X.......................X-------X+++X--------------------
------------------------------------X...X-------X.......................X-------X+++X--------------------
------------------------------------X...X-------X.......................X-------X...X--------------------
------------------------------------X...X-------X...XXXXXXXXX...XXXXXXXXX-------X...X--------------------
------------------------------------X..:X-------X...X-------X...X---------------X...X--------------------
------------------------------------X...X-------X...X-------X...X---------------X...X--------------------
------------------------------------X...X-------X...X-------X...X---------------X...X--------------------
------------XXXXXXXXXXXXXXXXX---XXXXX...X-------X,,,X-------X,,,X---------------X:.:X--------------------
------------X.......:.......X---X.......X-------X...X-------X...X---------------X.H.X--------------------
------------X...............X---XH......X-------X.A.X-------X...X---------------X:.:X--------------------
------------X...............X---X.......X-------X...X-------X...X---------------X...X--------------------
------------X...............X---XA......XXXXX---X...XXXXXXXXX...X---------------X...X--------------------
------------X...............X---X...........X---X...............X---------------X.H.X--------------------
------------X.:.:...........X---XA..........X---X......:.:......X---------------X...X--------------------
------------X.........B.....X---X...........X---X...............X---------------X...X--------------------
--------XXXXX.:.:...XXXXX,,,XXXXXXXXXXXXX,,,X---X......:.:......X---------------X...X--------------------
--------X...........X---X.......X-------X...X---X...............X---------------X.H.X--------------------
--------X.A........BX---X.E.....X-------X...X---X...............X---------------X...X--------------------
--------X...........X---X.......X-------X...X---X...............X---------------X...X--------------------
---XXXXXX...........XXXXX.......XXXXXXXXX+++XXXXX...............XXXXXXXXXXXXXXXXX...X--------------------
XXX.,++..........................++...E..............................:.:............X--------------------
>.H.,++...H...W...............E..++...............:.....W...........................X--------------------
>XX.,++..........................++.......E..........................:.:............X--------------------
---XXXXXX...........XXXXX.......XXXXXXXXXXXXXXXXX...............XXXXXXXXXXXXXXXXXXXXX--------------------
--------X...........X---X.......X---------------X...............X----------------------------------------
--------X.A.........X---X.E.....X---------------X...............X----------------------------------------
--------X...........X---X.......X---------------X...............X----------------------------------------
--------XXXXX.:.:...XXXXX,,,XXXXXXXXXXXXXXXXXXXXX......:.:......X----------------------------------------
------------X.........B.....X---X...........,...+...............X----------------------------------------
------------X.:.:...........X---XA..........,...+......:.:......X----------------------------------------
------------X...............X---X...........,...+...............X----------------------------------------
------------X...............X---XH......XXXXXXXXX...XXXXXXXXX...X----------------------------------------
------------X...............X---X.......X-------X...X-------X...X----------------------------------------
------------X...............X---XW......X-------X.H.X-------X...X----------------------------------------
------------X.......:.......X---X.......X-------X...X-------X...X----------------------------------------
------------XXXXXXXXXXXXXXXXX---XXXXX+++X-------X,,,X-------X,,,X----------------------------------------
------------------------------------X...X-------X...X-------X...X----------------------------------------
------------------------------------X...X-------X...X-------X...X----------------------------------------
------------------------------------X...X-------X...X-------X...X----------------------------------------
------------------------------------X,,,XXXXXXXXX...XXXXXXXXX...XXXXX------------------------------------
------------------------------------X...............................X------------------------------------
------------------------------------X.A.H.H.H.H.H.H.H.H.H.H.H.H.H.H.X------------------------------------
------------------------------------X...............................X------------------------------------
------------------------------------XXXXXXXXXXXXXXXXXXXXXXXXXXXXXXXXX------------------------------------
