XXXXXXXXXXXXXXXXXXXXXXXXXXXXXX-------------------------------------------------------------------------
X............................X-------------------------------------------------------------------------
X............................X-------------------------------------------------------------------------
X............................X-------------------------------------------------------------------------
X....,,,,,,,,,,,,,,,,,,,,,...X-------------------------------------------------------------------------
X....,H.H................,...X-------------------------------------------------------------------------
X....,...................,...X-------------------------------------------------------------------------
X....,H................T.,...X-------------------------------------------------------------------------
X....,...................,...X-------------------------------------------------------------------------
X....,........A..........,...X-------------------------------------------------------------------------
X....,...................,...X-------------------------------------------------------------------------
X....,...................,...X-------------------------------------------------------------------------
X....,...................,...X-------------------------------------------------------------------------
X....,...................,...X-------------------------------------------------------------------------
X....,....E..............,...X-------------------------------------------------------------------------
X....,...........A.......,...X-------------------------------------------------------------------------
X....,...................,...X-------------------------------------------------------------------------
X....,...................,...X-------------------------------------------------------------------------
X....,........E..........,...X-------------------------------------------------------------------------
X....,...................,...X-------------------------------------------------------------------------
X....,...................,...X-------------------------------------------------------------------------
X....,.....E........A....,...X-------------------------------------------------------------------------
X....,...................,...X-------------------------------------------------------------------------
X....,...................,...X-------------------------------------------------------------------------
X....ttttt...............,...X-------------------------------------------------------------------------
X....t...t........E......,...X-------------------------------------------------------------------------
X....t...t...............,...X-------------------------------------------------------------------------
X....t...t.H.HH........K.,...X-------------------------------------------------------------------------
X....ttttt..............H,...X-------------------------------------------------------------------------
X....,,,,,,,,,,,,,,,,,,,,,...X-------------------------------------------------------------------------
X............................X-------------------------------------------------------------------------
X............................X-------------------------------------------------------------------------
X............................X-------------------------------------------------------------------------
XXXXXXXXXXXXXXXXXXXXXXXXXXXXXX-------------------------------------------------------------------------
-------------------------------------------------------------------------------------------------------
-------------------------------------------------------------------------------------------------------
-------------------------------------------------------------------------------------------------------
-------------------------------------------------------------------------------------------------------
-------------------------------------------------------------------------------------------------------
-------------------------------------------------------------------------------------------------------
-------------------------------------------------------------------------------------------------------
-------------------------------------------------------------------------------------------------------
-------------------------------------------------------------------------------------------------------
-------------------------------------------------------------------------------------------------------
-------------------------------------------------------------------------------------------------------
-------------------------------------------------------------------------------------------------------
-------------------------------------------------------------------------------------------------------
-------------------------------------------------------------------------------------------------------
-------------------------------------------------------------------------------------------------------
-------------------------------------------------------------------------------------------------------
-------------------------------------------------------------------------------------------------------
-------------------------------------------------------------------------------------------------------
-------------------------------------------------------------------------------------------------------
-------------------------------------------------------------------------------------------------------
-------------------------------------------------------------------------------------------------------
-------------------------------------------------------------------------------------------------------
-------------------------------------------------------------------------------------------------------
-------------------------------------------------------------------------------------------------------
-------------------------------------------------------------------------------------------------------
-------------------------------------------------------------------------------------------------------
-------------------------------------------------------------------------------------------------------
-------------------------------------------------------------------------------------------------------
-------------------------------------------------------------------------------------------------------
-------------------------------------------------------------------------------------------------------
-------------------------------------------------------------------------------------------------------
-------------------------------------------------------------------------------------------------------
-------------------------------------------------------------------------------------------------------
-------------------------------------------------------------------------------------------------------
-------------------------------------------------------------------------------------------------------
-------------------------------------------------XXXXXXXXXXXXXXXXXXXXXXXXXXXXXXXXXX--------------------
-------------------------------------------------X...........,,,.,....,...........X--------------------
-------------------------------------------------X.ttt.....,,..,.,....,...........X--------------------
-------------------------------------------------X.t.t....,....,.,....,...........X--------------------
-------------------------------------------------X.ttt.....,,..,T,....,...........X--------------------
-------------------------------------------------X...........,,,.,....,..E........X--------------------
-------------------------------------------------XXXXXXXXXXXXXXX,,....,...........X--------------------
---------------------------------------------------------------X......,...........X--------------------
---------------------------------------------------------------X......,...........X--------------------
---------------------------------------------------------------X......,.....E.....X--------------------
---------------------------------------------------------------X......,...........X--------------------
---------------------------------------------------------------X......,...........X--------------------
---------------------------------------------------------------X......,...........X--------------------
---------------------------------------------------------------X......,........E..X--------------------
---------------------------------------------------------------X......,...........X--------------------
---------------------------------------------------------------X......,...........X--------------------
---------------------------------------------------------------X......,...........X--------------------
---------------------------------------------------------------X......,,,,,,,,,,,,X--------------------
---------------------------------------------------------------X..................X--------------------
---------------------------------------------------------------X..................X--------------------
---------------------------------------------------------------X..................X--------------------
---------------------------------------------------------------X..................X--------------------
---------------------------------------------------------------X..................X--------------------
---------------------------------------------------------------X..................X--------------------
---------------------------------------------------------------X.,,,,,,,,.........X--------------------
---------------------------------------------------------------X.,.T....,.........X--------------------
---------------------------------------------------------------X.,......,.........X--------------------
---------------------------------------------------------------X.,...ttt,.........X--------------------
---------------------------------------------------------------X.,.E.ttt,.........X--------------------
---------------------------------------------------------------X.,......,.........X--------------------
---------------------------------------------------------------X.,......,.........X--------------------
---------------------------------------------------------------X.,......,.........X--------------------
------------------------------XXXXXXXXX------------------------X.,......,.........X--------------------
------------------------------X.....AAX------------------------X.,,,,,,,,.........X--------------------
------------------------------X......AX------------------------X..................X--------------------
------------------------------X.E.....X------------------------X..................X--------------------
------------------------------X....E..X------------------------X...........,,,,,,,X--------------------
------------------------------X...:...X------------------------X...........,..Ht..X--------------------
------------------------------X..E....X------------------------X...........,.T.tttX--------------------
------------------------------X....E..X------------------------X...........,......X--------------------
------------------------------X.......X------------------------X,,,,XXXXXXXXXXXXXXX--------------------
------------------------------X.......X------------------------X....X----------------------------------
---------------------------XXXX.......X------------------------X....X----------------------------------
---------------------------X.E+..E...EX---XXXXXXXXXXXXXXXXXXXXXX,,,,XXXXXXXXXXXX-----------------------
---------------------------XXXX.......XXXXX....::.::.:.......,................X------------------------
------------------------------X.......,...,..................,...............X-------------------------
------------------------------X:EH....,...,..................,........E.....X--------------------------
------------------------------X.......,...,..................,.............X---------------------------
------------------------------X..E....XXXXX..................,............X----------------------------
------------------------------X......EX---X..................,...........X-----------------------------
------------------------------X.......X---X..................,,,,,,,,,,,X------------------------------
------------------------------X.......X---X..................,.,,,,,,,,X-------------------------------
------------------------------X.......X---X..................,.,.....AX--------------------------------
------------------------------X.......X---X,,,,,,,,,,,.......,.,E....X---------------------------------
------------------------------X.......X---X,,,,,,,,,,,.......,.,...AX----------------------------------
------------------------------X....E..X---X.........,,.......,.,..AXXXXX-------------------------------
------------------------------X.E.....X---X...E.....,,.......,,,A.XX.t.X-------------------------------
------------------------------X...:...X---X.E....E..,,.......,...X-X,XXX-------------------------------
------------------------------X....E..X---X.........,,.......,..X--X.X---------------------------------
------------------------------X..E....X---X..E......,,.......,.X---XEX---------------------------------
------------------------------X.......X---X.....E...,,.......,X----X.X---------------------------------
------------------------------X......HX---X.......E.,,.......XXXXXXX,XXXXX-----------------------------
------------------------------XXXXXXXXX---X.........,,.......XX:.........X-----------------------------
------------------------------------------XXXXXXXXXXXX,,,,,,,XX,,,,,,,,,,XXXXXXX-----------------------
-----------------------------------------------------X........+,.........,.....X-----------------------
-----------------------------------------------------XH.....E.+,.........,..E.EX-----------------------
-----------------------------------------------XXXXX-XHHH.....+,..E.E....,.....X-----------------------
-----------------------------------------------X.W.X-XXXXXXXXXX,,,,,,,,,,XXX,,,X-----------------------
-----------------------------------------------X...X----------XH.........X-X...X-----------------------
-----------------------------------------------X.EAX----------X..........A-X...X-----------------------
-----------------------------------------------X...X----------X........E.XXX,,,X-----------------------
-----------------------------------------------X.A.X----------XE.........,+....X-----------------------
-----------------------------------------------X...X----------X......E...,+....X-----------------------
-------------------------------------XXXXXXXXXXX,,,XXXXXXXXXXXX..........,+....X-----------------------
-------------------------------------X.H.....++..............+,...E......XXXXX,XXXXXXX-----------------
-------------------------------------XXXXXXXXXX....XXXXXXXXXXXX........E.A---X....E..X-----------------
----------------------------------------------X....:----------X..........A---X......,X-----------------
----------------------------------------------X..E.X----------XE....E....A---X......EX-----------------
----------------------------------------------X....X----------X..........X---X...E..,X-----------------
----------------------------------------------X..T.X----------X........E.X---X,XXXXXXX-----------------
----------------------------------------------X....X----------X..........X---X.X-----------------------
----------------------------------------------X....X-XXXXXXXXXX,,,,,,,,,,XXXXX,XXXXXXX-----------------
----------------------------------------------X..W.X-X:.......L..........,..........HX-----------------
----------------------------------------------X..,.X-X.:...:..L...E.E....,..EE..E....X-----------------
----------------------------------------------X.,.,X-X...:....L..........,..........:X-----------------
----------------------------------------------X,,.,X-X,,,XXXXXX,,,,,,,,,,XXXXXXXXXXXXX-----------------
----------------------------------------------X,.,.X-X...X----X.........:X-XXXX+++XXXX-----------------
-------------------------------------XXXXXXXXXX...,X-X...X----XXX,XXXXXXXX-X:.......:X-----------------
-------------------------------------X.:..WAA.,..<.X-X...X------X.X--------X,,,,,,,,,X-----------------
-------------------------------------XXXXXXXXXXXX,XX-X...X------X.X------XXX,,,,,,,,,X-----------------
------------------------------------------------XXX--X...X------X.X------X:..........X-----------------
-----------------------------------------------------X..:X------X.X------X.,,,,,,....X----XXXXXXXXXXXXX
-----------------------------------------------------X...X------XEX------X.,....,...:X----X:.........:X
-----------------------------------------------------X:..X------X.X------X.,....,:...X----X......:....X
-----------------------------------------------------X.:.X------XtX------X.,..E.,...AX----X...........X
-----------------------------------------------------X...X------XXX------X:,....,....X----X...:.:...:.X
-----------------------------------------------------X...XXXXXXXXXXXXXXXXX.,,,,,,.:..X----X.......:...X
-----------------------------------------------------X:.:...........................:X----X....E......X
-----------------------------------------------------X..........:....AA.A:....W......X----X:..........X
-----------------------------------------------------X......:...............:........X----X..,,,,,,,,.X
-----------------------------------------------------X,,,,,,,,,,,,,,,,,,,,A....:....AX----X..,.tttt.,.X
-----------------------------------------------------X,.E.E.E...E...E.EE.,...:.......XXXXXX..,.t..t.,.X
-----------------------------------------------------X,..................,A:...AA..:.,...,,:.,.t..t.,:X
-----------------------------------------------------XXXXXXXXXXXXXXXXXXXXXXXXXXXXXXXXXXXXXX..,.tttt.,.X
------------------------------------------------------------------------------------------X..,......,.X
------------------------------------------------------------------------------------------X..,,,,,,,,.X
------------------------------------------------------------------------------------------X...........X
------------------------------------------------------------------------------------------X.....:.:...X
------------------------------------------------------------XXXXXXXX----------------------X.:.........X
-------------------------------------------------------------XX...X-----------------------X...........X
---------------------------------------------------------------XtX------------------------X...E.....:.X
---------------------------------------------------------------X.X------------------------X.....:.....X
---------------------------------------------------------------X.X------------------------X...........X
---------------------------------------------------------------X.X------------------------X...:.......X
---------------------------------------------------------------X.X------------------------X:.........:X
---------------------------------------------------------------X.X------------------------XXXXXXXXXXXXX
---------------------------------------------------------------X.X-------------------------------------
---------------------------------------------------------------X.X-------------------------------------
---------------------------------------------------------------X.X-------------------------------------
---------------------------------------------------------------X.X-------------------------------------
---------------------------------------------------------------X.X-------------------------------------
---------------------------------------------------------------X.X-------------------------------------
---------------------------------------------------------------X.X-------------------------------------
-----------------------------------------------------XXXXXXXXXXXLXXXXXXXX------------------------------
-----------------------------------------------------X..................X------------------------------
-----------------------------------------------------X.:...............:X------------------------------
-----------------------------------------------------X.......E....E.....X------------------------------
-----------------------------------------------------XH.................X------------------------------
-----------------------------------------------------X.H..:....E....AA..X------------------------------
-----------------------------------------------------XH.................X------------------------------
-------------------------------------------XXXXXXXXXXX,,,,,,,,,,,,,,,,,,X------------------------------
-------------------------------------------X,..........................,X------------------------------
-------------------------------------------X.,..:.....................,.X------------------------------
-------------------------------------------X..,...........:..........,..X------------------------------
-------------------------------------------X:..,......:..........:..,...X------------------------------
-------------------------------------------X....,..................,....X------------------------------
-------------------------------------------X.....,......tttttt....,.....X------------------------------
-------------------------------------------X......,,.:..t....t...,......X------------------------------
-------------------------------------------X........,...t....t..,.......X------------------------------
-------------------------------------------X.........,..tttttt.,........X------------------------------
-------------------------------------------X.:.:......,.......,.........X------------------------------
-------------------------------------------X...........,..:..,..........X------------------------------
-------------------------------------------X........A...,...,...........X------------------------------
-------------------------------------------X...........A.,.,............X------------------------------
-------------------------------------------X......:.......,.:........T..X------------------------------
-------------------------------------------X........A....,.,.....:......X------------------------------
-------------------------------------------X.:..........,...,...........X------------------------------
-------------------------------------------X...........,..:..,..........X------------------------------
-------------------------------------------X..........,.......,.:.......X------------------------------
-------------------------------------------X..:......,.........,........X------------------------------
-------------------------------------------X........,...........,.......X------------------------------
-------------------------------------------X......,,.......:.....,...:..X------------------------------
-------------------------------------------X.....,....:...........,.....X------------------------------
-------------------------------------------X....,..............:...,....X------------------------------
-------------------------------------------X:..,....................,...X------------------------------
-------------------------------------------X..,....:......T..........,..X------------------------------
-------------------------------------------X.,........................,.X------------------------------
-------------------------------------------X,..........................,X------------------------------
-------------------------------------------XXXXXXXXXXXXXXXXXXXXXXXXXXXXXX------------------------------
-------------------------------------------------------------------------------------------------------
-------------------------------------------------------------------------------------------------------
-------------------------------------------------------------------------------------------------------
-------------------------------------------------------------------------------------------------------
-------------------------------------------------------------------------------------------------------
-------------------------------------------XXXXXXXXXXXXXXXXXXXXXXXXXXXXXX------------------------------
-------------------------------------------X............................X------------------------------
-------------------------------------------X............................X------------------------------
-------------------------------------------X............................X------------------------------
-------------------------------------------X............................X------------------------------
-------------------------------------------X............................X------------------------------
-------------------------------------------X............................X------------------------------
-------------------------------------------X............................X------------------------------
-------------------------------------------X............................X------------------------------
-------------------------------------------X............................X------------------------------
-------------------------------------------X............................X------------------------------
-------------------------------------------X............................X------------------------------
-------------------------------------------X............................X------------------------------
-------------------------------------------X............................X------------------------------
-------------------------------------------X............................X------------------------------
-------------------------------------------X..,,,,,,,,,,,,,,,,,,,,,,,,>.X------------------------------
-------------------------------------------X..,.......................>.X------------------------------
-------------------------------------------X..,.......................>.X------------------------------
-------------------------------------------X..,.......................>.X------------------------------
-------------------------------------------X..,......E................>.X------------------------------
-------------------------------------------X..,.............E..E......>.X------------------------------
-------------------------------------------X..,.......................>.X------------------------------
-------------------------------------------X..,...........E...........>.X------------------------------
-------------------------------------------X..,..............E........>.X------------------------------
-------------------------------------------X..,.......................>.X------------------------------
-------------------------------------------X..,..............E........>.X------------------------------
-------------------------------------------X..,.......................>.X------------------------------
-------------------------------------------X..,T.H.H..................>.X------------------------------
-------------------------------------------X..,,,,,,,,,,,,,,,,,,,,,,,,>.X------------------------------
-------------------------------------------X............................X------------------------------
-------------------------------------------XXXXXXXXXXXXXXXXXXXXXXXXXXXXXX------------------------------
