-----------------------------------------------------XXX-----------------------------------------------------------
-----------------------------------------------------X>X-----------------------------------------------------------
-----------------------------------------------------X,X-----------------------------------------------------------
-----------------------------------------------------X.X-----------------------------------------------------------
-----------------------------------------------------X,X-----------------------------------------------------------
-----------------------------------------------------X,X-----------------------------------------------------------
-----------------------------------------------------X.X-----------------------------------------------------------
-----------------------------------------------------X,X-----------------------------------------------------------
-----------------------------------------------------X,X-----------------------------------------------------------
-----------------------------------------------------X,X-----------------------------------------------------------
-----------------------------------------------------X,X-----------------------------------------------------------
-----------------------------------------------------X.X-----------------------------------------------------------
-----------------------------------------------------X.X-----------------------------------------------------------
----------------------------------------------------X,,X-----------------------------------------------------------
----------------------------------------------------X,,X-----------------------------------------------------------
----------------------------------------------------X,,X-----------------------------------------------------------
--------------------------------------------------XXX,,XXXX--------------------------------------------------------
-----------------------------------------------XXX..,,,,...XXX-------X---------------------------------------------
----------------------------------------------X...............XX---XXXX--------------------------------------------
---------------------------------------------X..................XXXX.XX--------------------------------------------
--------------------------------------------A.....................X.EXXX-------------------------------------------
-------------------------------------------X......................,....X-------------------------------------------
------------------------------------------X.................E......,E.XXXX-----------------------------------------
-----------------------------------------X.........................,,.EXX:X----------------------------------------
----------------------------------------A............,,,,............,,XX..XXX-------------------------------------
----------------------------------------X...........,.,,,,............,.E.,,EX-------------------------------------
---------------------------------------X......E.....,,,,,,.............,..,..:X------------------------------------
---------------------------------------X............,,,K,,............,...E,EXX------------------------------------
--------------------------------------A.............,,,,,,............,...,,,XX------------------------------------
--------------------------------------X..............,.,,..............,....,EX------------------------------------
--------------------------------------X...............,,........E.......,E.,,X-------------------------------------
-------------------------------------X................................,,....X--------------------------------------
-------------------------------------XA..............................,,....X---------------------------------------
-------------------------------------X................................,..XXX---------------------------------------
-------------------------------------X.............,,,,,,,.............,.X-X---------------------------------------
--------------------------------------X.....,,,,,,,.......,,,,,,,......,EXX----------------------------------------
--------------------------------------XXX,,,........,,,,,,.......,,XXXXX.X-----------------------------------------
----------------------------------------X.....,,,,,,......,,,,,,...X----XX-----------------------------------------
-----------------------------------------XX,,,......,,,,,.......,,XX-----------------------------------------------
-------------------------------------------X...,,,,,.....,,,,,...X-------------------------------------------------
--------------------------------------------X,,.....X.EXX.....,,X--------------------------------------------------
----------------------------------------XXX-A,,,,,,,,,,,,,,,,,,HX-XXX----------------------------------------------
--------------------------------------XXXXXXX,,,,,,,,,,,,,,,,,,,XXXXXXXXXXX----------------------------------------
-------------------------------------X..,,,.......................,,,.....X----------------------------------------
------------------------------------X..,,,,......................,,,,......X---------------------------------------
------------------------------------X..,.,,......................,.,,......X---------------------------------------
---------------------------X-------X..,..,.,....................,..,.,......X--------------------------------------
--------------------------XX------X...,.,.,,....,...............,.,.,,......X--------------------------------------
-------------------------X,X-----X....,.XXX,..,,.,..XXXXX.......,.XXX,.......X-------------------------------------
------------------------X,.X----X....,..X-X.,,....,.X---X......,..X-X.,......X-------------------------------------
-----------------------X,..X---X.....,.,XXX.,,..H.,.XXXXX......,..XXX.,.......X------------------------------------
----------------------X,....X--X....,.,,..,,.,....,............,.,..,..,......X------------------------------------
---------------------X.,....X-X.....,,......,,,,,,............,.,,..,,,,......X------------------------------------
--------------------X.,.....XX................................,,...............X-----------------------------------
------------------XX.,,,,,,,:............XX..........XX..........XX............X-----------------------------------
-----------------X.......,,.,,...........XX..........XX..........XX.............X----------------------------------
----------------X.....,,,...,.,...........,...........,...........,...........,.X----------------------------------
---------------X....,,......,..,.........,.,.........,.,.........,.,.........,.,.X---------------------------------
--------------X...,,........,...,.......,...,.......,...,.......,...,.......,...,X---------------------------------
-------------X.,,,.........,.....,:..:,,.....,X..XX,.....,X..XX,.....,X..XX,.....,X--------------------------------
------------X,,............,......,,,,,.......X,,XX.......X,,XX.......X,,XX.......XX-------------------------------
-----------X,..............,......................................................,.XXX----------------------------
---------XX.....,,,,,,,,,,,,,.,,,,,,,,,,,,,,,,,,,,,,,,,,,,,,,,,,,,,,,,,,,,,,,,,,,.,....XXX-------------------------
-------XX.....,,............,.,.................................................,.,.......XX-----------------------
-----XX.....,,..............,.,.................................................,.,.........XXX--------------------
---XX.....,,................,.,...,:............................................,.,............XXX-----------------
--X.....,,..................,.,...,,,,,,,,,,,,,,,,,,,,,,,,,,,,,,,,,,,,,,,,,,,,,,,,,...............XXX--------------
--A...,,........E...........,.,...,.,..........................................,:,,.....A............XXX-----------
--X.,,......................,.,...,.,,,,,,,,,,,,,,,,,,,,,,,,,,,,,,,,,,,,,,,,,,,,,.,...X++XX.............XX---------
--X.,.......................,.,...,.,...........................................,.,..XXX,XXX..............XXX------
--X.,.ttt...................,.,...,.,.....,,,,,,,,,,,,,,,:,.....................,.,,XH,,.,HXX................XXX---
--X.,.t.t...................,.,...,.,.....,.....,,,......,,,.....................,,.XX,,E,HXX.................,.XX-
--X.,.ttt...................,.,...,.,.....,.....,T,.........,....................,,.XX..,.HXX..................,,:X
--X.,..................E....,.,...,.,...,:,..:..,,,.........:,...................,,,XXE,,E,XX.................XX.,X
--X.,.......................,.,...,.,.,,..,...XXXXXXXXXXXXXXXXXXXXXXXXXXXXX......,,.XXX....XX...,,,,,,,,,,,,,,XX,.X
--X.,..........E............,.,...,.,.,.E.,...X---------------------------X.......,,.X-X,XXX....,,............,..,X
--X.,.......................,.,...,.,.,...,...XXXXXXXXXXXXXXXXXXXXX--------X......,.,.XX,XX.....,,,,,,,,,,,,..,...X
--X.,.....................,,..,...,.,.,.,,,...XE,.,E.,,,,,E,,H,E,,,X-------X......,.,..:........,,,.........,.,...X
--X.,...................,,.,,.,...,.,.,,..,,,,X,XXXXX,.E..........,.X------X......,..,..........,,,.,,,,,,..,.,.,,X
--X.,.................,,.,,:,.,...,.,.,E..E.AX....X--XH,,,,,,E,,,,,,.X------X......,..,:........,,,.,.....,.,.,.,.X
--X.,...............,,,,,...,.,...,.,.,...,.X.,E,HXXXXXXXXXXXXXXXXX...X-----XXX....,...,:.......,,,.,E..E.,.,.,.,,X
--X.,.............,,,,..:.:.,.,...,.,.,..E,.,E,.,.XXEX------------X...X-------X....,....:.......,,,.,.....,.,.,...X
--X.,...........,,:,.:......,.,...,.,.,,,,..XX,E,XXX,XX-----------X.E.X-----XXX....,....,.......,,,.,..E..,.,.,.,,X
--X.,...........,.,.....:.:.,.,...,.,........XX,XX....,XX:X:X:----X...X-----XE,...,......,......,,,.,.....,.,.,.,.X
--X.,...........,.,...:.....,.,...,.,.........X,X.....,.XXXXXXX---X...XXXX--XXX...,.......,XX,..,,,.,E..E.,.,.,.,,X
--H.,...........,.:........:,.,..H,.H.................,.,.,.,.X---X.,,,...XX--X...,..,....,XX,..,,,.,.....,.,.,...X
XXX.,......,,,,,,.,A,,,,,,,,,.,..:,.:.................,.,.,.,.XXXXX,..,,,H,,X-X...,,,.,...,,,,..,,,.,.,,..,.,.,.,,X
X:..,......,.<....:.W.........,H,,.E.,:H..............,.,.,.,,XX.A,...,.HH,.XXX..,...H.,..,.....,,,.,.,,,.,.,.,:,.X
X,,.,.....,:,,,,,,,,,,,,,,,,,,,,,.,,,.,,,,,,,,,,,,,,,,,.,.,.,,L,..,,,.,,,:,.XX,..,..,,,.,.,.....,,,.,.,,,.,.,.,.,,X
X,,.,....H,,.<,T,.............,.E.,:,E...............,,.,.,.,,L,..,.,.,..:,E,X,..,.A,E,X,.,.....,,,.,.,K,:,.,.,...X
X,,.,.....,:,,,,,,,,,,,,,,,,,,,H,.,,,.:H,,,,,,,,,,,,,,,.,.,.,,L,..,,,.,,,:,.XX,..,..,,,.,.,.....,,,.,.,,,:,.,.,.,,X
X:..,.....,..<.<..............,,,,.E.,,...............,.,.,.,,XXXA,...,.HH..XXX..,...H..,.,HHH..,,,.,.,A,:,.,.,.,.X
--H.,......,,,,,,.:,,,,,,,,:,.,..:,.:.................,.,.,.,.X-XXX,..,,,.HXX-X..,,,,,,,..HXXH..,,,.,.,,..,.,.,.,,X
--X.,...........,.,...:..:..,.,..H,.H.................,.,.,.,.X---X.,,,.XXX-XXX..,........HXXH..,,,.,E..E.,.,.,...X
--X.,...........,.,.........,.,...,.,.........X,X.....,.X:X:X:X---X..XXX----XE,..,,,,.....HHHH..,,,.,.....,.,.,.,,X
--X.,...........,.:..:..:.:.,.,...,.,........X.E.X....XXXXXXXX----X..XXXXXX-XXX...,.,....,......,,,.,..E..,.,.,.,.X
--X.,...........,,,,........,.,...,.,.,,,,,.X.,,,.XX,XX-----------X...,.E.X---X...,,,...,.......,,,.,.....,.,.,.,,X
--X.,.............,,,,......,.,...,.,.,..E,.,E,.,HXXEX------------X..XXXX.X---X...,.....,..,,...,,,.,E..E.,.,.,...X
--X.,...............,,,,,:..,.,...,.,.,...,.X.,E,.XXXX------------X..XX-X.X-XX....,....,..XXXX..,,,.,.....,.,.,.,,X
--X.,.................,,.,,:,.,...,.,.,E..E.AX,,,X-----------------X:X--X.X-X.....,...,...X.AXX.,,,.,.....,.,.,.,.X
--X.,................H..,,.,,.,...,.,.,,..,,,,X.X-------------------X---X.XX......,..,....X.E,,.,,,.,,,,,,..,.,.,,X
--X.,.....................,,..,...,.,.,.,,,...X,XXXXXXXXXXXXXXXXXXXXXXXXX.XX......,.,.....X.HXX.,,,.........,.,...X
--X.,.......................,.,...,.,.,.E.,...X...E,,..E.,,.E..,,.E..E..,.XX......,.,.....XXXX..,,,,,,,,,,,,XX,...X
--X.,.......................,.,...,.,.,...,...XXXXXXXXXXXXXXXXXXXXXXXXXXXXX.......,,........,...,,,,,,,,,,,,XX,.,,X
--X.,.......................,.,...,.,.,,..,..:XXXXXXXXXXXXXX:XXXXXXXXXXXXXX.......,...XX,XX.....,,,,,,,,,,,,,,XX..X
--X.,........E..............,.,...,.,...,:,.....,,,..........,...................,,..XXX,XXX........,.,,,,XXX.XX.:X
--X.,..................E....,.,...,.,.....,.....,T,.........,....................,,,XX.....XX......,.,.,,,X-X.A.XXX
--X.,.......................,.,...,.,.....,.....,,,......:,,.....................,,,X.E..E.XX......,.,,..,XXXXXX---
--X.,.......................,.,...,.,.....,,,,,,,,,,,,,,,,,......................,,.X.,,,,,XA......,.,,..,.XX------
--X.,.......................,.,...,.,.........................................:,.,,,X,,,,,,XX.......,,,,HXX--------
--X.,,......................,.,...,.,,,,,,,,,,,,,,,,,,,,,,,,,,,,,,,,,,,,,,,,,,,,.,,.XX,,E,,XX.........XX-----------
--A...,,......E.............,.,...,.,..........................................,.,,..XXXXXXX.......XXX-------------
--XX....,,..................,.,...,,,,,,,,,,,,,,,,,,,,,,,,,,,,,,,,,,,,,,,,,,,,,,.,,...XXXXX......XX----------------
----XX....,,................,.,...,:..........................................:,,.,.....A.....XXX------------------
------XX....,,..............,.,.................................................,.,........XXX---------------------
--------XX....,,............,.,.................................................,.,......XX------------------------
----------XX....,,,,,,,,,,,,..,,,,,,,,,,,,,,,,,,,,,,,,,,,,,,,,,,,,,,,,,,,,,,,,,,,.,...XXX--------------------------
------------X,.............,......................................................,.XX-----------------------------
-------------X,,...........,......,,,,,.......,,,,,.......,,,,,.......,,,,,.......XX-------------------------------
--------------X.,,.........,.....,.....,.....,.....,.....,.....,.....,.....,.....,X--------------------------------
---------------X..,,,......,....,.......,...,.......,...,.......,...,.......,...,.X--------------------------------
----------------X....,,.....,..,.........,.,.........,.,.........,.,.........,.,..X--------------------------------
-----------------X.....,,...,.,...........,...........,...........,...........,...X--------------------------------
------------------X......,,.:,....................................................X--------------------------------
-------------------X......,,X..,,,,,,,......XXXXXXXXXXXXXXXX+XXXX......,,,,,,,....X--------------------------------
--------------------X.,,,,..X.,.......,....X-XE....,,...AXXX,XX:XX....,.......,...X--------------------------------
---------------------X.,....X.,.XX,..E,...XXWX,.E.EXX.A.,XHH.....XX...,...XX,.,...X--------------------------------
----------------------X,....X.,.XX,...,...X.XXEXX,,XXXXXXXH.....HXX...,..EXX,.,...X--------------------------------
-----------------------X,...X.,.,,,...,...XEXX.X:......AX-X......XX...,...,,,.,...X--------------------------------
------------------------X,.XX.,..A....,...X.XX..,.......XXX.....EXX...,....A..,...X--------------------------------
-------------------------X,XX.,E...E..,...X.XXE.,.......,,,......XX...,E....E.,...X--------------------------------
--------------------------XXX.,....H..,...XAXXXXX.......,E,B..B..XX...,..H....,...X--------------------------------
---------------------------XX.,...XX,.,...XE..E,,.......,,,X,.XXEXX...,.XX,...,...X--------------------------------
----------------------------X.,...XX,.,...XA...,,E........,B,.BX.XX...,.XX,...,...X--------------------------------
----------------------------X.,.E.,,,.,...XXXEXXX......E..,..E...XX...,.,,,E..,...X--------------------------------
----------------------------X.,.......,....X----:X,XHXXXX:XXXXXXXX....,.......,...X--------------------------------
----------------------------X..,,,,,,,......XXXXXXXXXXXXXXXXXXXXX......,,,,,,,....X--------------------------------
----------------------------:..........:.......AA..,..E.,...H.......:............:X--------------------------------
----------------------------XXXXXXXXXXXXX..........,.....,..........XXXXXXXXXXXXXXX--------------------------------
-----------------------------------------X........,,,,,,,,.........XX,XXXX-----------------------------------------
------------------------------------------X.......,......,........X....t,X-----------------------------------------
-------------------------------------------X.....,........,......X.tt,,,,X-----------------------------------------
--------------------------------------------XXXXXXXXXXXXXXXXXXXXXt,,,,E.EX-----------------------------------------
----------------------------------------------------------------X,,.E....X-----------------------------------------
----------------------------------------------------------------X.E.....EX-----------------------------------------
----------------------------------------------------------------XE..E.E..X-----------------------------------------
----------------------------------------------------------------X........X-----------------------------------------
----------------------------------------------------------------X.E.E.E.EX-----------------------------------------
----------------------------------------------------------------X........X-----------------------------------------
----------------------------------------------------------------XE..E.E.EX-----------------------------------------
----------------------------------------------------------------X.....E.EX-----------------------------------------
----------------------------------------------------------------XE..E....X-----------------------------------------
----------------------------------------------------------------X.E..E.E.X-----------------------------------------
----------------------------------------------------------------X........X-----------------------------------------
----------------------------------------------------------------XXXXXXXXXX-----------------------------------------
