XXXXXXXXXXXXXXXXXXXXXXXXXXXXXXXXXXXXXXXXXXXXXXXXXXXXXXXXXXXXXXXXXXXXXXXXXXXXXXXXXXXXXXXXXXXXXXXXXXXXXXXXXXXXXXXX
X..............................................................................................................X
X.A.A....H.............................................................................H..................A.A..X
X....................E.........................................................................................X
X.....................................E........................................................................X
X.A..E...................................................................E................E.................A..X
X..............................................................................................................X
X..............................................................................................................X
X........................XXXXX,,,,,,,,,,,,,,,,,,,,,,,XXXA......................................................X
X,,,,,,,,,,,,,,,,,,,,,,,,XXXXXX.....................X--X..............................................E........X
X.............................XX,,,,,,,,,,,,,,,,,,,X---XA......................................................X
X..............................XX.................X--XX........................................................X
X...........E...................XX,,,,,,,,,,,,,,,X-XX..........................................................X
X................................X..............XXX............................................................X
X.................................X,,,,,,,,,,,,XX..,,,......A.A.A..............................................X
X..................................XX.........X-X..,T,................................A........................X
X.............................E.....XX,,,,,,,X--XXXXXXXXXXXXXXXXXXXXXXXX.......................................X
X..E.........XXXX..................XXX,,,,,,,XXXXXXXXXXXXXXXXXXXXXXXXXXX.....E.......A..XX.....................X
X...........X...X.................XX..................,................X............A.XXXXX....................X
X..........,.....,.....,,,,,......X............A.A....,.............HA.X...........A..X...,,..............E....X
X.........X....H.,...H.,...,..A..X.A..................,................XA..,,,,,.....,,....,...................X
X........X...E....X....,,,,,....X.A...................,................X...,...,....,,H.E...X..................X
X........X........XX...,...,....X..........E..........,................X...,,,,,...X.,.......X.................X
X........XX.H..W...XX,,,,,,,,,.X......................,....E...........X...,...,...XX....E...X.................X
X.......A..X.......XX,.,...,.,.X......................,................X.,,,,,,,,,XX.........X.....E...........X
X........A..,,.....XXX.,,,,,.XXX....................XXX................X.,.,...,.,XX..W..H..X..................X
X.........A..,X...,...,,...,.,..,...................X-X................XXX.,,,,,.XXX......,,...................X
X,,,,,,,,,,,A,XXXX..W..,,,,,,..W.XXXXXXXXXXXX,,,,,,XX-XX,,,,,XXXXXXXX.,..,.,...,,...,...X,.....................X
X................X.....,...,,....XX...XXXXXXX,,,,,,XXXXX,,,,,XXXXXXXXX.W..,,,,,,..W..XXX,,,,,,,,,,,,,,,,,,,,,,,X
X............A.,,X....,.....,,...XX,..A.............,+..............XX....,,...,.....X.........................X
X....E.........,..,..,,,....,,,,.,.,.....E..........,+.........H...,XX...,,.....,....X,,..H....................X
X..........,,,,,,,,,,..,,,,,,..,,,,,,,,,............,+.............,.,..,,,....,.,,.,..,.......................X
X..........,.,.,.,.,...,:,,:,..,.,.,.,.,............XX.........,,,,,,,,,,.,,,,,,,..,,,,,,,,,...................X
X..........,.,.,.,.,...,,,,,,..,.,.,.,.,...........BXX.B.......,.,.,.,.,..,E,,:,...,.,.,.,.,...................X
X.E........,.,.,.,.,...,.,,.,..,.,.,.,.,.............X.........,.,.,.,.,..,,,,,,...,.,.,.,.,...................X
X..........,,,,,,,,,,..,:,,<,..,,,,,,,,,...........B.,.B.......,.,.,.,.,..,<,,:,...,.,.,.,.,...................X
X..............,..,..,,,...,.,,,,..,.................,.........,,,,,,,,,,.,,,,,,,..,,,,,,,,,......XXXX,,,,,,,,,X
X..............,,X....,.....,,...XX,...A......E......,.............,..,.,,.,...,.,,.,..,..........X--X.........X
X............A...X....,.....,,...XX..................,.............,XX...,,.....,....X,,.........X---X.........X
X..........A...XXX.W...,,,,,,..W.XXXX................,....E......E..XX...,,.....,....X..A........X---X.........X
X...E........XX...,...,,...,,...,....X...............,........H...XXXX.W..,,,,,,..W..XXXXA.......X---X.........X
X...........X......XXX.,,,,,.XXX......,,.............,...........XX...,...,,...,,...,...XXX..E..X-XXXX.........X
X.........XX.A.....XX,.,...,.,.X.......,XX...........,.........,,.H....XXX.,,,,,.XXX......XXX...X-X..,.........X
X........X.........XX,,,,,,,,,.X......H.X-X.E........,...E...XX........X.,.,...,.,XX....A..XXX..XX,..,.........X
X........X..A......XX..,...,...XX........XX..........,......XX.........X.,,,,,,,,,XX......A..X.X-X,..,.........X
X........X.........XX..,,,,,.A..XX.......XX..........,.E....XX......H.XX...,...,..XX.........XXXX,,..,.........X
X....XXXXX.........XX.A,...,.....,,....E.XX..........,......XX.......,X..A.,,,,,..XX...E...,,XXX.,,..,.........X
X..,,XXXXX,,,,.....XX..,,,,,.....,,H.....XX...H......,....A.XX.......,.....,...,E..X.......,.,.,.,,..,.........X
X..,.,.,.,.,.,.....XX.............XX....,,.,.....ttt.,...A..XX......X,.....,,,,,...X.......,.,.,.,,..,.........X
X..,.,.,.,.,.,.....XX..............XXX..,...,,...t.t.,..A..,.,,.....X..............X.......,.,.,.,,..,.........X
X..,.,.,.,.,.,.....,,..........E......XX.....,,..ttt.,....,...XXXXXX.H.............X.......,.,.,.,,..,....E....X
X..,.,.,.,.,.,.....,,...................,.....,,.....,...,,..,,..........E.........,.......,.,.,.,,..,.........X
X..,.,.,.,.,.,.....,,....................,.....,,,,,,,,,,,..,,..H...............E..,...E...,.,.,.,,..,.........X
X..,.,.,.,.,.,.....,,...................A.,,....,.AAA.A.,..,,......................,.......,.,.,.,,..,.........X
X..,.,.,.,.,.,.E...,,E...................A.,,....,,,,,,,..,,.ttt...................,.E.....,.,.,.,,..,.........X
X..,.,.,.,.,.,.....,,............E....E.....,,............,..t.t...................,.......,.,.,.,,..,.........X
X..XXXXXXX,,,,.....XX.....B...............A.,.,..........A,..ttt...E.........BB....X.......,.,.,.,,..,.........X
X..XX....X.........XX.......................,.A..........A,........................X.......,.,.,.,,..,.........X
X..XX,,,.X.........XXX+++XXX,,,,,,,,,,,,,,,,,.A.....H....A>,,,,,,,,,,,,,,,XXXXXX,,,X.......,,XXX.,,..,.........X
X..XX,T,.X,,,,,,,,,XXX,,,XX.................,.A..........,,,,,,,,,,,,,,,,,XXXXXX+++XXXX......X--X,,..,.........X
X..XX,,,.X..........X.....BB.............ttt,A,..........A,........................XXXX,,,,,,XXXXX,..,.........X
X..XX....X.A........X....................t.t,,............,.A................B.....X.........X..XX,..,.........X
X..XX....X..........X....................t,,,.....,,,,,...,..A.....................X......A..X...XX..,.........X
X..XX....X..........,.................E....,.....,A.AAA,...,..A...........E........,.........X...XXXXX.........X
X..XX....X.A........,.....E.............H.,,....,,,,,>,,,...,......................,....E....X.,T,X--X.........X
X..XX....X..........,..........E.........,,....,....,,..,,...,..................E..,......A..X.,.,XXXX.........X
X..XX....X..........,.................XXX,...,,.....,,...,...,,....................,.........X.,,,.............X
X..XX....X..........,.E............XXXXXX...,,.A.A..,,...,,...XXXXXX...............,.........X.................X
X..XX....X..........X..............X.....,.,,.A.....,,.ttt,,.,.XXXXXX...........E..X.........X.................X
X..XX....X..........X...,,,,,...H.,,H.....XX........,,.t.t.,X.,....X,.H............X.........X.................X
X..XX....X..........X...,...,.....,.......XX........,,.ttt..XX.....H,,.....,,,,,...X.....E...X.A...............X
X........X..........X...,,,,,.A..X,.......XX........,,....H.XX.......,.....,...,.AXX.........X...........E.....X
X........X.H........XA..,...,...XX........X.........,,......XX........X..A.,,,,,..XX.........X.A.............H.X
X........X..........X.,,,,,,,,,XX...E...H.X.....E...,,.E....XX........XX...,...,..XX.E.......X.................X
X........XXX........X.,.,...,.,XX........XX.........,,......XXXH.......X.,,,,,,,,,XX.........X.................X
X.........XXXX.E....XXX.,,,,,.XXX......,,...........,,........X,.......XXX.,...,.XXX.......XX..................X
X...........X-XX...,..,.,...,,...,....X.............,,.........,,......XXX.,,,,,.XXX......X....................X
X............XX-XXX....,,,,,,..W..XXXX..H...........,,...E.....H.XX...,...,,...,,...,...XX.....................X
X,,,,,,,,,,,,,,XXXX.W..,,...,.....XXX...............,,............XXXX.W..,,,,,,...W.XXX.......................X
X............A..,XX...,,.....,....X,,H..............,,..............XX...,.,...,,....X.........................X
X....E..........,.,..,,,....,.,,.,..,...........E...,,.............,XX..,.,.....,,,..X,,.A...............E.....X
X...........,,,,,,,,,,,.,,,,.,..,,,,,,,,,...........,,.............,..,,.,.,,,,,.,,,,..,.......................X
X.E.........,.,.,.,.,..,:,,<,...,.,.,.,.,...........XX.........,,,,,,,,,,.,.,,:,,..,,,,,,,,,...................X
X...........,.,.,.,.,..,,,,,,...,.,.,.,.,.........B.XX.B.......,.,.,.,.,..,<,,,,...,.,.,.,.,...................X
X...........,.,.,.,.,..,,,,,,...,.,.,.,.,...E......BXX.B..E....,.,.,.,.,..,,,,,,...,.,.,.,.,...................X
X...........,,,,,,,,,,.,:,,E,,..,,,,,,,,,.E.........XX.........,.,.,.,.,..,:,,:,...,.,.,.,.,...................X
X...............,..,,.,.,,,,,.,,,,..,...............XX....E....,,,,,,,,,,.,,,,,.,..,,,,,,,,,...................X
X..E............,XX..,.,.....,,,..X,,.A.............++.............,..,.,,.,...,.,,.,..,....................E..X
X............H...XX...,,.....,....X.................++.............,XX...,,.....,....X,,..A....................X
X.........E....XXXX.W.,.,,,,,,..W.XXX...............++........XXXXXXXX...,,.....,.W..XXX,,,A,,,,,,,,,,,,,,,,,,,X
X.............XX...,...,,...,,...,..XXXXXXXXXX,,,,,XXXXX,,,,,XXXXXXXXX.W..,,,,,,.....XXXX...A..................X
X.....E.....,,......XXX.,,,,,.XXX...................XX................,...,,...,,...,...XX.....................X
X..........X..H.W...XXX.,...,.XXX..E................XX.................XXX.,,,,,.XXX.....,,,..A................X
X........XX.........X.,,,,,,,,,XX..........E........XX.............E...X.,.,...,.,XX..W....XX..................X
X........XX.........X...,...,,,X-X....E..XXXXXXX....XX.................X.,,,,,,,,,XX......E..X.................X
X........XX.E....H.X,A..,,,,,,T,XX.......XXXXXXXX....,.......E........X....,...,...XX...E....X.................X
X........XX..E....,.,...,...,,,,X-X......X-X....XX...,..............AXX.H..,,,,,....,,......XX.................X
X.........X,.....,,.,...,,,,,....X-X...,,.X-X.W..XX..,.............A.X.....,...,....,,.....,X..................X
X..........,,...XX..,............X-X.,,..,X--X....XX.,..A.A......H..X......,,,,,.....XX....,........E..........X
X...E.......XXXXXX..,.............X-X..,,..X-X.....XXXXXXXXXXXXXXXXXX................XX...X....................X
X............XXXX...,.............X-X.,..,,.X-X.....XXXXXXXXXXXXXXXX..................XXXX................E....X
X...................,..............X-X.,,.,,.X-X...................,...........................................X
X...................,...............X-X.,,..,.X-X........AA.A......,...........................................X
X.....E.............,................X-X..,,...X...................,...........................................X
X...................,....E............XX.,...,,....................,......E....................................X
XA.........E........,..........E.......XXX.,,......................,....................E......................X
X...................,...................X-X........................,........................................A..X
X...................,....................X...........E.............,...........................................X
XA..A...............,.E............................................,.............................E.......A..A..X
X.............H.....,..........................................H...,............E..............................X
X...................,..........................E...................,...........................................X
X...................,..............................................,...........................................X
XXXXXXXXXXXXXXXXXXXXXXXXXXXXXXXXXXXXXXXXXXXXXXXXXXXXXXXXXXXXXXXXXXXXXXXXXXXXXXXXXXXXXXXXXXXXXXXXXXXXXXXXXXXXXXXX
