------XXXXX-------XXXXX---------XXXXX--------------
------X...X-------X.E.X---------X...X--------------
--XXXXX...XXXXXXXXX...XXXXXXXXXXX...XXXXXXX--XXXXX-
--X.................:,....................X-X,,:,,X
--X.,,,,,,,,,,,,,,,,,,,,,.......,,,,,,,,,,XXX,,.,,X
--X.,E.....W...........E,.......,E.A...E..++,..:.H+
--X.,.:,,,,,,:,,,,,,,,,.,..,,,..,.,,:,,,,,XXX,,.,,X
--X.,.,,.....,,.......,A,.,XXX,.,.,.,,....X-X,,:,,X
--X.,.,..........,,,..,.,.,X-X,.,A,.......X--XXXXX-
--X.,.,.........,XXX,.,.,.,XXX,.,.,.......X--------
--X.,.,.,,,.....,X-X,.,,,..,,,..,.,.......XXX------
--X.,.,,XXX,....,XXX,.,H,.......,E,.........X------
--X.,.,,X-X,,,,..,,,..,,,.......,.,........EX------
--X.,A,,XXX,,K,.......,E,.......,.,.........X------
XXX.,.,.,,,.,,,.......,,,......:,A,..,,,..XXX------
X...,.,.....,.,.......,H,......,,.,.,XXX,.X--------
X...,.,,,,,,,.,.......,,,.......,.,.,X-X,.X--------
X...,E...E...E,.......,.,.......,.,.,XXX,.X--------
XXX.,,,,,,:,,,,.......,A,.......,.,..,,,..X--------
--X......,,...........,.,.......,E,.......X--------
--XXXX........XXXXXXX.,.,..,,,..,.,.......X--------
------XX,,,,,XX---XXX.,A,.,XXX,.,.,.......X--------
----XXXX,,,,,XXXX-X..:,.,.,X-X,.,.:,......X--------
---X....,,,,,A...XX..,,.,.,XXX,.,.,,......X--------
--X.....,,,,,.....XXX.,.,..,,,..,.,.......X--------
--X..E..,,,,,..E..X-X.,.,.......,A,.......X--------
--X.....XXXXX.....X-X.,.,,,,,,,,,.,.......XXX------
--X....X-----X....X-X.,E.........E,.........X------
--X,,,X-------X...X-X.,,,,,,,,,,,.,........EX------
--X,,,X-------X...X-X...........,A,.........X------
--X,,,X-------X,,,X-XXXXXXXXX...,.,..,,,..XXX------
--X,,,X-XXX--X.E.E.X------XXX...,.,.,XXX,.X--------
--X,,,X-X.XXX.......XXXXX-X....:,.,.,X-X,.X--------
--X...XX.:.E,E.....E.E.E.XX....,,.,.,XXX,.X--------
--X.W.X.....,............EXXX...,E,..,,,..X--------
--X...,.....,.............X-X...,.,.......X--------
--X...,.....,,,,,,,,,,,,,,XXX,,,,.,,,,,,,.X--------
---X.A,..H.E,......W...A..++,.E..W..A..E,.X--------
----XXX.....,,,,,,,,,,,,,,XXX,,,,,,:,,,.,.X--------
-------X....,.............X-X......,,.,A,.X--------
--------X...,.............X-X.........,.,.X--------
---------X.E,E.E.E.E.E....X-XH........,A,.X--------
----------XXXXXXXXXXXXX+++X-XXXXXXXXX.,.,.X--------
----------------------X+++X---------X.,.,.X--------
--------------XXXXXXXXX,,,XXXXXXXXX-X.,.,.X--XXXXX-
--------------X,,,..........A..E.HX-X.,E,.X-X,,:,,X
-------------X,,W,............,,,.X-X.,.,,XXX,,.,,X
-------------X,,,,....,,,,....,H,.X-X.,A.A++,..:.H+
------------X.,....,,,....,,,.,,,.X-X.,.,,XXX,,.,,X
------------X.,....,.........,...AX-X.,E,.X-X,,:,,X
------------X.,...,..........,....X-XXXXXXX--XXXXX-
-----------X..,,,,,,,,,,,....,....X----------------
-----------X..,,,,,,,,,W,H....,...XXX---XX---------
----------X.A.,,,,,,,,,,,.....,...,L.XXX..XX-------
----------X...,...,...........,...,L....A,..X------
-----------X..,..E.,.........,....,L...,,,,,.XX----
------------X.,.,,,.,,.......,....XXX.,,..,,...X---
-------------X,.,H,...,...,,,..E..X-X.,,,.,.,..X---
--------------X.,,,....,,,....,,,.XX.,,,,,.,A.X----
--------------X,..............,.,.XX.,,A,,E,..X----
--------------X.,.............,,,.XX.,,,,,.,..X----
--------------X..,................X-X,,,,.,,.X-----
--------------X...,,,,,,,,,,,,,,,,X-X,.,,A.,.X-----
--------------X...........E......X--X.,,..,.X------
---------------X.......,,,...A.XX----X.E,,,AX------
---------------XE......,.,....X-----XX.,,,.,X------
---------------X..,,,.E,,,A..X----XX.,,.,.,.,X-----
---------------X..,.,.......X-----X.,.,.,,E..X-----
---------------X..,,,.<.E.XX------X.,H,,,,,,.X-----
---------------XXXXX.....X--------X.,,,,,H,,,X-----
--------------------XXXXX-------XX..,,A,,,,,,.X----
-------------------------------X....,,,,,,.,H,X----
-------------------------------X....,,.E,,,,..X----
--------------------------------X..,.,A,..,,.X-----
--------------------------------X.,.,..,,,,.X------
-------------------------------X..,.,,,,,.,X-------
-------------------------------X..,,,,.,,,.X-------
------------------------------X..,,.,,,.,A.X-------
------------------------------X..,,,,,,,,,.X-------
-----------------------------X...,,,,.E,,,.X-------
------------------------------XX.,,,,,,,,,.X-------
--------------------------------X,,.,,.,,,.X-------
--------------------------------X,.,,.,A,,..X------
--------------------------------X.,..,,,.,..X------
--------------------------------X.,A,,,,,,..X------
-------------------------------X..,,,,,,,...X------
-------------------------------X....XX,XX..EX------
-------------------------------X.E..XX.XX...X------
--------------------------------XX..XX.XX..X-------
----------------------------------XXXXEXXXX--------
------------------------------------X>>>X----------
