---------------------------------------------------------------------------------------------XXXX+XXXX-----------------------------------------
--------------------------------------------------------------------------------------------X.........X----------------------------------------
-------------------------------------------------------------------------------------------XA..E..E..H.X---------------------------------------
----------------------------------------------------------------------------------------XXXX...........XXXX------------------------------------
---------------------------------------------------------------------------------------XEE,,....XXX....,E.EX-----------------------------------
---------------------------------------------------------------------------------------XHE,,...X---X..B,E.HX-----------------------------------
---------------------------------------------------------------------------------------XEE,,.E.XXXXX...,E.EX-----------------------------------
----------------------------------------------------------------------------------------XXXX...,E.E,.E.XXXX------------------------------------
-------------------------------------------------------------------------------------------XB..,...,...X---------------------------------------
---------------------------------------------------------------------------------------XXXXX,,,XXXXX,,,XXXXX-----------------------------------
--------------------------------------------------------------------------------------X...,.....BEB.....,..X-----------------------------------
-------------------------------------------------------------------------------------X....,.............,...XX---------------------------------
------------------------------------------------------------------------------------X.,,..,E.........E..,..,..X--------------------------------
------------------------------------------------------------------------------------X...,.XXXXXX,,,XXXXXX.,...X--------------------------------
------------------------------------------------------------------------------------X....X----XX,,,XX----X....X--------------------------------
------------------------------------------------------------------------------------X,,,X----XH......X----X,,,XXXXXXXXXXXXX--------------------
------------------------------------------------------------------------------------X.E.X---XH......H.X---X...XX..,,...,.,.XX------------------
-------------------------XXXXXXXXXXXXXXXXXXXXXXXXXXXXXXXXXXXXXXXXXXXXXXXXXXXXXXXXXXXX,,,X---X.........X---X,,,XX..,,KE.,.,.,.X-----------------
-------------------------X,,,,,,,,,,,,,,,,,,,,,,,,,,,,,,,,,,,,,,,,,,,,,,,,,,,,,,,,,XX...X---H.........X---X.E.XXE.,,.E.,,.,.,.X----------------
-------------------------X,,,,,,,,,,,,,,,,,,,,,,,,,,,,,,,,,,,,,,,,,,,,,,,,,,,,,,,,,XX,,,X---X..E...E..X---X,,,XX..,,,,,XX.,,...X---------------
-------------------------X,,.....................................................,,XX...X---X,XXX,XXX.X---X...XX..,,,,,X-XX.E.,.X--------------
-------------------------X,,.....................................................,,XX,,,X---XEX-X,X-XEX---X,,,XX.......X---X.,...X-------------
-------------------------X,,.....................................................,,XX..EX---X,XXX,XXX.X---XE..XXE......X----X...,X-------------
-------------------------X,,.....................................................,,XX,,,X---X,,E,,,E,.X---X,,,XX..XXX...X----X.E..X------------
-------------------------X,,.....................................................,,XX...X---XA......A.X---X...XX..X-X....XXX--X.,,X------------
-------------------------X,,............................................,XXXXXXXXXXXX,,,X----X.......X----X,,,XXA.XXX....E..X-X,..,X-----------
-------------------------X,,...........................................,X-----------X...X-----X+++++X-----X...XX............X--X,,.X-----------
-------------------------X,,..........................................,X---------XXXX,,,XXXXXXX,,K,,XXXXXXX,,,XX,,..E..XXX.HX--X,,,X-----------
-------------------------X,,.........................................,X---------X.,............B..B.............,.,....X-X..X--X.E.X-----------
-------------------------X,,........................................,X---------X..,...E,,,,,...E....E.,,,,,,E...,..,...XXX..X--X...X-----------
-------------------------X,,.......................................,X---------XB...,..,,.T.,..........,,.T.,...,....,......EX--X...X-----------
-------------------------X,,......................................,X---------X......,.,,,,E,..........,E,,,,..,......,.E....X--X,,,X-----------
-------------------------X,,.....................................,X-XXXXX----X,,....,..,,,,,...........,,,B,..,....,,,......X-X.....X----------
-------------------------X,,....................................,X-X..H..X---X..,....XXX,,,,,XXX,,,XXX,,,,,XXX....,..XXXXXXX-X.......X---------
-------------------------X,,..............,,,,,,,,,,,,,,,,,,,,,,,X-X.....X---XE..,,.X--X,,,,,X-X,,,X-X,,,,,X--X.,,..BX-------X.......X---------
-------------------------X,,..............,,,,,,,,,,,,,,,,,,,,,,,X-X.....XXXXX.....X---EHHH.HXXX,,,XXEHHH.HX---X....BXXXXXXX-X.EXXX..X---------
-------------------------X,,..............,,...,................,XX......,,,,,.....X----XXXXX-X.....X-XXXXX--X-X.E...BB....XXX..X-XE.X----XX---
-------------------------X,,..............,,...,................,XXE.....,,,,,,,,,.X---XXXXXXX....E..XXXXXXXXX-X,,,,.,,,E,.L,...XXX..X---XH.X--
-------------------------X,,..............,,...,................,,,......,,,,,,,.E.X--X........E...........X,HXX,,.,.,,,.,.L,....H....X--X.EX--
-------------------------X,,..............,,...,.........,,,,,..,,,......XXXXX,,T,.X-X..E................E...X-X,,T,.,,E,,.L,.,,,,,,...X-E..X--
-------------------------X,,..............,,...,........A,.,.,..,,,E.....X---X,,.,BX-XH......................X-X,,.,.,,,,H.XX.,,...,..EXXX,,XX-
XXXXXXXXXX--XXXXXXXXXX---X,,..............,,...,.........,,,.,..,XX......X---X,,,,.X-X.......................X-X,,,EBBX,,,XX-X,,...,...,..,.A.X
XEE.EEtt.X--XEE.EEtt.X---X,,..............,,...,........A,E..,..,XXW....X----XE,,,.X-X.......................X-X.,,,BXX,,,X--X,,...,...,..,..WX
X,,,,,t,,X--X,,,,,t,,X---X,,..............,,...,.........,,,,,..,X-XXXXX-----X.....XXX.......XXX,,,XXX.......X-X.....XX,,,X--X,,,,,,...,..,.A.X
XEE.EEtt.X--XEE.EEtt.X---X,,..............,,.<.,........W.......,XXXXXXXXXXXXX.....XX........XXX,,,XXX.......X-X.E...,E.EEHX-X,,,,,,...XXX,,XX-
X,,,,,,t,X--X,,,,,,t,X---X,,..............:,...,................,XX..........,.....XX..E.....XX,,,,,XX.....E.XXX.....,.....XX.E.XXX..E.X-X,,X--
XEE.EEtt.X--XEE.EEtt.X---X,,..............,....,................,+,.,,,,E,,,.,.....L,........,,,...,,,.......,,,.....,E.EE.B,...X-X...X--E.EX--
X,,,,,tt,X--X,,,,,t,,X---X,,..............,..<.,<...............,+,.,,.....,.,.....L,........,,,.K.,,,.......,,,.....,E.EE.B,...XXX..X---XH.X--
XEE.EEtt.X--XEE.EEtt.X---X,,..............,....,................,+,.,E,,,,,,.,.....L,........,,,...,,,.......,,,.....,.....B,....H...X----XX---
XXXXXXXXXX--X,,,,,,t,X---X,,..............,,...,................,XX.,,,,,,,E.,.....XX..E.....XX,,,,,XX.....E.XXX.....,E.EE.BXE.......X---------
------------XEE.EEtt.X---X,,..............:,...,................,XXXXXXXXXXXXX.....XX........XXX,,,XXX.......X-X.E...,E.EEAXX.......X----------
------------X,,,,,t,,X---X,,..............,,.<.,.........,,,,,..,X-----------X.....XX........XXX,,,XXX.......X-X.....XX,,,X--XHH,HHX-----------
------------XEE.EEtt.X---X,,..............,,...,........A,.,H,..,X-XXXXXX----X.....X-X.......................X-X....BXX,,,X--XXXXXXX-----------
------------XXXXXXXXXX---X,,..............,,...,.........,E,,,..,XX...:..X---X,,,E.X-X,,,,...............,,,,X-X,,,,BXX,,,XX-------------------
-------------------------X,,..............,,...,........A,...,..,,,E.....X---X,,.,.X-X..,.,.............,...EX-X,,.E.BB...HX-------------------
-------------------------X,,..............,,...,.........,,,,,..,,,......XXXXX,,T,BX-A.E.,.,...........,.....X-X,,T,.,,,E,.XXXXXXX-------------
-------------------------X,,..............,,...,................,,,......,,,,,,,.,.X-X....,,...........,.....X-X,,.,.,,,.,.L,.....X------------
-------------------------X,,..............,,...,................,XX......,,,,,,E,,.X-X,.E..,...E...E...,.E...X-X,,,,.,,,,,.XX......X-----------
-------------------------X,,..............,,...,................,XXE.....,,,,,.,,,.X-X.,.A.,...........,....X--X.E,,.,,,E,.X-X.....X-----------
-------------------------X,,..............,,,,,,,,,,,,,,,,,,,,,,,XX......XXXXX.....X--XXXXXXX........XXXXXXX---X....BBXXXXXX--X....X-----------
-------------------------X,,..............,,,,,,,,,,,,,,,,,,,,,,,XXH.....X---X...,,.X--------XXX,,,XXX--------X.,,..BX--------X....X-----------
-------------------------X,,....................................,X-XX..H.X---X..,....XXXXXXXXXXXLLLXXXXXXXXXXX....,..X--------X....X-----------
-------------------------X,,.....................................,X--XXXX----X,,.E..,...B...............B.....,....,,X--------X.,,.X-----------
-------------------------X,,......................................,X---------X......,E,,,,,,..E....E..,,,,,E..,......X--------X....X-----------
-------------------------X,,.......................................,X---------XB...,..,,.T.,..........,,.T.,...,....,XX-------->>>X------------
-------------------------X,,........................................,X---------X..,...,,,,,,..........,,,,,,....,..,.A.X-----------------------
-------------------------X,,........................................,.X---------X.,....,,EXX......XXX.E,,,,,....,.,.W.X------------------------
-------------------------X,,.........................................,.X---------XXXXX,,,X-X,,,,,,X-X,,,XXXX,,,XXX...X-------------------------
-------------------------X,,..........................................,.X------------X.E.XXX......XXX...X--X,,,X-XXAX--------------------------
-------------------------X,,...........................................,.XXXXXXXXXXX-X....E.E...E..E..E.X--X,,,X---X---------------------------
-------------------------X,,............................................,,,,,,,,,,,X-XW..................XX,...X-------------------------------
-------------------------X,,.....................................................,,X-X...................,,.,,.X-------------------------------
-------------------------X,,.....................................................,,X--XH.................,,...X--------------------------------
-------------------------X,,.....................................................,,X---XXHHHXHHHHXHHHHXHXXXXXX---------------------------------
-------------------------X,,.....................................................,,X-----------------------------------------------------------
-------------------------X,,,,,,,,,,,,,,,,,,,,,,,,,,,,,,,,,,,,,,,,,,,,,,,,,,,,,,,,,X-----------------------------------------------------------
-------------------------X,,,,,,,,,,,,,,,,,,,,,,,,,,,,,,,,,,,,,,,,,,,,,,,,,,,,,,,,,X-----------------------------------------------------------
-------------------------XXXXXXXXXXXXXXXXXXXXXXXXXXXXXXXXXXXXXXXXXXXXXXXXXXXXXXXXXXX-----------------------------------------------------------
