----------------------------------------------------XX--------X-----------------------------------------------------------------------------------------------------------------
-------------------------------------------------XXX.X-------X.X----------------------------------------------------------------------------------------------------------------
-------------------------------------------------X...X-------X.X----------------------------------------------------------------------------------------------------------------
-------------------------------------------------X....X-----X...X---------------------------------------------------------------------------------------------------------------
--------------------------------------------------X...X----X.....X--------X-----------------------------------------------------------------------------------------------------
--------------------------------------------------X...X----X....X---------XXX---------------------------------------------------------------------------------------------------
--------------------------------------------------X...X---X.....X---------X..X--------------------------------------------------------------------------------------------------
--------------------------------------------------X...X---X....X----------X...X-------------------------------------------------------------------------------------------------
------------------------------------------XX-------X..X--X....X-----------X....XX-----------------------------------------------------------------------------------------------
---------------------------------------XXX.X-------X...XX....X------------X......X----------------------------------------------------------------------------------------------
---------------------------------------X....X------X...XX....X------------X.......X---------------------------------------------------------------------------------------------
----------------------------------------X...X------X...X....X-------------X........XX-------------------------------------------------------------------------------------------
----------------------------------------X...X-------X......X--------------X...X......X------------------------------------------------------------------------------------------
----------------------------------------X....X---XXXX......X--------------X...XX......X-------------------------------------XXXXXX----------------------------------------------
-----------------------------------------X...XXXX..........X--------------X...X-XX.....XX-----------------------------XXXXHX...H..XX--------------XXXXXXXXXXXXXXXXXXXXXXXXXXXXXX
-----------------------------------------X................X---------------X...X---X......X------------------------------XX..H.......XX------------X..........,.:.,.............X
------------------------------------------X...............XXXXXXXXXXXXXXXXX...X----X......X-------------------------------XX......H..X------------X..........,...,.............X
------------------------------------------X......XX.......................,...X-----X......XX-------------------------------X..H.H...X------------X.........,.....,............X
------------------------------------------X....XX-X.......................,...X-XXXXXXX......X------------------------------XH.....H.X------------X.........,.....,............X
-------------------------------------------X.XX---X.......................,...X-X...X--X......X-----------------------------X..H.H...X------------X..........,,:,,.............X
-------------------------------------------XX-----X..XXXXXXXXXXXXXXXXXXXXXX...X-X...X---X......XX---------------------------XH..XX...X------------X...........X,...............X
--------------------------------------------------X..XtttttttX------------X...XXX...X----X.......X--------------------------X..X--XX.X------------X...XXX.....X................X
--------------------------------------------------X..X......tX------------X.........X-----X.......X------------------------X..X-----XX------------X......,:...XX...............X
--------------------------------------------------X..X...ttttX------------X.........X------XX.....X------------------------X.X----------------XXXXX......,,....X...............X
--------------------------------------------------X..Xttt,,,,X------------XXX.......X--------X....X------------------------XX-----------------X,T.,..,,,,,,....XX......,,,,,...X
--------------------------------------------------X..X,,,,..EX---------------XXXXX..X---------X...X------------------------X------------------XXXXX..,::.:,,...XX......,...,...X
---------------------X----------------------------X..X.E.EE..XXXX-----------------XXX---------X...X---------------------------------------------XXX.,.,,,,,,....X......,.E.,...X
--------------------X.X---------------------------X..XE.EE..EX...XXXXXXXX---------------------X...X------------------------------------------XXXt+,.,.,..,,,....XX.....,...,...X
----------X-------XX...X-----XXXXXXXXXXXXXX-------X..XEE.EE.EX...........XXXXXXXX-------------X...X----------------------------------------XX.:t:+,.,,...,,,....XX.....,,,,,...X
----------X------X..,,,.X----X............X-------X..XEE..EE.X..XXXX.............XXXXXXXX-----X...X------------------------------------------XXX,+,,.,....,,,....XX............X
---------X.X------X.,E,HXXXXXX..,,,,,,,...X-------X..X...E...X..X---XXXXXX...............XXXX-X...X---------------------------------------------XXXXXX,,,,XXXX+++XXXXXXXXXXX>>XX
---------X.X-----XX..,,,,.T..,..,E..E.,...X-------X..XEE...E.X..X---------XXXXXX............X-X...X-------------------------------------------------X....X----XEE.X--------X..X-
--------X.A.X--XXX-X...AXXXXXX..,AA..H,...XXXXXXXXX..XEE.E.EXX..X---------------XXXXXX......X-X...X------------------------------------------------X..A.X-----X..E.X-------X..X-
--------X,,,X--X.XX.....X----X..,tttt.,...,W......,..X......XX..X--XXXXX--------------XXX...X-X...X-----------------------------------------------X.....X------X..E.X------X..X-
-------X,.E,.X-X.,..X...X----X..,tE.tW,...,.......,..X.E.E.EXX..X--X....XXXXXXXX--------X...X-X...X-----------------------------------------------X....X--------X..X-------X..X-
-------X,,,,,XX,..XX-XXX-----X..,t..t.,...XXXXXXXXX..X......XX..X--X............XXXXX---X..X--X...X----------------------------------------------X....X--------X.EX--------X::X-
------X,,,E,H,..,.X----X-----X..,AtttH,...X-------X..X.E.E.EXX..X--X................X---X..X--X...X---------------------------------XXX---------X....X--------X.EX---------XXXX-
------X.E.,,,.,.X..X---------X..,..A..,...X-------XXXX......XX..XX-X...XXXXX........X---X..X--X...X--------------------------------X.,.XXXXX---X....X--------X,,X---------------
-----X,..:.E,.XXX.:X---------X..,E.A.E,...X----------XE.E.EEXX....XX...X----XXXXX..X----X..X--X...X-------------------------------X..,......XXX....X--------XXTX----------------
-----XA,...,.AX--XttX--------X..,,,,,,,...X----------X,,,,,EXX.........X--------X..X---X...X--X...X------------------------------X....,............X----------X-----------------
----X..,,,A,...X-Xt.X--------X............X---XXXX---X,.E.,.XX.........XXXXX----X..X---X...X--X...X-----------------------------X......+++........X-----------------------------
----X..,A,.,.E.X--XX---------XXXXXXXX,,XXXX---X..X---X,...,X-X........X-X..X---X...X---X...X--X...X---------------------------XX......X---++++...X------------------------------
---X.E,...E.,..X---------------------X..X-----X..X---X,,,,,XXX..XXXX..X-X..X---X...X---X...X--X...X--------------------------X.......X--------++X-------------------------------
---X..,.E...,,,.X--------------------X..X------X.X---X,,,,,X-X..X--X..X-X...X-XX...X---X..X---X...X-------------------------X.......X-------------------------------------------
--X,,,,,,E,A,,,.X---------------------X..X-----X.X---X,.E.,.XX..X--X..X-X...XX....X----X..X---X...X------------------------X......XX--------------------------------------------
--X,A.,,..,,,.A,.X---------------------X..X---X..XXX-XX,,,,.XX..X--X..X--X........X----X..X---X...X-----------------------X......X----------------------------------------------
-X,...,,,.,,,.,..X---------------------X...X--X.....XXXXXXX.X...X--X..X--X......XXX----X..X---X...X----------------------X......X-----------------------------------------------
-X,,E.,,E,.A.E..AX----------------------X..X-X..XXX.......XXX..X--X...X--X..XXXX-------X..X---X...X---------------------X......X------------------------------------------------
X.A.,,,,.,,.......X----------------------X..X...X--XXXX.....,..X--X...X--XXX-----------X..X---X...X--------------------X......X-------------------------------------------------
XXXXXXXX,XXXXXXXXXX-----------------------X.,..X-------XXXX.,..X--X..X----------------X...X---X...X-------------------X......X--------------------------------------------------
-------X.X--------------------------------X,...X-----------XX..X--X..X----------------X...X---X...X------------------X......X---------------------------------------------------
-------X.X---------------------------------X....XX----------XXXX--XX.X----------------X..X----X...X----------------XX.....XX----------------------------------------------------
-------X.X--------------------------------X..X....XX--------XXX-----XX----------------X..X----X...X---------------X......X------------------------------------------------------
-------X.X--------------------------------X.X-XX....XX------X..XXX--------------------X..X----X...X--------------X......X-------------------------------------------------------
-------X.X-------------------------------X..X-XXXX....XX--XXXX....XXXX--------------XX...X----X...X-------------X......X--------------------------------------------------------
-------XAX-------------------------------X.XXXX..XXX....XXX.X-XX......XX----------XX...,,.X---X...X------------X......X---------------------------------------------------------
-------X.X------------------------------X....XXX..X-XX....X.X--X..XXXX-X---------X...,,...X---X...X-----------X......X----------------------------------------------------------
-------X,X-------------------------------XX....X.X----XX.,..XX-X..X--XX--------XX...X......X--X...X----------X......X-----------------------------------------------------------
-------XTX---------------------------------X.....X------X.....XX..X-X-X------XX...XX-X......X-X...X---------X.....XX------------------------------------------------------------
-------X,X----------------------------------X...X-------X..XX....X--X-X-----X...XX----X......XX...X--------X.....X--------------------------------------------------------------
-------X.,X----------------------------------XX.X------X..X--XXX.X-X--X---XX..XX-------X.....XX...X-------X.....X---------------------------------------------------------------
-------X.,.X-----------------------------------X-------X..X-----XX-XXX--XX..XX----------X.....X...X-----XX.....X----------------------------------------------------------------
-------X.,..X-----------------------------------------X..XXXX--------X-X,,,X------------X......,..X----X......X-----------------------------------------------------------------
-------X.X...X----------------------------------------XX.....XXXXXX---X...X--------------X......,.X---X......X------------------------------------------------------------------
-------X.XX...X------------------XXX--------------------XXXX.......XXX...X----------------X......,X--X......X-------------------------------------------------------------------
-------XXX-X...X-----------------XW.XXX-----------------XXXXXX..........X------------------X......X-X.....XX--------------------------------------------------------------------
------------X...X----------------X.W.WX-----------------X..X-X..XXXX...X--------------------X......X.....X----------------------------------------------------------------------
-------------X...X---------------X....X-----------------X.XXX...X---XXX----------------------X......,...X-----------------------------------------------------------------------
--------------X...X-------------X....EX-----------------X...X..X------------------------------X......,.X------------------------------------------------------------------------
---------------X.,.XX-----------X.....X-----------------XX.....X-------------------------------X......X-------------------------------------------------------------------------
----------------X.H..XX---------X......X------------------XXX.X---------------------------------X.....X-------------------------------------------------------------------------
--------------XX.,,,,..X--------X..E...X---------------------XX---------------------------------X......X------------------------------------------------------------------------
--------------X..,E.,..X---------X.....X---------------------------------------------------------X....X-------------------------------------------------------------------------
---------------X,...,.XX--------X,.....X----------------------------------------------------------X...X-------------------------------------------------------------------------
--------------X,.,.,..,.XX----XX..X..XX------------------------------------------------------------X.X--------------------------------------------------------------------------
------X------X-X..,..XX...XX-X--XX-XX---------------------------------------------------------------X---------------------------------------------------------------------------
-----X.X---XX-X-XX+XXX-XX...X--X------------------------------------------------------------------------------------------------------------------------------------------------
----X...X-X..X---X+X-----XX..XX-------------------------------------------------------------------------------------------------------------------------------------------------
---X..E..X..X----X.X-------XX---------------------------------------------------------------------------------------------------------------------------------------------------
--X......,.X-----X.X------------------------------------------------------------------------------------------------------------------------------------------------------------
--X.E....,X------X.X------------------------------------------------------------------------------------------------------------------------------------------------------------
--X......X-------X.X------------------------------------------------------------------------------------------------------------------------------------------------------------
--X...E..X-------X.X------------------------------------------------------------------------------------------------------------------------------------------------------------
---X,...X-----XXXX.X------------------------------------------------------------------------------------------------------------------------------------------------------------
--X..X.X------X..,.X------------------------------------------------------------------------------------------------------------------------------------------------------------
--XWX-X-------E.E,.X------------------------------------------------------------------------------------------------------------------------------------------------------------
-XW.X---------XXXX.X------------------------------------------------------------------------------------------------------------------------------------------------------------
---X-------------X.X------------------------------------------------------------------------------------------------------------------------------------------------------------
-----------------X.X---------XXXXXXXX-------------------------------------------------------------------------------------------------------------------------------------------
-----------------X.X--------XH.....H.XX-----------------------------------------------------------------------------------------------------------------------------------------
-------------X---X.X-------X.....:.....X----------------------------------------------------------------------------------------------------------------------------------------
-------------XX--X.X------X............X----------------------------------------------------------------------------------------------------------------------------------------
-------------XX--X.X-----X......XXX....X----------------------------------------------------------------------------------------------------------------------------------------
-------------X.X-X.X-----X......X-X....X----------------------------------------------------------------------------------------------------------------------------------------
-------------X..XX.X-----X....,,++X,,..X----------------------------------------------------------------------------------------------------------------------------------------
-------------X..+,.X-----X....,WE.EE,..X----------------------------------------------------------------------------------------------------------------------------------------
-------------X..XX.XXXXXXX....,,,,,,,..X----------------------------------------------------------------------------------------------------------------------------------------
-------------X.X-X......+,.............X----------------------------------------------------------------------------------------------------------------------------------------
-------------X.X-X......+,.............X----------------------------------------------------------------------------------------------------------------------------------------
-------------XX--X.XXXXXXX.............X----------------------------------------------------------------------------------------------------------------------------------------
-------XXXXX-X---X.X-----X......XXX....X----------------------------------------------------------------------------------------------------------------------------------------
-------X<.<X-----X.X-----X......X-X....X----------------------------------------------------------------------------------------------------------------------------------------
-------X...X-----X,XXX---X......+++....X----------------------------------------------------------------------------------------------------------------------------------------
-------X...X-----X...,X---X...........,X----------------------------------------------------------------------------------------------------------------------------------------
-------X...X-----X.:.,.X--X.........,,.X----------------------------------------------------------------------------------------------------------------------------------------
---X---X...X-----X..,,,X---X.......,,.HX----------------------------------------------------------------------------------------------------------------------------------------
---XXX-X...X-----XXXX,,.X---XXXXXXXXXXXX----------------------------------------------------------------------------------------------------------------------------------------
---XWEXX...XXXXXXXXXX..,X-------------------------------------------------------------------------------------------------------------------------------------------------------
---X..,,.....E.E....+,.X--------------------------------------------------------------------------------------------------------------------------------------------------------
---XEE,,...........W+,.X--------------------------------------------------------------------------------------------------------------------------------------------------------
---XWE,X.....E.E....+.X---------------------------------------------------------------------------------------------------------------------------------------------------------
---X.XXX...XXXXXXXXXXX----------------------------------------------------------------------------------------------------------------------------------------------------------
---XX--X...X--------------------------------------------------------------------------------------------------------------------------------------------------------------------
-------X...X--------------------------------------------------------------------------------------------------------------------------------------------------------------------
-------X...X--------------------------------------------------------------------------------------------------------------------------------------------------------------------
-------X:..X--------------------------------------------------------------------------------------------------------------------------------------------------------------------
-------X...X--------------------------------------------------------------------------------------------------------------------------------------------------------------------
-------X<.<X--------------------------------------------------------------------------------------------------------------------------------------------------------------------
-------XXXXX--------------------------------------------------------------------------------------------------------------------------------------------------------------------
