------XXXXXXXXXXXXXXXXXXXXXXXXXXXXXXXXXXXXXXXXXXXXXXXXX----XXXXXXXXXXXXXXXXXXXXXXXXXXXXXXXXXXXXXXXX-----------XXX-----------------X----------------------------------------------------------------
------XE.E.E.EE.E.E.E,XXXXXE.EE.EtXXXXXEXXXXXE,EXXXX..XXXXXXXXXXXE,E,EXXXXXEXXXXXEXXXXtE.EE.E.E.E,X-----------X,,XXX--------------XXX--------------------------------------------------------------
------XXXXXXXXXXXXXXXXX---X,,,,,,tX---X.X---X.,.X--XE.,,ttttX---XXXXXXX---X.X---X,X--XXXXXXXXXXXXXX-----------X..,,.X------------X...XX------------------------------------------------------------
--------------------------XE.EE.EtX---XEX---XE,EX--X..,E,E,EX-------------X,X---XXX--------------XX----------X,....,X------------X.....XX----------------------------------------------------------
--------------------------X,,,,,,tX---X.X---XE,EX--XE.,E,E,EX-------------XXX--------------------XX---XXX----X,.....EX----------X........XX--------------------------------------------------------
--------------------------XE.EE.EtX---XEX---X.,.X--X..,.,.,.X------------------------------------XX---X,X----X,......X----------X.........,XX------------------------------------------------------
--------------------------X,,,,,,tX---X,X---XE,EX--XE.,E,E,EX-------------------------------XXXXXXXXXXXEX----X......X----------X..XXXXXXXXX.,X--------------XX-------------------------------------
--------------------------XE.EE.EtX---XXX---XE,EX--X..,E,E,EX-------------------------------XEtEtEXXXXXXX----X......X----------X..XXXXXXXXX...XX------------X.XX-----------------------------------
--------------------------X,,,,,,tX---------X.,.X--XE.,.,.,.X-------------------------------XXXXXXX----------X.....X----------X...XA.H.HAXX.....XX---------X...X-----------------------------------
--------------------------XE.EE.EtX---------XE,EX--X..,E,E,EX------------------------------------XX---------X,.....X----------X.E.XE..E.EXX.......XX-------X...X-----------------------------------
--------------------------X,,,,,,tX---------Xtt,X--X..,E,E,.X---------------------------------XXXXX---------X,....X----------X:.,,X......XX:,.E....,X-----X....X-----------------------------------
--------------------------XE.EE.EtX---------XXXXX--XE.,.,.,EX---------------------------------E,t-X---------X,....X----------X,,..XE..E.EXX..,,,,,:..XX---X....X-----------------------------------
--------------------------XXXXXXXXX----------------X..,E,E,EX---------------------------------X,t,X---------X,...X-----------E.H.AX......XX.......,,,,,XXX.....X-----------------------------------
---------------------------------------------------XE.,E,E,,X---------------------------------E,t-X---------X....X----------X.....XE..E.EXX............,,X,....X-----------------------------------
---------------------------------------------------Xtttt,,,,X---------------------------------XXXXX--------X,...,.XX--------X.....X,,,,,,XX..............,,,,,.X-----------------------------------
---------------------------------------------------X..XXXXXXX------------------------------------XX--------X,..,.A..X------X:............................,..,,,XX----------------------------------
---------------------------------------------------XXXX------------------------------------------XX--------X,:.,...:.XX---XX............................,...:.T+,XX--------------------------------
-------------------------------------------------------XXXXXXXXXXXXXXXXXXXXXXXXXXXXXXX-----------XX--------X..,........XXX,,............................,.....+.:.,XX------------------------------
------------------------XXXXXXXXXXXXXXXXXXXXXXXXXXXXXXX,,,,,,,,,,,,,,,...............X-----------XX--------X.,..........,,.,......................XX....,.....+....,,XX----------------------------
----------------------XX,,,,,,,,,,,,,,,,.............................................X-----------XX--------X,......E...E,...,....,XXX..........XXXXX.T..,.....+......,.X---------------------------
---------------------X,,..............................................................X----------XX-------X,,............,.,,.,,,,XXHX.......XXXX.,XX...,....+........,,X--------------------------
-------------------XX,................................................................X----------XX-------X,.........E...,,XX,,,,..E.XE...XXXX....EXX..,.....+..........,X-------------------------
-----------------XX,,.................................................................X----------XX-------X..............XX-X,..E...AXX,XX.........,X..,.....+...........,XX-----------------------
----------------X.,...................................................................X----------XX-------X....,,,,,...E.XXX..E......XX,...........,X..,.....+............,,X----------------------
--------------XX,,.......:.............................................................X---------XX------X,...,,,.,,,.....X.......E...X.............XX.,....+...............,X---------------------
-------------X.,.......................................................................X---------XX------X,..,.E.E.E,,....X.E...E....AX.............,X.,....+................,X--------------------
-----------XX,,........................................................................XXXXXXXXXXXX-XXX--X,..,..,,,.,,....XX.......E.EXX............,X,.....+................:.X-------------------
---------XX.,........:.....:.......................................................,,,,.X-----------XXX-X.,..,.E,:,E.,.....X...E......HX............KXX....+.................XX--------------------
--------X.,,...................................................................,,,,......X--------------X.,..,..,,,.,,.....X.E...E....XX............XXX....X...............XX----------------------
--------X,.................................................................,,,,........,,X--------------X.,..,.E.E.E,,.....X....X.XXXX..........XXXXX,....X:XX.:.........XX------------------------
-------X.,.............................................................,,,,.......,,,,,.:.X-------XXX--X,.,...,.....,.:.....XX,XXX...E........XXXE...,....X...X.........X--------------------------
-------X,......:....:..............................................,,,,.......,,,,.....E..X-------XXX--X.,.....,,,,,........XX+...........XXX+XH....,....X....,XX.......X--------------------------
------X.,.................:....................................,,,,......,,,,,.............X-----------X.,..................X.......E..XXXXX..XE...,....X....,,,XX.......X-------------------------
------X,....:..............................................,,,,.....,,,,,...................X---------X,.,.........E...E.....X.....XXXX.A.A...XXA.,....XX....,,,E.X.......X------------------------
-----X.,................................................,,,.....,,,,...........XXX..........X---------X,.,...................X...XXX.A.AE..E...X..,....X....,,,,..XX......X------------------------
-----X,............:...................................,...,,,,,...............X..XXX,.......X-------X,..,.......E...E.......X...XXW.........E.XX,....X......,,,.,,,.......X-----------------------
-----X,...:...:......................................,,.,,,.........,,,.......XX.H.X+XXXX.....X------XX..,....................X...XXA.E..E.....XX....X.......,,,XX,T......,,X----------------------
----X,..............................................,..,..........,,,A,,......X.E..X.XX.HXX.E..X------X..,......X.............X...XX........E.XX,,..XX........,XXX,,......,,X----------------------
----X,...............:.............................,.,,..........,,A.E.H,.....X...XX.XX..EX....X------X..,....XXXXX.:.........XX...XAE..E.E.,X.,.E,,X........,,XXE........T,,X---------------------
---X,.............................................,.,...........,,E.....E,....XE.EXX.X.E..X...E.X----X:..,...XXX,XXXX..........X...X......,,.,,...,X.....,,,,...XX...........X---------------------
---X,....:.......................................,.,....XX,....,,........,,..XX...,..X..EX.......X---X...,.XHX.,E..XXXX........X....XA.XX,...,.,,.XX.,,,,.......E:X..........,X--------------------
--X,...........................................,,.,.....X::XX..E,........,,E.XX.E.,..,E..X.......X---X,..,X,..,,,..E.XXXX......XX...XXX.....,....XX,E............XX...........X--------X-----------
--X,.............:........:...................,.,,......::.:X..,,........,,..XE...,..,...X......E.XXX.,..,X,....,,,....XXX......XX,XX.......,....,XXX............X.E.........,X------XXAXX---------
--X,.........................................,.,.......X::::,..,,........,,.XX..E,..,.EE.X......,,,,,..,.,XH......,,,E.,:X......X...........,....,..XX..........XtT........,,.,X---XX...,,XX-------
--X,........................................,.,........XX::X....,,E.....E,..XXX,.,W.,...XX....,,..,,,..,.,X.........,,,.XX..................,....,...XX........X.H......:X,...,X-XX.:...,.,.X------
--X,............:.........................,,.,.....E......XX.....,XXXXXX,.,,....,XXXX,.EX...,,....,,,..,.,X.,.........,X-XE................,.....,....XXX.....,X,,t....XXX,....,X.......,.:,,X-----
--X,....:..:.............................,.,,.....,,,.............,,X,X,,,.........XX,,XX.,,.....E,,,..,.,XX,,,........,XXX................,.....,......XX..,,..,,t.E.XX:XX,..,+.........,...,X----
-X,.....................................,.,.....,,,,,,..............,,,,................X,........,,,..,.,XX.E.,,.....,..,XXX............,,......,.......XX,.E....,.XXX..EX,.,+..........,....X----
-X,..................:.................,.,.....,E....E,.............,,...,,,,.....................,,,..,.,X-XX.E.,,...,,,,.,,XX.........,........,........,.....E..XX.E...XX,.+..........,...E.X---
-X,............................:......,.,.....,X......H,..........,,...,,....,,,,.................,,,..,,..XX-XX.E.,.,,,,,,,.,XXX.....,,.........,.:......,,......,.......XX,+............,...XXX--
-X,....:....:.......................,,,,.....,XX.......,,.......,,...,,..........,,,,,,,,,,,,,,,,,XXX..,,....XX-X,.,.X.,,,,,,,.,XXX.,,...........,.........,......,E......XXX.............XXXX-----
-X,.............:..................,.,.......,,X....E..A,.......,..,,....XXX.......,,,,,,.........X-X,,.,......XXXX:X-XX,,,,,,,.,XXX..............,........,,.E..,........,T,.............X--------
-X,...............................,.,........,XX.......,,......,..,..XXXXXXX......,E....E,.......X--X:..,......,,XXXXX..XX,,,,,,,.X,..............,.........,....,........,t,:............X--------
-X,...........................:...,.,........,XX......A,,......,..,..XXXX.TX.....,X.......,......XXX,...,......,.,,X......XX,,,..,.,,,.E..........,.........,,..,E........,.,..............X-------
-X,.....:....:....................,,,.........,XE....E.,......,..,...XX....X....,XX......A,,.....XET,,..,......,...,........XX,,.,...,,XXX,,,XX....,.......Tt,.,..........,.,..............X-------
X,......................:.........,,,....,,,,,,,,,...,,.......,.,....+,.....X..E,,X....E..H,....X-X.A,..,.....,....,..........XXX......XX....XX....,...:....t,,,.T........,.,...........T..X-------
X,................................,,,,,,,......,,,,,,,.......,.,......,.....X...,XX.......,,....X-X..XX.,.....,,,.,.............X,,...,,......XX...,........H.XX,,XX......,.,..............X-------
X,................................,,,<...........,,,,......,,..,...XXXX...,,X...,XX......A,,....:XX..XX.,....:XX,,,.............,..,,.,....,..XX....,......XXX-X,,XX......,.,...............X------
X,....:....:...............:......,,,...............,,...,,...XXXXX..:X,,,..,....,XE....E.,.....XXX..XX.,.....XXXX,............:,....XX..,,,...XX...,....XX----X,,XXE.....,.,............E.:X------
X,..............:......:..........,,,<.<.:....,XX.....,,,.....XXH.H,,,X....A,.....,,,...,,......T,..A+X:,....XXTt..,,,,.........,....XX,,.E,...XX...,....X-----X,,X:.....H,.,..............XX------
X,................................,,,.....,,,,.XXX,XX.........XX,,,...X......,.....,,,,,,.......XXX..+X.,....XXtt....,,,,.......,....X.,...,..TXX...,....XXXXXXX++XXXXXXXXX,,,,........XXXX--------
X,................................,,,<,,,,....XX..XX-X,....,,..X......XX...,,X.......,,,........:XX..XX.,....,.........,,.......,....X.,.E.,...XX..T,....X:..........,..X....,T,,..XXXX------------
X,....:....:......................,,,,.XXXX...X.....X,.XX,,.,..XX......X,,,..X..................XXX..XX.,...,..........,,.......,....,.,...,...XX...,....XX..........,T.X......,,XX----------------
X,.....................:..........,,,..,,.,...X.....,.XXX...,..XX......X.....X..................X-X.,,,.,...,........T.,...E...E,....,A,...,...XX...,....,,...........,.,......,,XXX---------------
-X,..............:................,,,..XX,X..XX....,...XX...,..X,......,.....XX...,,,,,,,,,,.....XX,A,..,...,..........,........,....X.,E..,...XX,,,:,..,,,............,,......,.,..XXX------------
-X,.....:.........................,.,..XX,X..XX....,...X.....,.XX......,.....:X...,,,,,,,,,,.....XET,,..,..,,..........,.....E..,....XA,...,..,XX,,,,,..,,,...,,,,,,,..,,......,..,...X------------
-X,........................:......,.,.......XX.....,.W.X.....,..X......,,..XXXX...,,,,,,,,,,.....X--X:..,..,..........,.........,....,.,E..,.,.L,,,,,H.,TXX...,.....,...X.......,.:..HX------------
-X,................................,.,......XXX....,..X......,..X.EX,,,XXXX...,...,,..E..,,,......X-X..,..,,..........,:........,....,A,...,..,L,,,,,,.,.XX...,.....,...X.......,.,..X-------------
-X,........:..:.....................,.,.......XXX.,...X......,..XXXX,,.........,..,,,,,,,,,,.....,XXX,.,..,,..........,.........,....X.,...,...XX,,,:,..,XX...,..H..,...XE......,.,..X-----------XX
-X,.....:............:...............,.,.........XXX.X........,...T.....,,,....,..,,,,,,,,,,.,,,,.,,,.,,..,,.........,..........,....XA,E..,...XX...,,..,XX...,.....,...X.......,..,X--------XXXX.X
-X,.............................:.....,.,,..........XX.........,...,,,,,...,....,.....,,,,,,,.....,,,.,,.,,..........,..........,....,.,...,..XX....,....XX...,.....,...X........,.X---XXXXXX....,X
-X,....................................,,.,............E..,,,...,,,.........,...,,,,,,............,,,.,,.,,,.........,..........,....,.,...,..XX...T.,...,,...,,,,,,,...,,,......,,XXXXE.:,.E..E.X-
--X,.....................................,.,............,,,,,,...............,...................E,,,..,...,,,,.....,,..........,....X.,.E.,.XX......,...,,.............,..,.....,.,......,......X-
--X,...:....................:.............,.,..........,E....E,........X,X....,...................,,,..,.......,,,,H,..E........,....X.,...,.XX......,...,,T............,,,.,.....,,.......,....,X-
--X,......:.....:..........................,.,........,X.......,.....,XXXX,....XXXX,,XXX,,........,,,..,.........,,,,...........,....X..,,E,XX........,..XX.............XX.,.,,,,,,,.......,:...,X-
--X,........................................,.,......,XX......A,,...,XX..XX,...X:......X..,,,,,,..,,,.,,...........E........:...,...,.,...,,XX..,,,,..,..XX.............X-XX.,,.,.,........,....X--
--X,.....................:...................,.,.....,,X....E..A,..,,.......,..XX......X........,,XXX.,,...................X....,..,,..XXXXXX...,..,...,.X:XXX,,,,,,,XX,X-XXXXX,.,,........,.E..X--
--X,............:.............................,.,....,XX.......,,.,,........,,.,,......X.........X--X,,..............E....X.X..H,..,..,,.......,....,..,.XXXXXXXXXXXXXXT,XX.t..XXX,........,...,X--
---X,......:........:..........................,.,...,XX......H,,.E,...,,,..,,E,,.....AX.......E.X--X,,..................X.K.XX.,.,..,.,.......,....,..,.....E.HX....WX,.XXtt....:X.........,..,X--
---X,...........................................,.,,..,XE....E.,..,,...,,,..,,.,,......XE.......XXX-X,...................X....XX,,...,,.......,.....,...,......EX.....X..XX....E..X.........,..X---
----X,...........................................,..,..,,,...,,...,,...,,,..,,.,,.....AX.......XX.:X.,........,.........X......XX,..,,........,.....,...,.......X.....X,,XX......X..........,.,X---
----X,.....:.................:....................,,.,..,,,,,,.....,,..,,,..,..XX......X.......XX.,.,:.......,,,.......X...,....X,.,,.........,......,...,......X....XX.TXX......X..........,.,X---
-----X,.............:...............................,.,...,,,......,,,:,,:,,,..XX.....WX.....EXX..,.,........,.,,.....X...,.,....,X.,.........,..,,,,,....,.....X,XXXX,.XX.......X...........,,X---
-----X,......:.......................................,.,............,,XX,X,,...XX,XXXXXX.....X-X.,.,........,....X.A..X..,...,....XX..........,.,,,.,,,....,....X...,..,XX......X............,X----
-----X.,..............................................,.,,,,........,.XXLX.,...XX,XXXXXX....X-X..,.,.......,,...,.XX.X...,....,,...XX.........,,.E.E.E,,....,...X....,XXX.......X...........A,X----
------X,...............................................,....,,,,,,...:-XTX,...............E.X-X.,.,.......,,,T..,...X...,.......,....XX.......,,..,,,.,,,....,..X....XX.......E.X............,X----
------X.,.....:......:...:..............................,,,,......,,,X-X.X:................X-X.H,.,.......,.,..,...,...,...,.H...,....XX......,,.E,:,E.,.,....,.X..............X............,X-----
-------X,.........:.............................,,,,,,......,,,,,,..,XX-XX,,,..........E..X--X.,.,.......,t..,,...,,,.,...,.,.....,...K.X.....,,..,,,.,,.,.....,XH.............X............,X-----
-------X.,.....................................,XXXXXXXXXXX,,,,,..,,,XX+XX,..,,,,,,,,,....X-X..,.,......,..t.,,...,E,.,...ttt,.....,...X.,.....,.E.E.E,,..,.....XX............XX............X------
--------X,....................................,X-----------XXXXXXXXXXXX-XX,....,,,,...,,:X--X.,.,E.....,,,Tt.X...,,,,,...,tEt.,...,...X.:,.....,,.....,....,......XXX......E..X............,X------
--------X.,.......:..........................,X-:XXXXXXXXXX.,....,tt:XX-XX,,,..,,,.......X-X.H,.,.....,,,,,.XXX.,...,.....tttt...,...XX...,....,.,,,,,......,,......XXXXX.....X:...........X-------
---------X.,,............:.................,,X--X............,..,.tTXX.XX.,..,,,,,,,,...X--X.,.,.....,,,,,,XXE.X.K...,.....,,,...,...X....,....,..............,,......XXXXXX.:X...........,X-------
----------XX.,........:...................,XX--X............XXXXXXXXXX,X-X.,.........,,,X-X..,.,.....,,,,,,,,...XX....,.....,...,...X......,....,...............,,.....,,XXXXX............X--------
------------X.,..........................,X--XX..XXXXX,...XXX-XXX----X.X--X,............X-X.,.,E.....,,,,,,,.....XX....,,......,...X.......,....,..........XX.....,,...,.,,,XX,,,.......:.X--------
-------------X.,........................,X--X,..X-----X..XXX:X.H.:X-X..X---X,..........X-X.H,.,.....,,,,,,,,......XXX....,....,...X.........,...,.......XXXXX.......,,,,....,,...,,,,,,..X---------
--------------X.,......................,X-XX,..X----XX..XX......WX--X..X---X,..........X-X.,.E...XX.,,,,,,,......,,XXX....,...,..XX.........,...,.....XXX.tTXX........XX,,,..,.........,,XXXXXXX---
---------------X.,,...................,XXX,....,XXXX,..,X........X-X...XX--XX,.........XX..,.,...XXXX,,,,,,......,.,,XX....,.,,,XX..........,....,:XXXX...ttXX.......X--XXX,,...........,......X---
----------------XX.,.................,XX,.............,X-X.......XXX,..,,XX:XX........X-X.,.,..E.X,,.tT,XXX.....,....,XX,...,,EXX............,...XXX.........X......X------XX,.........,,......X---
------------------X.,,..............,XX.,..XXXX,,,,,,:X--X....X:X--X.,XX,,HH.XX.......XX..,.,...XX,,,t.t,.XXXXX,,...,..XX,...,,X.......:...XXX...XX..........XX....X---------X,,,,.....,.......X---
-------------------X..,,..........,,XX..XXX---XXXXXXXX----X,XX-X--X...XX.,...XX,......XX.,.,.E..X..,,.,,.,,.,.XX,,,.,...XXX...X........XXXXXXX..,,XX.........XX...X-----------X...,,,.,,...XXXXX---
--------------------XX..,,.......,XXX,.X----XXX,H,XX:XXXXXX,X--X--X..XX,,...X-X,,....XX:.,.,....X..,,,.,,,,,.,,.XX,,......XXKXX.....XXXXXXX,,X,,.,,,.........XX....XX----------X.E.:.,XXXXX--------
----------------------XX..,,....,XXX..XXXX--X.........,.,...EX:XXX,..X:,,...:--X,,...XX-X.,E....X...,.,,,,.T,..,..X........XXX......XXX...,.EX,...,,.H........XX.....X---------X.....X-------------
------------------------XXX.,,.,XX,,,,XX,,XXX.........,.,........X,,X-X.....XX-X,.,..,.:X.,.....X...,,,.,..,.T,T,:X:........X.......X,,..,,,.,,,.E,,,........XXX....E.X---------X...X--------------
---------------------------XX.,XX,,,,,,,,,,.,.........,.,..E.E.....,X-X.....X--XX,.,,,,,X,...E.X.....,.,.,,.,,..,X..................X..,....K,,,...,X.....XXXX.......X-----------X.X---------------
------------------------XX---XXX.,,,,,,,,,K.,:........,.,.........T.XX.....XXXX:-X..X..XX,.....X:....,,.,..,....,X...................X..,,....,,,.,,X.XXXX..........X-------------X----------------
------------------------XX----X.,..T...,,,,.,.........,.,..E.E.....X-X.....,,.,.XX,.XX,XX..E...XXXX.,.,,..,....,.,..................AX....,,..X,,,..XXX............X-------------------------------
------------------------XX---X,,......,,,XXXX.........,.,..........XX.E....XXXX.,XXXX,,XX.........XXXX..,,.....,.,.................,,X......,.XX....,.............X--------------------------------
------------------------XX---X,.....,,,XX---X.........,.,....E.E...:XXX...,X---X.,XXX..XX:..........AX:,.......,.,...........,,,,,,..,.......,,X....,............X---------------------------------
----------------------------X,,....,,XX-----XXX,,,XX,XXXXX........X----XXX,.XX--X,.X.,XX.,.........HXX.,.......,,........XX,,........,.........X....,...........X----------------------------------
---------------------------X,,...,,XX---------X.H.X-:-----X,.E.E..X------X....X:X,.,..XX.,..........X.,.......,.,........XX...........,........X....,..........X-----------------------------------
---------------------------X,,..,.X-----------XXXXX-X:XXXX,.X....X------X......XX..,,XX,.,..........X.,.......,.X........XX...........XX.......X,....,..........X----------------------------------
---------------------------X,,..,.X-----------------X,.....,XXX.,X-----XE......X-X,.X-XE:,..........X.,.......,.X........X-X..........XX......XX,....,...........X---------------------------------
---------------------------X,,..,.X---------------XX........X--X..XX--X........X--XX:X,...,........tX.,.......,.X.........XX..........XX......XX.,...,..:.........X--------------------------------
---------------------------X,,..,.XXX-----------XX..........X---XE.EXX..........X---XX,...,......T.XX,.......,.X..........XX...........XX.....XX.,...,.............X-------------------------------
---------------------------X,,..,,..,XXXXXXXXXXX............X-XX....,,........,.X---X.,...,.......tX.,.......,.X.E........XX...........XX.....X...,..,..............X------------------------------
---------------------------X,,....,,E,,EE.E...,,...........,.X...E..,,........,,X---XE....,.......tX..,.....,..XXXX.......XX...........,......X...,..,........:......X-----------------------------
---------------------------X,,.....,E,,E......,,..........X.,.......XX........,,X--X.,.....,.....t,.,.,...,,..X-XXXXXXX...X-X..........,.....XX...,..,................X----------------------------
----------------------------X,,....,.,,.......XX........XX-X........XX.......,.,X--X,......,..A..t...,.,.,...XXXE.HXAXX...X-X...........,....XX...,..,.................X---------------------------
-----------------------------X.,...,E,,.....XX-XX,,,,,,X---X........XX.......,,,X-X.,......,....t.....,.,...XX.....E.X.....XXtt.........,..XXXX...,..,..................X--------------------------
-----------------------------X,.,,,,.,,...XX-XX........X--X:.......X--XE.......X--X,.......,.:.,.......,:.,,........AX.....XXTt.......,,XXXX......,..,..................EX-------------------------
------------------------------X,,,,,,,,.XX-XX...........X--X.......:--X........X-X,.........,,,.........XX,.E.......AX.....XXXXXXXX,,,,...........,..,...........X.......X-------------------------
-------------------------------X,,,,,,XX--X............EX---X,...XXX--X:.E.....X-X,.........XX.........,XXXXXXX....EXX.....XXXXXXXX,..............,..,.........,::X.....,X-------------------------
-------------------------------X.....X---X.............,.XXXX,,XX-----XXXX.EXX:XX,.........X-X.........tHt..XXXXXXXAX.......,,,,,,,...............,..,.......X::::X....A,X-------------------------
-------------------------------X....X---X.H.....,,....,,,E.E..X-----------XX---XX.........X-X.........,..T........XXX.......,.....,...............,..,.....XX:::.:XX....,X-------------------------
-------------------------------X...X----:..A.,,,.,..XXX........X---------------X.........X--X........,,A............:........,....,...............,..,.:..:::::.XX-X...H.X-------------------------
-------------------------------X...X-----XXX..,,XXX:--XE.E......XX-------------X........X--X.........,.......................,,,,,,...............,..,..,:::..XX----X..,X--------------------------
-------------------------------X..X---------XXXX-----X..........E.X-----------X........X---X..,.....X,:.......................XXXXXXXXXXXX.......,...,XX:::.XX-------XE,X--------------------------
-------------------------------X.X-------------------XE...E.......EX----------X,.......X--X.,,,...XXX.,,......................X----------X:......,...,.X:.XX---------X,X---------------------------
-------------------------------XX-------------------X...E..,,....,,:X----------X......X---X,..,..X-X....,,....................X----------X.......,...,.XXX------------X----------------------------
-------------------------------XX------------------:,,,E.E.,,....,.X-----------X,....X-----X:,..X--X......,,....X,,,,,,XX.....X----------X......,....,..X------------------------------------------
-------------------------------XX-------------------X.,....,,....,.X------------X,..X-----X+X,XX--X......:..,,..X,,,,,,XX.....X----------X......,....,...X-----------------------------------------
-------------------------------XX-------------------X.,E.E.,,...,..X-------------X.X-----XX-XX-----XX.........,EXE..E.EXX.....X----------X......,....,...X-----------------------------------------
-------------------------------XX--------------------X,....,,...,,X---------------X---XXX.EX---------X..........X......XX.....X----------X.....,.....,....X----------------------------------------
-----------------------------------------------------X,.E.........X-------------------X.E..X----------XX...E...:XE..E.EXA,H,,EX----------X,....,....,......X---------------------------------------
-----------------------------------------------------X...E........X------------------X.....EX------XX---XX......XE..E.EXX.....X----------X,...,.....,.....AX---------------------------------------
-----------------------------------------------------XE.....H.....X------------------X......X------XX-----X.....X......XX.E...X----------X.,..,.....,....HE,X--------------------------------------
------------------------------------------------------XE.E.......X------------------X....,,,X------XX------XX...XA.H.HAXX.....X----------X:.,.,..:..,....,XX---------------------------------------
------------------------------------------------------X,..A.:.A..X-------------XXXXXX,,,,...X----------------X..XXXXXXXXX.....X----------X..,,......,.,,XX-----------------------------------------
------------------------------------------------------X:XX,,,,,X:X-------------X.E..,.......XX--------------X..............,,XX----------XX,,X,,,,,,XXXX-------------------------------------------
-------------------------------------------------------X-XXXXXXX-X------------X......,......,,XX------------X........,,,,,XXX--------------XXX.....X-----------------------------------------------
------------------------------------------------------------------------------XHE....,....,,,,>.X----------X..,,,,,,,.XXXX-------------------X.....X-----------------------------------------------
-----------------------------------------------------------------------------X.......,....,,>...X---------XXXXXXXXXXXX-----------------------X....X------------------------------------------------
-----------------------------------------------------------------------------X...E....,....,,....X-------------------------------------------X....X------------------------------------------------
------------------------------------------------------------------------------XXH.....XX...,,....XX------------------------------------------X...X-------------------------------------------------
--------------------------------------------------------------------------------XXE.XX--XXXX,..XX--------------------------------------------X...X-------------------------------------------------
----------------------------------------------------------------------------------XX--------XXX----------------------------------------------XXXX--------------------------------------------------
---------------------------------------------------------------------------------------------------------------------------------------------------------------------------------------------------
