-------------------------XXXXXXXXXXX-XXX--------------X:X-X:X--------------------------------------------------------
-------------------------X,,,,,,,X,XXX,XX--XXXXXXXXX-XX,XXX,XX-------------------------------------------------------
-------------------------X.,,,..........XXXXB...E.BXXXE.....BXXXXXXXXXXXXXX------------------------------------------
-------------------------X.,.,..........,..,.......,.,.......,...,.E.B....X------------------------------------------
-------------------------X.,,,..........XXXX.......XXX....E..XXXXXXXXXXXX,X------------------------------------------
-------------------------X..............X--X.E...BBX-:.B....:X----------X.X------------------------------------------
-------------------------X..E...........X--XXXXXXXXX-XX,XXX,XX-----XXXXXX,XXXX---------------------------------------
-------------------------X..............X-------------X:X-X:X------XA.......AX---------------------------------------
-------------------------X.,,,.,,,,,,,,,X--------------------------X,,,...,,,X---------------------------------------
-------------------------X.,.,E,.,,.,,.,X--XXXXXXXXXXXXXXX---------X,..,.E..,X---------------------------------------
-------------------------X.,,,.,,,,,,,,,X--X.E,,,,,,,,,,.X---------X,...,...,X---------------------------------------
-------------------------XXXXX,XXXXXXXXXX--X.,,,,,,,,,,,EX---------X,..,.,..,X---------------------------------------
-----------------------------X.X-----------X,XXXXXXXXXXX,X---------X,..,.,..,X---------------------------------------
-------------------------XXXXX,XXXXXXXX----X,XXH......+X,X---------X,,,...,,,X---------------------------------------
-------------------------XtttttttttEt.X----XEXXE....E.+X,X---------XXXXXXXX,XX---------------------------------------
-------------------------X.E........t.X----X,XX.......XX,X---XXXXXXXXXXXXXX,XX---------------------------------------
-------------------------X....E.....t.X----X,XXXXXXXXXXX,X---X....,,,........X---------------------------------------
-------------------------X......E...t.X----X,XXXXXXXXX-X.X---X....,..,.......X---------------------------------------
-------------------------X........E.t.X----XE,E,,,E,.X-X,X---XH.,,,,,........X---------------------------------------
-------------------------X....E.....t.X----XXXXXXXXXXX-XEX---X..,.,..........X---------------------------------------
-------------------------X.E........t.X--XXXXXXXXXXXXX-X,X---X..,,,..........X---------------------------------------
-------------------------X.......E..t.XXXX...........X-X,X---XE..............X---------------------------------------
-------------------------X..........t.X..,...........X-X,X---X...............X---------------------------------------
-------------------------X..E.......t.,.T,...........XXX,X---X...,,,.........X---------------------------------------
-------------------------X....E.....t.XXXX...........,,,.X---X..H,.,.......A.X---------------------------------------
-------------------------Xttttttttttt.X--X...........,,,.X---XA..,,,.........X---------------------------------------
-------------------------XXXX,,,,,,XXXX--X...........,,,HX---XXXXXXXXXXXX,,,XX---------------------------------------
----------------------------X......X--XXXX...........XXXXX--------------X...X----------------------------------------
-------------------------XXXX,,,,,,XXXX..,...........X------------------X...X----------------------------------------
-------------------------XtttEtttttEt.X.T,...........X-XXXXXXXXXXXXXXXXXX,,,XXXXXX-----------------------------------
-------------------------XtE........t.XXXX...........XXX............E.........,..X-----------------------------------
-------------------------Xt.........t.X--X...........,.,.....................E,..X-----------------------------------
-------------------------XtE.E......t.X--X...........,.,......................,E.X-----------------------------------
-------------------------XttttttEtttt.XXXX...........XXX................E.....X..X-----------------------------------
-------------------------XXXX,,,,,,,XXX..,H..........X-XXXXXXXXXXXXXXXXXX,,,XXXXXX-----------------------------------
----------------------------X.......X-X.T,...........X----------XXX-----X...X----------------------------------------
-------------------------XXXX,,,,,,,XXXXXX...........X----------X+X-----X...X----------------------------------------
-------------------------XH...........X--X...........XXXXXX-XXXXX+XXXXXXX,,,XX---------------------------------------
-------------------------X........ttttX--X...........,.,..H-X.........XX.....X---------------------------------------
-------------------------X........t..tXXXX...........,.,..X-X.H.......XX.....X---------------------XXXXX----XXXXX----
-------------------------X..E...E.t..tX..,...........,.,..X-X.....E...XX.....X--------------------XX,,,XXXXXX,,,XXX--
-------------------------X........t..tX.H,...........XXX..X-X.........XX..E..X--------------------X...............X--
-------------------------X........t..tX..,...........X-X..X-X.........XX.A..AX--------------------X.............H.XX-
-------------------------X.....E..ttttXXXX...........X-X..XXX.........XX,,,,,X--------------------X..,,,,,,,,,,,..,X-
-------------------------X..E.........X--X...........X-X..,.,.........XX.....X--------------------X..,.........,..,X-
-------------------------X............X--XXXXX,,,XXXXX-X..,.,.........XX.....XXXXXXXXXXXXXXXXXXXXXX..,.,,,,,,,.,..,X-
-------------------------X.........E..X------X...X-----X..,.,.........XX.....XX.....,,,.,,.,,,.,,.,..,.,,,,,,,.,..XX-
-------------------------X............X------X...X-----X..XXX.........XX.....XX....E,,,.,,.,,,.,,.,..,.,,,,,,,.,..X--
-------------------------X.......E....X------X...X-----XXXX-X.........XX.....XX.....,,,.,,.,,,.,,.,..,.,,,<,,,.,..X--
-------------------------X....E.......X------X...X----------X.........XX.....XXE....,,,.,,.,,,.,,.,..,.,,,,,,,.,..XX-
-------------------------X.E.........WXXXXXXXX,,,XXXXXXX----X..E......XX.....XX.....,,,.,,.,,,.,,.,..,.,,,,,,,.,..,X-
-------------------------X............XX....:........H.X----X.........XX.....XX,,,,,XXXXXXXEXXXXXXX..,.,,,,,,,.,..,X-
-------------------------X............XX.E..........E..X----X.........XX.....XX.....X-------------X..,.........,..,X-
-------------------------X.E...E...E..XX...............X----X.......E,XXE.A..XX,,,,,X-------------X..,,,,,,,,,,,..XX-
-------------------------X............XX..,,,,,,,,,,,..X----X,,......,XX.....XX.....X-------------X...............X--
-------------------------X....A..A..A.XX..,.........,..X----X,,......,XX.....XX,,,,,X-------------XXXXXXXXX,,,XXXXX--
-------------------------XXXXXXXXXXXXXXX..,.........,E.X----X,,......,XX....EXX.....X---------------------X...X------
---------------------------------------X..,.........,..X----X.,,,,,,,,XX.....XX,,,,,X---------------------X,,,X------
---------------------------------------X.E,.........,..X----X,..,.,..,XX.....XX.....X---------------------X,,,X------
---------------------------------------X..,,,,,,,,,,,..X----X...,.,...XXH.W..XX,,,,,X---------------------X,,,X------
---------------------------------------X...............X----X...,.,...XX.....XX,,,,,X---------------------X,,,X------
---------------------------------------XE...........E..X----X...,.,...XX.....XX.....X---------------------X,,,X------
---------------------------------------X...............X----X..E,.,...XX.....XX,,,,,X---------------------X...X------
---------------------------------------XXXXXXX,,,XXXXXXX----X...,.,...XXXX++XXX.....X---------------------X,,,X------
-----------------------XXXXXXX---------------X,,,X----------X...,.,.E.X-------X,,,,,X---------------------X,,,X------
-----------------------X.....X---------------X,,,X----------X...,.,...X-------X.E...X---------------------X,,,X------
-----------------------XE..E.X---------------X,,,X----------X...,,,...X-------X,,,,,X---------------------X,,,X------
-----------------------X.....X---------------X,,,X----------X...,H,...X-------X.....X-------------XXXXXXXXX,,,XXXXX--
-----------------------XE..E.X---------------X,,,X----------X,,,,,,,,,X-------X,,,,,X-------------X...............X--
-----------------------X.....X-----------X++-X,,,XX>>>>-XXXXXXXXXXXXXXXXXXXXXXX,,,,,XXXXXXX-------XE..............X--
-----------------------X.....X----------X,,,XX,,,XX...X-X...............,.................X-------X..,,,,...,,E,,.X--
-----------------------XE..E.X----------XtttXX,,,XX.H.X-XE..............,...............E.X-------X..,..,...,...,.X--
-----------------------X,,,,,X----------X...XX,,,XX,,,X-X...............,.................X-------X..,..,...,...,.X--
--------------------XXXX,,,,,XXXX-------X,,,XX,,,XX,,,XXX...,,,...,,,...,.,,,,,,,,,,,,,,,.X-------X..,..,...,...,.X--
--------------------X.........E.X-------X.............,.,...,.,...,.,...,.,.............,.X-------X..,..,...,...,.X--
--------------------XE..........X-------X.............,,,...,,,...,,,...,.,,,,,,,,,,,,,,,.X-------X..,..,...,...,.X--
--------------------X.,,,,,,,,..X-------X.E...........,:,...............,.,.,,,,,,,,,,,,,.X-------X..,..,...,...,.X--
--------------------X.,,,,,,,,..XXXXXXXXX.....,,,,,...,,,...............,.,.,,,,,,,,,,,,,.X-------X..,..,...,...,.X--
--------------------X.,......,..,,,,,,,,,.....,,,,,...,.,E..............,.,.,,.......,,,,.X-------X..,,,,...,,,,,.X--
--------------------X.,......,..,,,,,,,,,.....,,,,,...,.,...,,,...,,,...,.,.,,...H...,,,A.X-------X...............X--
--------------------X.,,,,E,,,..,,,,,,,,,.....,,,,,...,.,...,.,...,.,...,.,.,,.......,,,,.X-------XE.......E......X--
--------------------X.,,,,,,,,..XXXXXXXXX...,,,,,,,,,.,,,...,,,...,,,...,.,.,,.......,,,,.X-------XXXXXXXXX,,,XXXXX--
--------------------X.,......,..X-------X...,.......,.,:,...............,.,.,,,,,,,,,,,,,.X---------------X...X------
--------------------X.,......,..X-------X...,.....E.,.,,,...............,.,.,,,,,,,,,,,,,.X---------------X,,,X------
--------------------X.,,,,,,,,..X-------X...,.......,.,.,...............,.,,,,,,,,,,,,,,,.X---------------X,,,X------
--------------------X.,,,,,,,,..X-------X...,.......,.,.,...,,,...,,,...,.,,,,,,,,,,,,,,,.X---------------X,,,X------
--------------------X.,......,..X-------X...,.......+.,.,...,.,...,.,...,.................X---------------X,,,X------
--------------------X.,......,..X------XX...,.,,,,..,.,.,...,,,...,,,...,.................X---------------X,,,X------
--------------------X.,,,,,,,,..X------X,...,.,..,..,.,,,...............,...............E.X---------------X...X------
--------------------X.,,,,,,,,..X------XX...,.,..,..,.,:,E.......E......XXXXXXX,,,,,XXXXXXX---------------X,,,X------
--------------------X.,......,..X-------X...,.,..,..,.,,,...............X-----XA....X---------------------X,,,X------
--------------------X.,......,..X-----XXX...,.,..,..,.,.,...,,,...,,,...X-----X.....X---------------------X,,,X------
--------------------X.,,,,E,,,..X-----:.,...,.,..,..,.,.,...,.,...,.,...X-----X..H..X---------------------X,,,X------
--------------------X.,,,,,,,,..X-----XXX...,.,,,,..,.,.,...,,,...,,,...XXXXXXX,,,,,XXXXXXXXXXXXXXXXXXXXXXX,,,XXXXXXX
--------------------X.,......,..X-------X...,.......,.,.,...............,.............,...........,.................X
--------------------X.,......,..X------XXE..,.......,.,,,...............,..E..........,...........,..............EH.X
--------------------X.,,,,,,,,..X------X,...,E......,.,:,...E...........,.............,...........,.................X
XXX+++XXXXX---------X...........X------XX...,.......,.,,,...,,,...,,,...XXXXXXXXXXXXXXXXXXXXXXXXXXXXX,,,,,XXXXXXXXXXX
X,,.,,,,,,X---------X.E.......E.X-------X...,.....T.,.,.,...,.,...,.,...X---------------------------X....,X----------
X.,.,.,,.,X---------XXXXX,,,XXXXX-------X...,,,,,,,,,.,.,...,,,...,,,...X---------------------------X....,X----------
X,,.,,,,,,X-------------X,,,X-----------X.....,,,,,...,.,...............X---------------------------X....,X----------
X.E.......X-------------X,,,X----------XX.....,,,,,...,.,...............X-------------XXXXXX++XXXXXXX,,,,,XXXXXXXXXXX
X......E..X-------------X,,,X----------X,.....,,,,,...,,,.E.............X-------------X.....,,,....,,.....,.......H.X
X.........X-------------X,,,X----------XX.....,,,,,...,:,...,,,...,,,.E.X-------------X,,,.........,,.....,,,,,,,,,,X
X,,.....,,X-------------X,,,X-----------X............T,,,...,.,...,.,...X-------------X,.,.........,,.....,,,,,,,,,,X
XE,.....,,X-------------X,,,X-----------XXXXXXXXXXXXXXXXX...,,,...,,,...X-------------X,,,.........,,.....,,,.....,,X
X,.,...,.,X-------------X,,,X---------------------------X...............X-------------XE...........,,.....,,,.....,,X
X,.,...,.,X-------------X,,,X-XXXXXXXXXXXXXXXXXXXXXXX---X...............X-------------X............,,.....,,,.....,,X
X,..,.,..,X-------------X,,,X-X.....................X---X..E........E...X-------------X,,,.........,,..E..,,,,,,,,,,X
XE..,.,..,XXXXXXXXXXXXXXX,,,XXX.E...................X---XXXXXXX,,,XXXXXXX-------------X,.,.........,,.....,,,,,,E,,,X
X,..,.,..,,...................,.,,,,,,,,,,,,,,,,,E..X---------XtttX-------------------X,.,.........,,.....,,,,,,,,,,X
X,.,...,.,,...................,.,,,,,,,,,,,,,,,,,,..X---------X.W,X-------------------X,.,.........,,.....,,,,,,,,,,X
XH.,...,.,,...................,.,,,,,,,,,,,,,,,,,,..X---------XXXXX-------------------X,,,.........,,.....,,,...,.,,X
X,,.....,,XXXXXXXXXXXXXXXXXXXXX.,,,,...........,,,..X---------------------------------X.E..........,,.....,,,,,,,,,,X
X,,.....,,X-------------------X.,,,,...........,,,..X---------------------------------X,,,.........,,.....,,,,,,,,,,X
X.........X-------------------X.,,E,...........,,,..X---------------------------------X,,,.........,,.....,.....E...X
XE........X-------------------X.,,,,........E..,,,..X---------------------------------X,.,.........,,.....,,,,,,,,,,X
X.........X-------------------X.,,,,...........,,,..X---------------------------------X,,,.........,,E....,,,,,,,,,,X
X,,.,,,,,,X-------------------X.,,,,...........,,,E.X---------------------------------X..........A.,,.....,,,.,,,,,,X
X.,.,E,,E,X-------------------X.,,,,...........,,,..X---------------------------------XXX,,,XXXXXXXXX.....,,,,,,,,,,X
XE,.,,,,,,X-------------------X.,,,,...........,,,..X-----------------------------------X,,,X-------X.....,,,,,,E,,,X
XXXXXXXXXXX-------------------X.,,,,...........,,,..X-----------------------------------X,,,X-------X.E...,,,,,,,,,,X
------------------------------X.,,,,...........,,,..X-----------------------------------X,,,X------X......,,,,,,,,,,X
------------------------------X.,,,,,,,,,,,,,,,,,,..X---------------------------------XXX,,,XXXXXXXX,,,,,,,,,,,,,,,,X
------------------------------X.,,,,,E,,,,,,,,,E,,..X---------------------------------X......,,,,,,,......,,,,,,,,,,X
------------------------------X.,,,,,,,,,,,,,,,,,,..X---------------------------------X.E..E.,,,,,,,......,,,.,...,,X
------------------------------X.....................X---------------------------------X......,,,,,,,......,,,,,,,,,,X
------------------------------XXXXXXX,,,,,,,,,XXXXXXX---------------------------------XXXXXXXXXXXXXXXXXXXXXXXXXXXXXXX
------------------------------------X.........X----------------------------------------------------------------------
--------------------------------XXXXX,,,,,,,,,XXXXX------------------------------------------------------------------
--------------------------------X..A..............X------------------------------------------------------------------
--------------------------------+.................X------------------------------------------------------------------
--------------------------------+E.............E..X------------------------------------------------------------------
--------------------------------+.................X------------------------------------------------------------------
--------------------------------X..A............H.X------------------------------------------------------------------
--------------------------------XXXXXXXXXXXXXXXXXXX------------------------------------------------------------------
---------------------------------------------------------------------------------------------------------------------
