------------------------------------------------------------------------------XXXXXXXXXXXXXXXXXXXXXXXXXXXXXXXX-----------------------------------
------------------------------------------------------------------------------X............................t.X-----------------------------------
------------------------------------------------------------------------------X............................ttX-----------------------------------
---------------------------------------------------------XXX------------------X.........E...........E........X-----------------------------------
---------------------------------------------------------X..X-----------------X..............,,,.............X-----------------------------------
---------------------------------------------------------X..X-----------------X.............,.W.,............X-----------------------------------
--------------------------------------------------------XX,,XXXXXXXXXX--------X....E........,...,......E.....X-----------------------------------
--------------------------------------------------------X...,,,,,,,,.X--------X..............,,,.............X-----------------------------------
--------------------------------------------------------X...,,,,,,,,,X--------X........E.....,.,.............X-----------------------------------
--------------------------------------------------------X.E........,,X--------X..............,.,.............X-----------------------------------
--------------------------------------------------------X........E.,,X--------X..............,.,....E........X-----------------------------------
--------------------------------------------------------X..........,.X--------X..............,.,..........E..X-----------------------------------
------------------------------------------------XXXXXXXXX,,,..,,,..,,X--------X....E.........,.,.............X-----------------------------------
------------------------------------------------XE......,..,..,H,..,,X--------X..............,.,.............X-----------------------------------
------------------------------------------------X.......,..,..,.,..,,X--------X...,,,.......,,,,,.......,,,..X-----------------------------------
-------------------------------------------------XXX,XXXX,,,..,,,..,,X--------X..,..,,,,,,,,,..,,,,,,,,,...,.X-----------------------------------
---------------------------------------------------X..X-X,,,.E...E.,,X--------X..,.H,.......,.T.,......,.A.,.X-----------------------------------
---------------------------------------------------X..X-X,,,.......,,X--------X..,..,.......,...,......,...,.X-----------------------------------
---------------------------------------------------X..X-X,,,.......,,X--------X..,..,,,,,,,,,H..,,,,,,,,...,.X-----------------------------------
---------------------------------------------------X..X-X,,,,,,,,,,,,X--------X...,,,.......,,,,,.......,,,..X-----------------------------------
---------------------------------------------------X..X-XXXXXXXXXXXXXX--------X..............,.,.............X-----------------------------------
---------------------------------------------------X..X-----------------------X.....E........,.,..........E..X-----------------------------------
---------------------------------------------------X..X-----------------------X..............,.,.............X-----------------------------------
--------------------------------------------XXXXXXXX,,XXXXXXXX----------------X..............,.,.............X-----------------------------------
--------------------------------------------XW.E..L...,L.E.t.X----------------X..............,.,....E........X-----------------------------------
--------------------------------------------XXXXXXX,,,XXXXXt.X----------------X........E.....,,,.............X-----------------------------------
--------------------------------------------------X...X----XXX----------------X.............,...,............X-----------------------------------
--------------------------------------------------X...X-----------------------X.............,.H.,..........E.X-----------------------------------
---------------------------------XXXXXXXXXXXXXXXX-X...X-----------------------X....E.....E..,...,............X-----------------------------------
---------------------------------X...AXX........X-X...X-XXXXXXXXXX--XXXXX-----X..............,,,.....E.......X-----------------------------------
---------------------------------X....XX.....E..X-X...X-X........,XXX...X-----X..............................X------XXXXXXXXXXXXXXXXXXXXXX-------
---------------------------------X.E..+,...T....XXX,,,XXX..K.....,+++.H.X-----X..............................X------X....XX..............X-------
---------------------------------X....XX.E.....AXX.....XX.....E..,XXX...X-----X..............................X------X.A..,,..............X-------
---------------------------------XX,,XXXX,,,,,,XXX.....XXX,,,,,,,X--X,,XX-----XXXXXXXXXXXXXXXXXXXXXXXXXXXXXXXX------X....,,..,,,....,,,,.X---XXX-
---------------------------------XX,,XXXX,,,,,,XXX,,,,,XXX,,,,,,,XXXX,,XX-------------------------------------------X....,,.,...,,,,....,X---X..X
--------XXXXXXXXXXXXXXXXXXXXXXXXXX....XX...........................XX...X-------------------------------------------X....,,.,.E.,..,.E..,X---XE.X
--------X.......................XX....XX...........................XX...X-------------------------------------------X....,,.,...,,,,....,X---X..X
--------X....................,,,XX....XX...........................XX...X-------------------------------------------X....,,..,,,....,,,,.X---X..X
--------X....................,,,XX....XX.E..........,,,.........E..XXA..X-------------------------------------------X....,,..............XXXXX..X
--------X.......,,,,...H....,...XX....XX...........,.<.,...........XX...X----XXXXXX---------------------------------X....,,..............,.E.,..X
--------X...E.,,...,.......,,...XXE...XX...........,...,...........XX...X---X,.,.,.X--------------------------------X....,,..............,...,..X
--------X.....,..E.,,......,,...XX....XX...........,...,...........XX...X--X.,.,E,.X--------------------------------X....,,..............,...,..X
--------X.....,....,,,,,,,,,,...++....XX............,,,............XX...X--X.,.,,.,.X-------------------------------X....,,..,,,....,,,,.XXXXX..X
--------X.....,....,,,,,,,,,,...++....XX............,,,............XX...X-X,.XXXX.,.X-------------------------------X....,,.,...,,,,....,X---X..X
--------X.....,....,,,,,,,,,,...++....XX............,.,............XX...X-X.,X---X.,X-------------------------------X....,,.,...,,,,....,X---X..X
--------X.....,.E..,,,,,,,,,,...XX....XX............,,,............XX...XX,.X----X.,.X----------------------------XXX....,,.,.E.,tH,..E.,X---X..X
--------X.....,..A.,,,....,,,...XX....XX............,.,............XX...,,,X------X.,X--------------------------XX,.,....,,.,,,,,,,,,,,,.X---X..X
--------X.....,....,,......,,...XX....XX............,,,............XX...,,X-------X,.X-----------XXXXXXX-------X..,.,....,,..............X---X..X
--------X.....,,,,,,........,...XX....XX............,.,............XX...XX--------X..X-----------X,.,..,X------X,.,.,....,,..............X---XE.X
--------X.....,....,.........,,,XX....XX............,,,............XX...X---------X,,X----------X.,.,..,.XX----X,.,.,....,,.......T......X---X..X
--------X......,,,,,.........,,,XX....XX............,,,............XX...X---------X..X----------X,,,.,,.E..X---X.,XXX....,,..............X---X..X
--------X......,..,...H.........XX....XXH...........,.,............XX...X---------X..X---------X...XXXX.,.,X--XE,.X-X....,,..............X---X..X
--------X.......,,,.............XX....XX..,,,.......,,,.......,,,.HXX...X---------X.E.X--------X,,.X---XX.,.XX.,.X--X....,,..,,,....,,,,.X---X..X
--------X.......,.E,............XX....XX.,.E.,......,.,......,.E.,.XX...X---------X...X--------X..,X-----X..,.,,.X--X....,,.,...,,,,....,X---X..X
--------X........,,.,...........XX....XX,,...,......,,,......,...,,XX...X---------X...X--------XE.,X------XX,.,.X---X....,,.,.E.,..,..E.,X---X..X
--------X..........,.,..........XX....,,.,...,.....,...,.....,...,B,,...X---------X.,,X--------X,,.X--------XXXX----X....,,.,...,,,,....,X---X..X
--------X.....E.....,.,,.....E..XX....,,HB...,.....,...,.....,...,.,,...X---------X,..X---------X.,.X---------------X....,,..,,,....,,,,.XXXXX..X
--------X............,..,.......XX....XX.,...,.....,...,.....,...,.XX...X---------X...X----------X..,X--------------X....,,..............,...,..X
--------X.............,,,.......XX....XX,,...,......,,,......,...,,XX...X----------X..,X---------X,,.X--------------X....,,..............,...,..X
--------X.............,..,......XX....XX.,...,......,.,......,...,BXX...X----------X.,..X--------X,,.X--------------X....,,..............,.E.,..X
--------X............H.,,,......XX....XX..,,,.......,,,.......,,,..XX...X----------X.,..X--------X,.,X--------------X....,,..............XXXXX..X
--------X..............,,,......XX....XX............,.,............XX...X-----------X..,.X------XE.,X---------------X....,,..,,,....,,,,.X---X..X
--------X........,,....,.,......XX....XX............,,,............XX...X-----------X..,.,XXX--X,,,.X---------------X....,,.,...,,,,....,X---X..X
--------X......,,,.,,..,,,......XX....XX............,.,............XX...X------------X.,.,E.,XX,,..X----------------X....,,.,.E.,tHt..E.,X---X..X
--------X.....,,..,,.,,,,,......XX.E..XX............,,,............XX...X------------X,.,.,.,,,,.,X-----------------X.H..,,.,...,t,,....,X---X..X
--------X....,..,.,,.,,..,......XX....XX............,.,............XX...X-------------XX,.,,.,,.,X------------------X....XX..,,,....,,,,.X---X,,X
--------X...,,..,,..,,,E.H......XX....XX............,,,............XX...X------XXXXXXXX-XX,,.,,.X-------------------X....XX..............X---X..X
--------X...,.E,.....,,..,......XX....XX............,.,............XX...X------X......X---XXXXXX--------------------XXXXXXXH.............X---X..X
--------X...,..,......,,,,...E..XX....XX............,,,............XX...X------X.....HX-----------------------------------XXXXXXXXXXXXXXXX---X..X
--------X...,,,.................XX....XX............,.,............XX...X------X..K...X------------------------------------------------------X..X
--------X...,.,.................XX....XX..,,,.......,,,.......,,,.BXX...X------X......X------------------------------------------------------X..X
--------X...,.,..H..............XX....XX.,...,......,.,......,.E.,.XX...X------XXX+++XX------------------------------------------------------X..X
--------X...,.,,................XX....XX,,...,......,,,......,...,,XX...X----XXXXX+++XXXX-----XXXXXXXXXXXXXXXXXXXXXXXXXXXXXXXXXXXXXXXXXXXXXXXX,,X
--------X...,,.,................XX....,,.B...,.....,...,.....,...,B,,...X----X,,........X-----X..E..,,.............E.......E..........H......,..X
--------X...,..,............E...XX....,,H,...,.....,...,.....,.T.,.,,...X----X.,......E.X-----X.....,,....E.......................E.......E..,..X
--------X....,,,................XX....XX.,...,.....,...,.....,...,.XX...X----X,,........X-----XX,,,XXXXXX,,,XXXX,,,XXXXX,,,XXXX,,,XXXX,,,XXXXX..X
--------X....,,,,...............XX....XX,,..E,......,,,......,...,,XX...X----X,,E.....,,X-----XX,,,XXXXXX,,,XXXX,,,XXXXX,,,XXXX,,,XXXX,,,XXXXXXXX
--------X....,,,,,,,,,,,,.......XX....XX.,...,......,,,......,...,.XX...X----X........,.X-----X.....,..........................................HX
--------X....,.E.,,...,..,,.....XX....XX..,,,.......,,,.......,,,..XX...X----X........,,X-----X.B...,.A........................B.....B....B.....X
--------X....,...,,E..,..,.,....XX....XX............,,,............XX...X----XXXX,,,,,XXX-----X.....,........................................B..X
--------X....,.H.,,..,,,,..E,...XX....XX............,,,............XX...X-------X.H...X-------X.....,...........................................X
--------X....,,,,,,,,....,,.,,..XX....XX............,,,............XXA..X----XXXX,,,,,XXX-----X.....,.....................................,,,,,.X
--------X..................,..,.XX..A.XX............,.,............XX...X----X,,......,,X-----X.....,,,,..................................,..,ttX
--------X..............H...,.,,.XX....XX...E........,,,............XX...X----X.,......,.X-----X.....,,,,,,,,,,,,,,,,,,,,,,,,,,,,,,,,,,,,,,,T.,,.X
--------X...................,.,.XX....XX.........,,,,,,,,,.....E...XX...X----X,,......,,X-----X.....+,,,,,,,,,,,,,,,,,,,,,,,,,,,,,,,,,,,,,,..,,.X
--------X...................,..,XX....XX........,.........,........XX...X----X.E...E....X-----X.....+,,,..................................,..,,tX
--------X..........E.........,,,XX....XX........,.........,........XX...X----X..........X-----X.....,.....................................,,,,,.X
--------X....................,.,XX....XX........,.........,........XX...X----X..........X-----X.....,...........................................X
--------X................H...,,,XX....XXXXXXXXXXXX,,,,,,XXXXXXXXXXXXX...X----X..........X-----X.....,......................................B....X
--------X....................,,,XX,,,,XXXXXXXXXXXX,,,,,,XXXXXXXXXXXXX,,,X----XXXX,,,,,XXX-----X.B...,.A.........................B....B....B.....X
--------X....E...............,,,XX......................................X-------X.H...X-------X.....,..........................................HX
--------X..................,,,,,XX.E..........E......................E..X----XXXX,,,,,XXX-----XX,,,XXXXXXXXXXXXXXXXXXXXXXXXXXXXXXXXXXXXXXXXXXXXXX
--------X..................,A.EWXX......................................X----X..E.......X------X+++X---------------------------------------------
--------X..................,....XX......................................X----X..........X------X,,,X---------------------------------------------
--------XXXXXXXXXXXXXXXXXXXXX,,XXXXXXXXXXXXXXXXXXXXXXXXXX,,,,,,,,,XXXXXXX----X.........EX------X...X---------------------------------------------
----------------------------XX,XX-----------------------X.........X----------X..........X------X..KX---------------------------------------------
----------------------------X,,,X-----------------------X,,,,,,,,,X----------X..E.......X------X,,,X---------------------------------------------
----------------------------X,,,X-----------------------X.........X----------X..........X------X...X---------------------------------------------
----------------------------X,,,X-----------------------X.........X----------X..........X------X,,,XX--------------------------------------------
----------------------------X...X-----------------------X.........X----XXXXXXXXXXX,,XXXXX------X.H..X--------------------------------------------
----------------------------X,,,X-----------------------X,,XXXX,,XX----X:..WX----X..X----------X....X--------------------------------------------
----------------------------X,,,X-----------------------X..X--X..X-----X....X----X..X----------X....X--------------------------------------------
----------------------------X...X-----------------------X..X--X..X----XXX++XXXXXXX,,X----------X>>>>>--------------------------------------------
----------------------------X...X-----------------------X..X--X..X----X.............X------------------------------------------------------------
----------------------------X...X-----------------------X..X--X..X----X.............X------------------------------------------------------------
----------------------------X,,,X-----------------------X..X--X..X----XX,,,,XXXXXXXXX------------------------------------------------------------
----------------------------X...X-----------------------X..X--X..X-----X....X--------------------------------------------------------------------
----------------------------X...X----------------------X..XXXXX...X----X....X--------------------------------------------------------------------
----------------------------X...X---------------------X..X-X..XX..X----X....X--------------------------------------------------------------------
----------------------------X,,,X-------------------XXX,,XXX++XX,,,XXXXX,,,,XXXX-----------------------------------------------------------------
----------------------------X,,,X-------------------X.................X.,..,...X-----------------------------------------------------------------
----------------------------X...X-------------------X.................X.,..,.H.X-----------------------------------------------------------------
----------------------------X,,,X-------------------X,,,,,,,,..,,,,,,.X.,,,,...X-----------------------------------------------------------------
----------------------------X,,,X------------------XX.E.....,..,....,.X.,..,...X-----------------------------------------------------------------
----------------------------X,,,X------------------X,.......,..,....,.X.,,,,...X-----------------------------------------------------------------
----------------------------X...X------------------X,...E.E.,..,,,,,,.X.,..,...X-----------------------------------------------------------------
----------------------------X,H,X-------------------X.......,..,....,.X.,,,,...X-----------------------------------------------------------------
----------------------------X,,,X-------------------X,,,,,,,,..,,,,,,.X.,..,...X-----------------------------------------------------------------
----------------------------XX+X--------------------X..........,....,.X.,,,,...X-----------------------------------------------------------------
XXXXXXXXXXXXXXXXXXXXXXXXXXXXX,,,XXXXXXX-------------X,,,,,,,,..,....,.X.,..,...X-----------------------------------------------------------------
X,....,H..........,,,,,,,,..,...,.....X------------XX.......,..,,,,,,.X.,..,...X-----------------------------------------------------------------
X,E...,.....E.....,.A....,..,,,,,..H..X------------X,.....E.,..,....,.X.,,,,...X-----------------------------------------------------------------
X,....,,,,,,,,,,,,,...,,,,,,,,,,,.....X------------X,E..E...,..,,,,,,.X.,..,..EX-----------------------------------------------------------------
X,..A.,,.......,.,,...,,,,,,,,,,,.....X-------------X,,,,,,,,..,....,.X.,,,,...X-----------------------------------------------------------------
X,....,,,,,,,,,,,,,......,....,,,,,,,.X-------------X..........,....,.X.,..,...X-----------------------------------------------------------------
X,,,,,,........,.,,.H,,,.,.H..,,,...,.X-------------X,,,,,,,,..,,,,,,.X.,,,,...X-----------------------------------------------------------------
X...........H..,.,,,,,,,,,....,,,.A.,.X------------XX.....E.,..,....,.X.,E.,...X-----------------------------------------------------------------
X.....E........,.,...,.,......,.....,.X------------X,.E.....,..,,,,,,.X.,,,,...X-----------------------------------------------------------------
X.......,,,,,,,,.,...,.,......,.....,.X------------X,....E..,..,....,.X.,..,...X-----------------------------------------------------------------
X.......,.....,,.,...,.,......,.E...,.X-------------X.......,..,....,.X.,..,...X-----------------------------------------------------------------
X.......,..E..,,.,.E.,.,.E....,,,,,,,.X-------------X,,,,,,,,..,,,,,,.X.,,,,...X-----------------------------------------------------------------
X..E....,.....,,.,...,.,..............X-------------X,,,,,,,,..,....,.X.,..,...X-----------------------------------------------------------------
X.......,.....,,,,,,,,,,..............X-------------X.......,..,,,,,,.XXX,,XX,,X-----------------------------------------------------------------
X.......,.H..A,,.....,.,...........E..X------------X,.E....E,..,....,.X-X..XXXX------------------------------------------------------------------
X.......,,,,,,,,,,,,,,,,..............X------------X,.......,..,,,,,,.X-X..X---------------------------------------------------------------------
XXXXXXXXXXX,,XXXXXXXXXXXXXXXXXXXXXXXXXX------------XX...E...,..,....,.X-X..X---------------------------------------------------------------------
----------X..X--------------------------------------X,,,,,,,,..,....,.X-X..X---------------------------------------------------------------------
----------X..X--------------------------------------XXXXXXXXXXXX,,,,XXX-X.EX---------------------------------------------------------------------
----------X..X-------------------------------------------------X....X---X..X---------------------------------------------------------------------
----------X..X-------------------------------------------------X....X---X..X---------------------------------------------------------------------
----------X..X-------------------------------------------------X..E.X---X..X---------------------------------------------------------------------
----------X,,X--------XX---------------------------------------X....X---X..X---------------------------------------------------------------------
--XXXXXXXXX,,XX-----XX,.X-------------------------------------XX,,,,XXXXX,,XX--------------------------------------------------------------------
--X...........XXX-XX,.,.,X-----------XXXXXXXXXX---------------X............BX--------------------------------------------------------------------
--XB.B.B.....E,.XX,.,,.,..X----------X,,.E.E.,X---------------X...E..B.B....X--------------------------------------------------------------------
--X...........,.,,,.XXXX.,X----------X.,,,,,,.X---------------X.............X--------------------------------------------------------------------
--X...........,.,,XX----X..X---------X.,,,,,,.X---------------X.............X--------------------------------------------------------------------
--X.E.........,.XX------X.,X---------XE,,...,AX---------------X......H......X--------------------------------------------------------------------
--X...........XXX--XXXXX-X..X--------X.,,,,,,.X---------------X.............X--------------------------------------------------------------------
--XX,,,XXXXXXXX----XA,,X-X,,X--------X,,....,,X---------------X..........E..X--------------------------------------------------------------------
---X...XXXXXXXX-XX-X.,.X-X..X--------X.,....,,X---------------X.E...........X--------------------------------------------------------------------
---X...XX.E..EX-XXXX.,,X--X,X--------X,,....,,X---------------X....B..B.B..BX--------------------------------------------------------------------
---X...XX.....X-X,.,..,X--X.X--------X,,....,,X---------------XXXXXXXXXXXXXXX--------------------------------------------------------------------
--XX,,,XX.....X-XXXX,,,X-X.X---------X.,....,.X--------------------------------------------------------------------------------------------------
--X..........HX-XX-X,..X-X,X---------X.,....,EX--------------------------------------------------------------------------------------------------
--XB......E...X-XX-XXXXX-X,X---------X.,....,.X--------------------------------------------------------------------------------------------------
--X....,.....,X-XXXXXXXXX,,X---------X.,....,.X--------------------------------------------------------------------------------------------------
--X.,...,,,,,,XXXXX........X---------X.,..E.,.X--------------------------------------------------------------------------------------------------
--X,H,,,,.,,..XX.XX.,,,,,,,X---------X.,....,.X--------------------------------------------------------------------------------------------------
--X.,.,,,,,,,,XX.++.,...E.,X--------X,.,...,..X--------------------------------------------------------------------------------------------------
--X..,...E.,.,XXXXX.,.....,X-------X,,.,...,..X--------------------------------------------------------------------------------------------------
--X,,,.....,.,X--XX.,.,,,.,XXXXXXXX,,,.,..,..X---------------------------------------------------------------------------------------------------
--X,,.,,,,,,.,X--X,.,.,.,.,,,,,,,,,,,,.,..,..X---------------------------------------------------------------------------------------------------
--X...,.,,.,,,X--X,.,.,,,.,XXXXXXX,,,,.,.,.BX----------------------------------------------------------------------------------------------------
--X,,,,,,,,..HX--X,.,.....,X------XX,,.,.,..X----------------------------------------------------------------------------------------------------
--X,.,........X--X,.E....E,X--------X,.,,.BX-----------------------------------------------------------------------------------------------------
--X,.,........X--XX.,,,,,,,X---------X.B,..X-----------------------------------------------------------------------------------------------------
--X,.,E......,X---XX,XX,XX,X---------X.,B.X------------------------------------------------------------------------------------------------------
--X,,,..,.E,,,X----XXXXXXXXX---------X...BX------------------------------------------------------------------------------------------------------
--X..E,,.,..,,X----------------------XXXXX-------------------------------------------------------------------------------------------------------
--X..,,,.,.,,,X----------------------------------------------------------------------------------------------------------------------------------
--X..,.,..,,.,X----------------------------------------------------------------------------------------------------------------------------------
--XA.,,,,.,,,,X----------------------------------------------------------------------------------------------------------------------------------
--XXXXXXXXXXXXX----------------------------------------------------------------------------------------------------------------------------------
