------------------------------------>>>--------------------------------
------------------------------------X.X--------------------------------
--------------------------------XXXXXLXXXXX----------------------------
--------------------------------X.........X----------------------------
--------------------------------X.ttt.ttt.X----------------------------
--------------------------------X.t.t.t.t.X----------------------------
--------------------------------X.ttt.ttt.X----------------------------
--------------------------------X.........X----------------------------
--------------------------------XXXXX,XXXXX----------------------------
------------------------------------X.X--------------------------------
------------------------------------X.X--------------------------------
------------------------------------X.X--------------------------------
------------------------------------X.XXXXX----------------------------
------------------------------------X.+..:X----------------------------
------------------------------------X.+W..E----------------------------
------------------------------------XE+..HX----------------------------
------------------------------------X.XXXXX----------------------------
------------------------------------X.X--------------------------------
------------------------------------X.X--------------------------------
------------------------------------X.X--------------------------------
------------------------------------XEX--------------------------------
------------------------------------X.X--------------------------------
------------------------------------X.X--------------------------------
------------------------------------X.X--------------------------------
------------------------------------X.X--------------------------------
------------------------------------X.X--------------------------------
------------------------------------X.X--------------------------------
------------------------------------X.X--------------------------------
-------------------------------XXXXXXEX--------------------------------
-------------------------------X..:++.X--------------------------------
-------------------------------XEW.++.X--------------------------------
-------------------------------X..H++.X--------------------------------
-------------------------------XXXXXX.X--------------------------------
------------------------------------X.X--------------------------------
------------------------------------X.X--------------------------------
------------------------------------X.X--------------------------------
------------------------------------X.X--------------------------------
------------------------------------XEX--------------------------------
------------------------------------X.XXXXX----------------------------
------------------------------------X.+.:.X----------------------------
------------------------------------X.+...E----------------------------
------------------------------------X.+.H.X----------------------------
------------------------------------X.XXXXX----------------------------
------------------------------------X.X--------------------------------
------------------------------------X.X--------------------------------
------------------------------------XEX--------------------------------
------------------------------------X.X--------------------------------
----------------------------------XXX,XX-------------------------------
----------------------------------XE...E-------------------------------
----------------------------------X..T.X-------------------------------
----------------------------------X....X-------------------------------
----------------------------------X,,,,X-------------------------------
-----------------------------------XLLLX-------------------------------
-------------------------------XXXX,,,,XXXXXX--------------------------
----------------------------XXX..............XXXX----------------------
--------------------------XX.......H.............XX--------------------
------------------------XX....................H....XX------------------
-----------------------X.........XXXXXXXXXX,,....H...XX----------------
---------------------XX......XXXXXXXXXXXXXX..,,,,......X---------------
--------------------X.......,XXXX...............,,,.....X--------------
--------------------X.....,,..............:.....,..,.....X-------------
-------------------X...H.,.....................,...,X....X-------------
-------------------X....,.......ttt............,..,X-X....X------------
-------------------X...,.,......t.t......E...,,...,.X-X....X-----------
------------------X....,.,......ttt........,,....,...X-X....X---XXXXXXX
------------------X.H.,...,..............,,.....,....HX-X...X---XWA<AWX
------------------X...,....,,..........,,.......,......XX...X---XA...AX
------------------X...,,,....,,,,,,,,,,....H...,.......XX...X---X....AX
------------------X...,..,...................,,........XX...X---X.....X
------------------X...,...,,...............,,..........XX...XXXXX.....X
------------------X...XX....,,...........,,............XX...,.T.+.<.<.X
------------------X...XX......,,,.....,,,..............XX...XXXXX.....X
------------------X...XX.........,,,,,.................XX...X---X.....X
------------------X...XX...................:...........XX...X---X.....X
------------------X.A.XX....:..........................XX...X---X.....X
------------------X...XX........:......................XX...X---XAA<.WX
-------------------X...XX.............................XX....X---XXXXXXX
-------------------X...XX...............E......H......XX...X-----------
-------------------X....XX...........................XX....X-----------
-------------------X....XX..........................AXX...X------------
--------------------X....XX.......................WA,X...X-------------
--------------------X.....XX.....................A,,.....X-------------
--------------------X..A...X,,HXXX.....H....XXXAA,.H....X--------------
---------------------X.....,..,XXXXXXXXXXXXXXXX,......,,.X-------------
---------------------XX....,...,......XXXXXX........,,..HX-------------
-----------------------XX..,.H.,..A....A..........XX..HE..X------------
-------------------------XX,..,..............XXXX+XX.E..XX-------------
---------------------------XXXXXXXXXX,,,XXXXX---X+....XX---------------
----------------------------------XXX+++XXXX-----X.EXX-----------------
----------------------------------XE..T...EX------XX-------------------
----------------------------------X........X---------------------------
----------------------------------X........X---------------------------
----------------------------------X..,,,,..X---------------------------
XXXXXXXXXXXXXXXXXXXXXXXXXXX-------X.,,,,,..X---------------------------
B..B..B.BB.B..B.B.B.BB.B.BX-------H,,,,,,,KX---------------------------
X.........................X-------X.,,,,,..X---------------------------
X.EA.E...E..E...E..E.EA.E.X-----XXX........X---------------------------
X.........................X-----X.t........X---------------------------
X......H............H.....X-----XXX......E.X---------------------------
X,,,,,,,,,,,,,,,,,,,,,,,,,X-------XE.......X---------------------------
X,,,,,,,,,,,,,,,,,,,,,,,,,X--------X......X----------------------------
X.........................X---------X,,,,X-----------------------------
X.,,,.....................XXXXXXXXXXX.H..XXXX--------------------------
X.+.,.A.AA..E..H..AAA.E...,+,,,,,,,,+....+t.X--------------------------
X.+,,.....................XXXXXXXXXXX.E..XXXX--------------------------
X.........................X---------XXXXXX-----------------------------
X,,,,,,,,,,,,,,,,,,,,,,,,,X--------------------------------------------
X.........................X--------------------------------------------
X.......H...+++.....H.....X-XXXXXXXXXXXXXXXXXXXXXXXXXXXXX--------------
X...A.E...E.+K+.E..E..A.E.X-X.tA.A.W.W.H.H.:.:.:.:.:...TX--------------
XE..........+++...........X-XXXXXXXXXXXXXXXXXXXXXXXXXXXXX--------------
X.........................X--------------------------------------------
BXBXBXXBXBXXBXBXBBXBXBBXBBX--------------------------------------------
-----------------------------------------------------------------------
