------------------------------------>>>---------------------------------
------------------------------------X.X---------------------------------
--------------------------------XXXXXLXXXXX-----------------------------
--------------------------------X.........X-----------------------------
--------------------------------X.ttt.ttt.X-----------------------------
--------------------------------X.t.,,t.t.X-----------------------------
--------------------------------X.ttt.ttt.X-----------------------------
--------------------------------XE......E.X-----------------------------
--------------------------------XXXXX,XXXXX-----------------------------
------------------------------------X.X---------------------------------
------------------------------------X.X---------------------------------
------------------------------------X.X---------------------------------
------------------------------------X.X---------------------------------
--------------------------------XXXXX.X---------------------------------
--------------------------------XH..X.X---------------------------------
--------------------------------:...,.X---------------------------------
--------------------------------XH..X.X---------------------------------
--------------------------------XXXXX.X---------------------------------
------------------------------------X.X---------------------------------
------------------------------------X.X---------------------------------
------------------------------------X.X---------------------------------
------------------------------------X,X---------------------------------
------------------------------------X.XXXXX-----------------------------
------------------------------------X.,.E:X-----------------------------
------------------------------------X.,...X-----------------------------
------------------------------------XE,.E.X-----------------------------
------------------------------------X.,...X-----------------------------
------------------------------------X.,...X-----------------------------
------------------------------------X.,E..X-----------------------------
------------------------------------X.,..:X-----------------------------
------------------------------------XEXXXXX-----------------------------
------------------------------------X,X---------------------------------
------------------------------------X.X---------------------------------
------------------------------------X.X---------------------------------
------------------------------------XEX---------------------------------
------------------------------------X.X---------------------------------
------------------------------------X.X---------------------------------
------------------------------------X.X---------------------------------
------------------------------------X.X---------------------------------
------------------------------------X.X---------------------------------
------------------------------------X.X---------------------------------
------------------------------------XEX---------------------------------
------------------------------------X.X---------------------------------
------------------------------------X.X---------------------------------
------------------------------------XEX-------------------X-------------
------------------------------------X.X------------------X.X------------
------------------------------------X.X------------------X..X-----------
----------------------------------XXX,XX----------------X..X------------
----------------------------------XA...A---------------X...X------------
----------------------------------X..T.X---------------X..X-------------
----------------------------------X....X--------------X..X--------------
----------------------------------XH,,,H--------------X..X--------------
-----------------------------------XLLLX-------------X..X---------------
-------------------------------XXXX,,,,XXXXXX-------X..X----------------
----------------------------XXX..A.......,...XXXXX--X.X-----------------
--------------------------XX.,.....:E....,.....A..XX,.X-----------------
------------------------XX...,............,.......,..X------------------
-----------------------X.....,...XXXXXXXXXX,,.....,..,X-----------------
---------------------XX......XXXXXXXXXXXXXX..,,,,,..,..X----------------
--------------------X.......,XXX.................,,.,T..X---------------
--------------------X.....,,..............:.....,..,..,,.X--------------
-------------------X.....,................:.....,..,X,....X-------------
-------------------X....,.......ttt............,..,X-X..E.X-------------
-------------------X...,,.......t.t......E...,,...,.X-X....X---XXXX-XXXX
------------------X....,.,......ttt........,,....,...X-X....H--XWAXXXAWX
------------------XH..,.,.,..............,,.....,.....X-X...H--XA..:..AX
------------------X...,.,..,,..........,,.......,......XX...X--XX..<.,XX
------------------X...,,.....,,,,,,,,,,........,.......XX...X---X,,,,.X-
------------------X...,.,,...................,,........XX...X---X.....X-
------------------X...,...,,...........T...,,..........XX...XXXXX.....X-
------------------X...XX....,,......H....,,............XX.:.,.T++<..<.X-
------------------X.,,XX......,,,.....,,,..............XX...XXXXX.....X-
------------------X,..XX.........,,,,,.................XX...X...X.....X-
------------------X...XX...............................XX...X...X,,,,.X-
------------------XH..XX....:..........................XX...X..XX..<.,XX
------------------X...XX........:K....................X-X...H..A,..:..,X
-------------------X.:.XX.............................XX....X..XWAXXX,WX
-------------------X.E.XX............................X-X...X...XXXX.XXXX
-------------------X....X..........E.................XX....X............
-------------------X.T..XX...........................XX...X.............
--------------------X....XX..........................X,,..X.............
--------------------X.....XX.......................,,...,X..............
--------------------X......X,,.XXX..........XXX.,,,.....X...............
---------------------X....,,..,XXXXXXXXXXXXX-XX,......,,.X..............
---------------------XA..,.,...,......XXXXXXX.,.....,,..EX..............
-----------------------XX..,...,........:.....,...XX.EW..AX.............
-------------------------XX,..,.,.....E.....XXXAX+XX....XX..............
---------------------------XXXXXXXXXX,,,XXXX....X+..E.XX................
--------------------------XXXXXX--XXXLLLXXXX.....XA.XX..................
--------------------------X..EtX--X:..T...:X......XX....................
--------------------------XE..tX--X........X............................
--------------------------XXXXXX--XH......HX............................
---------------------------XXXXX--X,.,,,,,,X............................
XXXXXXXXXXXXXXXXXXXXXXXXXXXXtttX--X.,,,,,..X............................
XB.BAB.B,.BB..B.B,B.B.BB.BXX...X--X,,,,,,,,X............................
X.......,A...A.,,A....A...XE.EEX--X.,,,,,..X............................
X......,......,.......,...XE.EEXXXXE.....,,XXX..........................
XA....HE....,,H....E..,..AXX...XX.t.....,E.+KX..........................
X.....,...,,..,....H..,...XE.EEXXXX....,...XXX..........................
X,,,,,,,,,,,,,,,,,,,,,,,,,XXtttXXXX....,...X............................
X,,,,,,,,,,,,,,,,,,,,,,,,,XXXXXXX.E,...,..XE............................
XE...,,.......+.......,...X-----X...X,,,,X..............................
X.,,,.........+E......,...XXXXXXXXXXX....XXXX...........................
X.,K,....A..H.+.....W.,...,+,,,,,,,,+.E.E+t.X...........................
X.,,,.........+.......,...XXXXXXXXXXX..A.XXXX...........................
XE..,,,.......+.E.....,...X.........XXXXXX..............................
X,,,,,,,,,,,,,,,,,,,,,,,,,X.............................................
X....,....,,..,.......,...X.............................................
X.....,.....,,,.......,...X.XXXXXXXXXXXXXXXXXXXXXXXXXXXXX...............
XAE..E,..H..E.,E..EH.E,EEAX.X.HHHHH.HHHHHHHHHHHHHHHHHH.TX...............
X......,.......,,.....,...X.XXXXXXXXXXXXXXXXXXXXXXXXXXXXX...............
X......,.....A...,A...A...X.............................................
BXBXAXXBABXBXXBXBBXBXBBXBBX.............................................
........................................................................
