----------------------------------------X:X:X:X----------------------------
----------------------------------------X:.:.:X----------------------------
----------------------------------------X.....X----------------------------
----------------------------------------X..E..X----------------------------
----------------------------------------X,,,,,X----------------------------
----------------------------------------X.....X----------------------------
----------------------------------------X,,,,,XX---------------------------
--------------------------------------XX,..K..,.XX-------------------------
------------------------------------XX..,..,..,...X------------------------
------------------------------------X...,,,.,,,...X------------------------
-----------------------------------X...XX,,,,,XX...X-----------------------
-----------------------------------X...XX.,.,.XX...X-----------------------
----------------------------------X,,,,,,,,,,,,,,,,,X----------------------
----------------------------------X.................X----------------------
----------------------------------X.................X----------------------
----------------------------------X................HX----------------------
----------------------------------XXXXXXXXX,XXXXXXXX-----------------------
------------------------------------------XLX------------------------------
-----------------------------------XX---XXX,XXXXX--------------------------
-----------------------------------XX---X.......X--------------------------
-----------------------------------XX-XXX....XX.X--------------------------
--------------------------------------XE,....,,.X--------------------------
-----------------------------------XX-X.,.......XX-------------------------
-----------------------------------XX-XE,.......,X-------------------------
-----------------------------------XX-X.,.......,X-------------------------
--------------------------------------XE,.......,X-------------------------
----------------XXX-------------------XXX.......XX-------------------------
----------------X.X---------------------X.......X--------------------------
--XXXXXXXXXXXXXXX.XXX-------------------X,,,,...X--------------------------
--XH.....E...E..,.t.X-------------------X,,,,,,.X--------------------------
--X.XXXXXXXXXXXXX.XXX-------------------X,,..,,.X--------------------------
--X.X-----------X.X---------------------X,,,,...X--------XXX---------------
--X.X-----------X+X---------------------X.,.....X-------XX,XX-------XXX----
--X.X-----------X+X---------------------X.......X-----XX.....XX-----XEX----
--X.X----------XX,XX--------------------XXXXXXLXX----X.........X----XXX----
--XEX-------XXX.....XXX----------------------X+X---XX...........XX---------
--X.X-----XX...........XX-------------------XX,XX-X...............X--------
--X.X-----X......E......X-------X----------XXX..X-X...............HX-------
--X.X----X...............X----HXXXX-------X.,,..HXX................X-------
--XEX----X...,,,,,,,,,...X---H.,,,HH-----X......XXX.................X------
--X.X----X...,,,,,,,,,...X--XH.,,,.HX---X.E...E.X-X.....,,,....,,....X-----
--X.X---X....,,,,,,,,,....X-X.,,E,..X--X..,,,...XXX.....,..,,,,.,....X-----
XXX,XXXXX....,,,.,,,,,.,,,XXX..,,,..X-XXX.,,,,,.,,,.....,.,,..,.,.....X----
+.....,+,....T,,.K,,,,.,..,+,.......XXX,,.,,.,,.,,,......,,,.,,,......X-XXX
XXX,XXXXX....,,,,,,,,,.,,,XXXXX.E...,+,..E,,T,,E,,,.T....,..T..,......X-XEX
--X.X---X....,,,,,,,,,....X-X,,.....XXXXX.,,,,,.,,,......,.,.,.,......X-XXX
--X.X----X...,,,,,,,,,...X--X...E...X-X,,.,,,,,.XX,......,,,..,,......X----
--XEX----X...,,,,,,,,,...X--X.......X--X........XXX.....,..,,,,.,....X-----
--X.X----X...............X--XH.XX..HX---X.E...E.X-X.....,,,....,,....X-----
--X.X-----X......E......X----XH,,.HX-----X......HXX.................X------
--X.X-----XX...........XX-----XXXLX-------X.XX..XXX.tt,............X-------
--XEX-------XXX.....XXX-----XX--XLX--------X,,..X-X.tt,..........H.X-------
--X.X----------XX+XX--XX-XXXXXXXX,X-XXXXX---XXLXX-X.,,,...........X--------
--X.X-----------X+X---XX-Xt.......X-XHt.X----XLX---XX...........XX---------
--X.X-----------X,X---XX-Xt.......X-XXXXX-XXXX,XXX---X.........X----XXX----
--X.X-----------X.X---XX-XX.......X-------X......X----XX.....XX-----XEX----
--X.XXXXXXXXXXXXX.XXX-XX--XXXXXXXXX-------X.......X-----XXXXX-------XXX----
--XH.....E...E..,.t.X---------------------XE.E.E.EX------------------------
--XXXXXXXXXXXXXXX.XXX-XX------------------X.,,,,,.X------------------------
----------------X.X---XX-----------------XXE,E.E,EX------------------------
----------------XXX---XX-----------------XX.,,.,,.X------------------------
------------------------------------------XE,E,E,EX------------------------
------------------------------------------X...,,..X------------------------
------------------------------------------XE.E.E.EX------------------------
------------------------------------------X.......X------------------------
------------------------------------------XH.....X-------------------------
--------------------------------------------XX,XX--------------------------
---------------------------------------------XKX---------------------------
---------------------------------------------XXX---------------------------
