----------------------------------------------------------------------XXXXXXXXX----------------------------------------------
----------------------------------------------------------------------XE.....EX----------------------------------------------
----------------------------------------------------------------------X.,,,,,AXXXXX------------------------------------------
-------------------------------------------------------XXXXXXXXXXXXXXXX.,...,.,,,,X------------------------------------------
-------------------------------------------------------XE.E.E,H.H..H.H,.,...,.,,H,X------------------------------------------
-------------------------------------------------------X..A..XXXXXXXXXX.,...,.,,,,X------------------------------------------
------------------XXXXXXXXXXXXXXX----------------------X.,,,.X--------XE,,,,,EXXXXX------------------------------------------
------------------X...,.,,.,....X----------------------X.,H,.X--------X.......X----------------------------------------------
------------------X....,.E,...E.X----------------------X.,,,.X--------XXX,,,XXX----------------------------------------------
------------------X....H..,.....X----------------------XX,,,XX----------X+++X------------------------------------------------
------------------X...XXXXXXX...X---------------XXXXXXXXX,,,XXXXXXXXXXXXX,,,XXX----------------------------------------------
------------------X...X-XX--X...X---------------X..H..........................X----------------------------------------------
------------------X...XXXXX-X...X-----XXXXXXX---X.H...................E..E..E.X----------------------------------------------
------------------X......AX-X...X-----XA.A.HX---X.............................X----------------------------------------------
------------------X.....E.X-X...XXXXXXX,,,,,XXXXX,,,,,,,,,,,,,,,,,,,,,,,,,,,,,XXXXX------------------------------------------
------------------X.......X-X..................,,.,.,.,.,.,.,.,...............,,..X------------------------------------------
------------------XXXXX...X-X..................,,.,.,.,.,.,.,.,.............E.,,..X------------------------------------------
----------------------X...X-X..................,,.,.,.,.,.,.,.,...............,,..X------------------------------------------
----------------------X...X-X...XXXXXXX,,,,,XXXXX,,,,,,,,,,,,,,,,,,,,,,,,,,,,,XXXXX------------------------------------------
----------------------X...X-X...X-----XA.H.HX---X.............................X----------------------------------------------
----------------------X...X-X,..X-----XXXXXXX---X.....................E..E..E.X-----------------XXXXXXXXX--------------------
----------------------X...X-X.,,X---------------X................H............X-----------------X.......X--------------------
----------------------X,..XXX,E.X---------------X...............XXXXXXXXX,,,XXX-----------------XXX,,,XXX--------------------
----------------------X.,,XXX,..X---------------X..............X--------X+++X---------------------XEHEX----------------------
---------------------XX,E.X-X.,,X---------------X.............X---------X,,,X-------------------XXX,,,XXX--------------------
---------------------XX,..X-X,..X---------------X............X----------X...X-------------------XH......X--------------------
----------------------X.,,X-X...XXXXXXXXXXXXX---X...........X-----------X,,,X-----------------XXX.,,,,,.XXX------------------
----------------------X,.HX-X....E.........AX---X...........X-----------X,,,X-----------------X.,.,...,.,.X------------------
----------------------X...X-X.........E.....X--XX...........XX----------X,,,X---------XXXXXXXXX.,.,.E.,.,.X------------------
----------------------X...X-XH..............X--X,...........,X----------X,,,X---------X.......,.,.,...,.,.X------------------
----------------------X.E.X-XXXXXXXXXXXXX...X--X,E....W....E,X----------X,,,X---------XXX,,,,,XXX.,,,,,.XXX------------------
----------------------X...X-------------X...X--X,...........,X----------X,,,X-----------XEAEHEX-X.......X--------------------
------------------XXXXX...XXXXXXXXXXXXX-X,..X--XX...........XX----------X,,,XXXXXXXXXXXXX.....XXX.......XXX------------------
------------------XA........,.,,.,.E,AX-X.,,X---XE.........EX-----------X,,,,,,,,,,,,..........A.........EX------------------
------------------X..........,.E,...,.XXX,E.X---XXX.......XXX-----------X,,,,,,,,,,,,....................HX------------------
------------------X,.........,..,..E,HXXX,..X----XX,,,,,,,X-------------XA,,,,,,,,,,,....................EX------------------
------------------X.,,XXXXXXXXXXXXXXXXX-X.,,X----XX,,,,,,,X-------------XXXXXXXXXXXXXXXXXXXXXXXXXXX,,,XXXXX------------------
------------------X..EX-------XX--------X,..X-----X.......X---------------------------------------X...X----------------------
------------------X...XXXXXXXXXXXXXXXXXXX...X-----X.......X-------------XXXXXXXXXXXXXXXXXXXXXXX---X...X----------------------
------------------X.,,......,.,,.,.A........X-----X......EX-------------X...,,......E.....,,,,X---X,,,X----------------------
------------------X,.........,.E,.....E.....X-----X,,,,,,,X-------------X...,,............,,,,X---X,,,X----------------------
------------------X..........,..,...........X-----X.......X-------------X...,,.E..........,,,,X---X...X----------------------
------------------XXXXX...XXXXXXXXXXXXXXXXXXX-----X,,,,,,,X-------------X,,,XXXXXXXXXXXXXXX,,,X---X...X----------------------
----------------------X..HX---XX------------------X......HX-------------X...X-------------X...X---X,,,X----------------------
----------------------X...X-----XXXXXXXXX---------X.......X-------------X...X-------------X...X---X,,,X----------------------
----------------------X.E.X-----XH....,HX---------X.......X-------------X...X-------------X...X---X..HX----------------------
----------------------X...X-----X....E,HX---------X...E...X-------------X,,,XX------------XE..X---X...X----------------------
----------------------X...X-----X.....,HX---------X.......X-----------XX......X-----------X...X---X,,,X----------------------
----------------------X...XXXXXXX...XXXXX-----XXXXX,,,,,,,X---------XX....A....X----------X...X---X,,,X----------------------
----------------------X...,.,,.,....X---------X...,.......X--------X............X---------X...X---X...X----------------------
----------------------X....,.E,.....X---------X.XXX,,,,,,,X-------X...XXX,,,XX...X--------X...X---XH..X----------------------
----------------------X....,..,....EX---------X.X-X.......X-------X..X--X,,,X-X..X--------X...X---X,,,X----------------------
----------------------XXXXXXXXXXXXXXX---------X.X-X.......X-----XXX...XX,,,,,XX...X-------X...X---X,,,X----------------------
----------------------------XX---------+++----X.X-XH......X-----X.,...,,,,,,,,,...X-------X...X---X...X----------------------
----------------------------------XXXXXX,XXXXXX,X-X.......X-----X.,E:E,,,,W,,,,.H.XXXXXXXXX,,,XXXXX,,,XXXXXXXXX--------------
---------------------------------X........A.....X-XE......X-----X.,...,,,,,,,,,...,.E..E.:,E..,:..,..,........X--------------
--------------------------------X..H............X-X,,,,,,,X-----XXX...XX,,,,,XX...,.......,...,...,..,..E.....X--------------
--------------------------------XE....,,,,,.....X-X.......X-------X..X--X,,,X-X...,.......,...,...,..,........X--------------
-----------------------------XXXX....,.....,....X-X,,,,,,,X-------X...XXX,,,XX...,........,...,...,..,........XXXX-----------
--------------------------XXX..,,...,.,,,,,.,...X-X.......X-------X............XX,........,...,...,..,........,.EX-----------
------------------------XX.....,,.:.,.,AWA,.,...X-X.......X--------X......H..E.XX.........,...,...,..,........,..X-----------
----------------------XX......E,,...,.,,,,,.,...X-X.......X---------XX.........,..........,...,...,,,,........,.EX-----------
--------------------XX....E...XXX....,.....,....XXX,,,,,,,X-----------XXXXX,,,,...........,...,...,,,,........,.EXXXXXXXX----
-------------------X.......XXX--XE....,,,,,.....XXX,,,,,,,X---------------X...............,...,...............,..XXH.Ht.X----
-----------------XXX...E..X-----X............E..X-X.......X---------------X...............,...,...............,.EXX...ttX----
--------------XXX...,...XX-------X.AHA.........X--X...E...X---------------X...............,...,...............,.EXX....AX----
--------------X....E.XXX----------XXXXXX,XXXXXX---X.......X---------------XE..............,...,...............XXXXXXX,XXX----
-------------XH.E..,,X-----------------XXX--------X.......X---------------X...............,...,A..............X-----X.X------
-------------X...,,,,XXXXXXXXX--------------------X.......X---------------X...........XXX.,...,...............X-----X.X------
-------------XE,,,,,..E.AE....XX------------------X.......X---------------X..........AX-XH,..E,:..............X-----X.X------
--------------X,,,.E..,,,,,,E...X-----------------X.......X-------------XXX...........XXX.,...,,,,,,,,,,,,,,,,XXXXXXX+XX-----
--------------XX..H.,,.,,...,,H.X-----------------X.......X-----------XX...,..............,..................,,.........X----
XXXXX---XXXXX-X.E.,,...,,.....,.EXXXXXXXX--XXXXXXXX,,,,,,,XXXXXXXXX--X......,.............,..................,,..........X---
XEt.X---X,H,XXX..,.....,,......,..+....HX-XX,....E,.......,E..,,..X--X......,.............,..................,,...........X--
X.t.X---X,<,XXX.,......,A.......,.+....,XXX..,,,,.,.......,....,,.XXX.......,.............,..................,,............X-
XEt.X--XX,,,++,.,......,,.......,.+.,,,.++,,...,,,,.......,....,,.++,.......,.............,..................,,............X-
X.t.X--X,<.<++,:,,,,,,AXXA,,,,,,,E,,.W..++,,.....,,...A...,.....,.++,...:...,.W.....T.....,..................,,............X-
XEt.X--XX,,,++,.,,,,,,,XX,,,,,,,,.+,,,..++,,,.....,.......,,,...,.++,.......,.............,..................,,............X-
X.t.X---X,<,XXX.,......,A.......,.+.,,,,XXX.,,....,.......,.,,...,XXX.......,.........XXX.,.......,,,,,,,,,,,,XXXXXXXX.....X-
XEt.X---X,,,XXX..,.....,,......,..+....HX-X.,,...E,.......,E..,,.XX-X.......,........AX-X.,.......,:..........X-------X....X-
XXXXX---X,,,XXX.E,.....,,......,E.XXX,XXX-XXXXXXXXX,,,,,,,XXXXXXXX---X......,.........XXX.,.......,..........EX--------X...X-
--------XA.AX-XX..,,,..,,....,,..X--XXX-----------XE.....EX-----------XX...,..............,.......,...........X--------X...X-
--------XXXXX-X,,,H..,,,,,,,,.H.X-----------------X.......X-------------XXX...............,.......,..........AX--------X...X-
--------------X,,,,E..E.AE..E.XX------------------X.......X---------------X...............,.......,...........X--------X...X-
-------------XE..,,,,XXXXXXXXX--------------------X.......X---------------X...............,.......,..........EX--------X...X-
-------------XH....,,X----------------------------X..E.E..X---------------X...............,.......,...........X--------X...X-
--------------X.E..E.X----------------------------X.......X---------------XE..............,,,,,,,,,.........,,X--------X,,,X-
--------------XXX...X-----------------------------X.......X---------------X...............,.......,........,..X--------XE.EX-
-----------------XXX------------------------------XXX,,,XXX---------------X...............,.......,.......,...X--------X,,,X-
----------------------------------------------------X+++X-----------------X...............,.......,.......,...X--------X...X-
----------------------------------------------------X,,,X---------------XXX,,,............,,,,,,,,,.......,...X---XXXXXX,,,XX
----------------------------------------------------X,,,X-------------XX......,...........,.......,.......,..HX--XX..XX.....X
----------------------------------------------------X..,X-----------XX....E..E.XX.........,.......,.......,...XXX.,,,.,.....X
----------------------------------------------------X,,.X----------X...........XX.........,.......,.......,...++,.,,,.,..E..X
----------------------------------------------------X.,,.X--------X.......H......,........,.......,.......,...++,.,,,.,.....X
-----------------------------------------------------X.,,.XX------X..............,........,.......,.A.....,...++,.,,,..,....X
------------------------------------------------------X..,.,XXXXXXX...............,..E....,.......,.......,...XXX.,,,...,,,XX
-------------------------------------------------------X.,,.,,...,,...............,......:,......H,:......,..HX-X,........EXX
--------------------------------------------------------X.,.,,...,,...H...T...H...XXXXXXXXX,,,,,,,XXXXX,XXXX,,X-X.,.........X
---------------------------------------------------------XX,.,...,,...............X-------X.......X---XHX--XXXX-X.,.........X
-----------------------------------------------------------XXXXXXXX...............X-------X.......X---X.X-------XXX.........X
------------------------------------------------------------------X...............X-------X.......X---X.XXXXXXXXXXX.........X
------------------------------------------------------------------X..............X--------X.......X---X.......E,,XX.....XX,,X
------------------------------------------------------------------X.......H...E..X--------XXXXXXXXX---XXXXXXXXXX,.+.....XX,,X
-------------------------------------------------------------------X............X---------------XXXXXXXXXXXXXXXXX++.....XX,,X
--------------------------------------------------------------------XX.........X----------------XE,H.A.E,AE.E.E.........XX,,X
----------------------------------------------------------------------XXX,,,XXX-----------------X.,.....,...,,,,,,,....,XX,,X
------------------------------------------------------------------------X+++X-------------------XX+.....,...,,,,,,,...,.....X
------------------------------------------------------------------------X,,,X-------------------X.+....XX...,..E.,,..,.E....X
------------------------------------------------------------------------X...X-------------------XE,H...,XX..,....,,..XX....EX
------------------------------------------------------------------------X.A.X-------------------XXXXXXX.AXX.,,,,,,,..XX..H..X
------------------------------------------------------------------------X...X-------------------------X...XX........AXXE...EX
------------------------------------------------------------------XXXXXXX,,,XXXXXXX--------------------X..AXX,,,,,XXXXXX,,XXX
------------------------------------------------------------------XE,...+...+...,EX---------------------X..,...E..X----X..X--
------------------------------------------------------------------X,,.A.,+.+,.A.,.X----------------------XX.......X----X..X--
------------------------------------------------------------------XE,...,+.+,...,EX-----------------------X.......XXXXXX..X--
------------------------------------------------------------------XXXXXXX,,,XXXXXXX-----------------------X.......,.......X--
------------------------------------------------------------------------X...X-----------------------------X.......,......AX--
------------------------------------------------------------------------X.A.X----------------XXX----------X.......XXXXXXXXX--
------------------------------------------------------------------------X...X---------------X...X---------XE.E.E.EX----------
------------------------------------------------------------------------X,,,X--------------X.,H..X--------XX,,,,,XX----------
------------------------------------------------------------------------XE.EX--------------XH>>,HX---------X,,,,,X-----------
------------------------------------------------------------------------XXXXX--------------X.....X---------X.....X-----------
-------------------------------------------------------------------------------------------X.....X---------X.....X-----------
-------------------------------------------------------------------------------------------X.....X---------X,,,,,X-----------
-------------------------------------------------------------------------------------------X.....X---------X.....X-----------
---------------------------------------------------------------------------------------XXXXX......X-------X......XXXXX-------
---------------------------------------------------------------------------------------XE,.,.......XX----X.......,.,EX-------
---------------------------------------------------------------------------------------X.,.,.........XXXX........,.,.X-------
---------------------------------------------------------------------------------------X.,..,...................,.,..X-------
----------------------------------------------------------------------------------------XE,.,...................,.,EX--------
----------------------------------------------------------------------------------------X.,..,.................,.,..X--------
-----------------------------------------------------------------------------------------X,...,...............,..,.X---------
-----------------------------------------------------------------------------------------X.,...,,,..........,,..,..X---------
------------------------------------------------------------------------------------------XE,.....,,,,,,,,,,...,E.X----------
-------------------------------------------------------------------------------------------X.,,,.............,,..X-----------
--------------------------------------------------------------------------------------------XX.E,,,,,,,,,,,,,E.XX------------
----------------------------------------------------------------------------------------------XX...E..E..E...XX--------------
------------------------------------------------------------------------------------------------XXXXXXXXXXXXX----------------
