-------------XXXXXXXXXXXXXXXXXXXXXXXXX-----------
-----------XX..................E......X----------
----------X.......E....................X---------
----------X..............E.............X---------
---------X....XXXXXXXXXXXXXXXXXXXXXX....X--------
---------X...X---------------------X....X--------
---------X...X----------------------X...X--------
---------X...X----------------------X...X--------
----XXXXX.....XXXX--XXXXXXXXXXXXX---X.E.X--------
----X............,XXX....E,..E.AX---X...X--------
----XWH.........E,++,.,,,,,,,,,,X---X,,,X--------
----X............XXXXE,E..,.....XXXXX...X--------
-----XXXX.....XXXX--X,,,,,,.....,E..,.:.X--------
---------X...X------XE,.........XXXXX...X--------
XXXXXXXXXX,,,XX-----X.,.........XXXXX,,,XXXX-----
X.......,.....X-----XH,.........XX.........X-----
X.......,....EXXX---XXX+++++++XXXX.........X-----
X.......,.....,.X-----X+++++++X--X.........X-----
X<......,.....,.X-XXXXX,,,,,,,XXXX..E,,,E..X-----
X.,,,,,.,...E.,.X-X.............XX..,...,..X-----
X<,,,,,.,.....,.X-X.............XX..,...,..X--XX-
X.,,,.,.,.....,.X-X.............XX..,...,..XXX..X
X<,,,H,.,.....,.X-X,,,,,,,,,,..,XX..,.E.,..,L,E.>
X.,,,.,.,E....,.X-X.........,..,.,..,...,..XXX..X
X<,,,,,.,.....,.X-X.....,,,.,..,.,..,...,..X--XX-
X.,,,,,.,.....,.X-X.....,K,.,..,.,..,...,..X-----
X:......,.....,.X-X.....,,,.,...XX..,,,,,..X-----
X.......,.....,.X-X.........,...XX.......E.X-----
X.......,....EXXX-X.........,...XX.........X-----
X.......,.....X---X.........,...XX.........X-----
XXXXXXXXXXXXXXX---X.........,...XXXXX,,,XXXX-----
-----------XXX----X.........,...X---X...X--------
-------HXXXX.XXXHXX.........,...X:XXX,,,XX:X-----
-------X....:....XX.........,...XX,,,,,,,,,X-----
-------X......E.,XX.........,...XX,,,,,,,E,X-----
-------X........,.,.........,...XX,,,,,,,,,XXX---
-------X........,.,......W..,...XX,,,,,,,,,,EX---
-------X........,.,.........,...X,,,,,H,,,,,A:---
-------X..E,,,,..XX.........,...XX,E,,,,,,,,EX---
-------X..,...,..XX.........,...XX,,,,,,,,,XXX---
-------X..,...,..XX.........,...XX,,,,,,,,,X-----
-------X..,...,..XX:...,,,,.,...X:,,,,,,,,:X-----
-------X..,...,.EXXXXXXX...XXXXXXXXXX...XXXX-----
-------X..,...,..XXXXXXX,,,XXXXXX---X...X--------
-------X..,.E.,..XX.............X---X...X--------
-------X..,...,..XX.............X--X....X--------
-------X..,,,,,..XX...E,,,,,,.E,XXX.....X--------
-------X.........,,...,.....,..,........X--------
-------X.........,,...,.....,..,..E....X---------
-------X.........,,...,.....,..,......X----------
-------X.........XX...,,E,,,,...XXXXXX-----------
-------X.........XX.............X----------------
-------X....E....XX.E...........X----------------
-------XXXXXXXXXXXXXXXXXXXXXXXXXX----------------
