-------------------------------------------------------------------------------------------:XXXXXXXXXXXX-------------------------------------------------------------------------------
-------------------------------------------------------------------------------------------X...E....E..X-------------------------------------------------------------------------------
-------------------------------------------------------------------------------------------X.,,,,,,,,,.X-------------------------------------------------------------------------------
-------------------------------------------------------------------------------------------X.,......E,.X-------------------------------------------------------------------------------
-------------------------------------------------------------------------------------------XH,...:...,.X-------------------------------------------------------------------------------
-------------------------------------------------------------------------------------------X.,.......,EX-------------------------------------------------------------------------------
-------------------------------------------------------------------------------------------XE,.......,.X-------------------------------------------------------------------------------
-------------------------------------------------------------------------------------------X.,......E,.X-------------------------------------------------------------------------------
-------------------------------------------------------------------------------------------X.,.......,:XXXXXXXXXXX---------------------------------------------------------------------
-------------------------------------------------------------------------------------------X:,.......,.....E..:.EX---------------------------------------------------------------------
-------------------------------------------------------------------------------------------X.,.......,,,,,,,,,,,.X---------------------------------------------------------------------
-------------------------------------------------------------------------------------------X.,............E.E.E,.X---------------------------------------------------------------------
-----------------------------------------------------------------------:XXXXXXXXXXXXXX:X---XE,.................,:XXXXXXXXXXX:X---------------------------------------------------------
-----------------------------------------------------------------------X...:..E...E.H..X---X.,.............:...,....E...E....X---------------------------------------------------------
-----------------------------------------------------------------------X.,,,,,,,,,,,,,.X---X.,.................,,,,,,,,,,,,,.X---------------------------------------------------------
-----------------------------------------------------------------------X.,......:....,.X---X:,H............................,.X---------------------------------------------------------
-----------------------------------------------------------------------X.,.:.........,.XXXX:.,.............................,EX---------------------------------------------------------
-----------------------------------------------------------------------X.,...........,E..H...,.........,,,,,,,,,,,,,,,,,...,.X---------------------------------------------------------
-----------------------------------------------------------------------XE,...........,,,,,,,,,.........,A...........:.,,...,:X---------------------------------------------------------
-----------------------------------------------------------------------X.,....................,,,,.....,E..E..E.H....E,,...,.X-------------------------------------XXX-----------------
-----------------------------------------------------------------------X:,..................,,....,,...,,,,,,,,,,,A,..,H...,EX-----------------------------------XX.H.X----------------
-----------------------------------------------------------------------X.,..................,.....H,...,,,,,,,,,,,,,..,,...,.X-----------------------------------XH..EH----------------
-----------------------------------------------------------------------X.,...,,,,,,,,,,,,..,........,..............,.E,,...,.X-----------------------------------X.E..X----------------
-----------------------------------------------------------------------XE,...,..........,..,.......W,..............,..,,.:.,EX-----------------------------XXXXXXXtttXX----------------
-----------------------------------------------------------------------X.,...,....H.A.AH,..,...E....,..............,..,,...,.X-------------------------XXXXA.,.:.......XX--------------
-----------------------------------------------------------------------X:,...,:.,,,,,,,,,...,....:.,.......:.......,..,,...,:X----------------------XXX.,.....,...E.E.,..XX------------
-----------------------------------------------------------------------X.,...,..,,,,,,,,,...,,....,,.,,,,,,,,,,,...,.:AH...,.X-------------------XXX..A.,...E.,.......,....XX----------
-----------------------------------------------------------------------X.,...,..,,............,,,,...,:......:.,...,..A,...,EX-----------------XX...,...,.....,.....A,.......XX--------
-----------------------------------------------------------------------XH,...,..,,...................,.XXXXXXX.,...,H.A,...,.X--------------XXX...E.,...,..:.,...E.,,..........XX------
-----------------------------------------------------------------------X.,...,..,,...................,.X-----XE,...,,,,,...,.X------------XX..,.E...,..,,,A..,,,,,,............,:XX----
-----------------------------------------------------------:XXXXXXXXXXX:.,...,.E,,...,,,,,,,,,,,,,,,,,.X-----X.,........H..,.X---------XXX:AE.,...:.,,,...,,,..................,..EXX--
-----------------------------------------------------------X....E...E....,...,..,,...,:.....:.......:..X-----XE,E.........E,:X-------XX..,....H,,,,,,..................,,,.....,.A.HX--
-----------------------------------------------------------X.,,,,,,,,,,,,,,,,,.E,,...,.XXXXXXXXXXXXXXXXX-----XXXXXXX,,,XXXXXXX-------XE...H,K..,.....................,,...,,....W.E.X--
-----------------------------------------------------------X.,:...........,.H,..,,...,.X-------------------XXXXX---X,,,X------------:X......,,,................:.....,...:.A....,..:.X-
-----------------------------------------------------------X.,............,HW,.E,,...,.XHXXXXXXXXXXX-----XAX,,,XAAXX,,,XXXX---------XXE.............................,.......,..E.,,,,X-
-----------------------------------------------------------XE,..,,,,,,,,,,,,,,..,,..E,.XX....,..E..X---XA.................HXX--------X..............................,..E..E.,........X-
-----------------------------------------------------------X.,..,...............,,...,.XXE....,...EX-XX.....................:XX:XXXXXX,.............................,......,...E.....X-
-----------------------------------------------------------X:,..H.E.............,,...,EXX..E..,....X-XE..................E...XX..E...,,..............................,,,...,.......:.X-
-----------------------------------------------------------X.,..H...........AAAA,,...,.XX....XXX..BX-X...,,,,,,,,,,,,,,,,,...XXA.....,,.................................,,,..........X-
-----------------------------------------------------------XE,..,...,,,,,,,,,,,,,,...,.XX....X-XE..X-X...,......H........,...XX......,,......................,,,,............,,,......X
-----------------------------------------------------------X.,..H...,................,:XX....X-X...XXX...,......H......:.,.E.,,..E...,,......................,...,.........,,...,,....X
-----------------------------------------------------------X.,..,...,................,.XX....X-X.....,...,...............,...,,E....E,,.....................,..:.,.........,.....A....X
-----------------------------------------------------------X.,..,..:,.....:..........,.XX....X-X:....,...,...............,...,,..E...,,........,,,,,........,H...,........,...E...,.E.X
-----------------------------------------------------------X:,..,...,................,EXXE...X-A....E,E..,....E.E........,..EXXB.....,,.......,.....,........,,:,.........,......:,...X
-----------------------------------------------------------X.,..,...,E.E.E......E..E.,.XX..E.X-XXXXXXX...,...............,...XX....T.,,......,.......,................:...,...E...,...X
-----------------------------------------------------------XE,..,...,,,,,,,,,,,......,.XX....XXX:X---X:..,.....E...A.....,.EHXX:.:...,,......,......A,.....................,,,..A,..E.X
-----------------------------------------------------------X.,..,E...........H,....E.,.XX....+..EX---XXXXXXXXXttttXXXXXXXXXXXXXXXXXXXX,.......,..,,..,........................,,,....X-
-------------------------------XXX-------------------------X:,..,.........:.E.,E.....,EXX.....+.AX-----------X....X------------------X........,.,..,,,.:,,...........................X-
---------------------------XXXX,..XXX----------------------X.,..,E............,...E..,.XH.E.:.+.:X-----------X....X-----------------:XE.......,.,.....,,..,,.................,,,,....X-
-----------------------XXXX....,.:...XX--------------------XH,..,,,,,,,,,,,...,.E....,.XXXXXXXXXXX-----------X.E..X-----------------XX.........,......,..E.,................,....,,..X-
-------------------XXXX...:.A.,......A.XXX-----------------XE,...........H,.E.,......,.X------XXXXXXXXXHX----X....X----AXXAX---------XE.........,....,,....:,............,,,.E.....,X--
-----------------XX..:.......,.........B..XX---------------X.,...,,,,,,,,,,...,....E.,EX------XA.E:,.A...X---X...AX---X....X-----------XX........,,A,..,....,...,,,....,,..,.....:XXX--
----------------X.,A.........,..........,,.X---------------X:,...K.E.E.E......,.E....,.X------XE..,,......X--X,,,XX--X.....XHX-----------XXX.:.........,..,,,..,...,,.,..E.,..XAXX-----
----------------X:.,.........,....E...,,.A..X--------------X.,...,,,,,,,....E.,...:..,.X------X............X-XLLLXX-X......,.XXXXX----------XX........:.,,...,,...E..,.....XXX---------
---------------X....,.........,H.....,.....:X--------------:.,.:.:,,,,,:.AAH..,.E..E.,:X------X.............XX,,,,XX.......,...:.X------------XX,.......,.....,......,...HX------------
--------------XA.....,....:...,,.....,.......X-------------XXXXXXXX,,,,XXXXXXXXXXXXXXXXX------X............................,A.E.:X-------------X,,,.....,.E....,..:..,.XX--------------
-------------X........,,,...,,..,,..,.......AX--------------------X..H.X-----------------------XB..........................,.....X------------X..,XXXXXXXXXAXAXXXX,,,XX----------------
-------------X..E....,...,,,......,,........,X--------------------X:..HX-----------------------X.....:,,,,,,,,,,,,,,,,:,...,HXXXXXXXX---------X.E.X--------------X,,.X-----------------
------------X........,...E..E..E....,,:...,,.X---------------XEXXXX....X---------XXX------XXX--X.....,,.......,,,,,...,,...XXX-X--XEX--X------X....X-------------H.E.X-----------------
-----------X........,...........XX....,,,,,..HX--------------H:.E,,....X-----XXXXX,XXXHXXXX,XXXX.....,....,,,,,,,,,,,,A,.E.X---:--XHX--:------XX.EX-------------X..W.HX----------------
----------X.A......,...........X--XX.......,,.X--------------XEA.,,....X-----X:.A..........E..,,.....,..:.,,,,.....,,,.,...X--X,XXXEX-X,X-------XX--------------X.:.E.X----------------
----------X....:.,,.............XXX-X.....H,.,X--------------XXXXXX.....XX---X................,,.....,....,,........,,.,...X-H....X,XX...H-----------------------XXXAX-----------------
---------X,...,,,.................X-X......,..X-------------------X.......XXXX...............E,,.....,....,,..E.....,,.,...,X..,,,,,,,,,.HX--------------------------------------------
---------X.,,,..........H.........:X-X....,...A--------------------X.........,................,,.....,...,,..........,,,.E,,,..,,,,,,,,,.HX--------------------------------------------
---------X..,.H.......,,,,,........X-X....,....X-------------------X:........,...........E....,,.....,...,,..........,,,..,,,..,,,,,,,:,..XXX------------------------------------------
---------XA.,.........,...,........X-X....,....X--------------------XX.......,..E..XXXXXXXXXXXXX.....,...,,...H.E....,,,..,,,A.,,,,,,,,,..,AX------------------------------------------
---------X...,...X....,.E.,.........X....,...E.X----------------------XX.....,.....XXXXXHXX----XA....,...,,..........,,,..,,,............HXXX------------------------------------------
---------X...,.XXX....,...,..............,.....X------------------------XX,XXX.E...,+,.....X---X.....,,,,,,..........,,,..,,,..,,,,,,,,,.HX--------------------------------------------
--------X.:..,.X--X...,,,,,...............,....X---XXXXXXXXA-----------XXXEX-X.....,+,...E..X--X.....,,,,,.,..E....:,.,,...,X..,,,,,,,,,.HX--------------------------------------------
--------X....,X---X.......................,....:X-X..:..A...X----------X:XHX-X.E...,+,E....EX--X.....,,,,.,,........,,.,...X-H....X,XX...X---------------------------------------------
--------X:...,X--X........................,.:...X:........:..:-------HXX,XXXAX.....XXXXXX..:AX-X.....,,,,.,,,,.....,,,.,...X--X,XXXEX-X,X----------------------------------------------
--------X...,.XXX..........................,..,,XX.W.........A-----XX........X.....XXXXXX....X-X.....,H...,,,,,,,,,,,,A,...X--X:X-X.X-X:X----------------------------------------------
--------X:..,H.............................,,,..XX:..,,,,,,,.A----X..........X.:......W:XX...XX......:,.......,,,,,..H:,...XHX-X--XEX--X-----------------------------------------------
--------X,,,..............................,....AXX...,E,,,,,.X--XX...........XXX.......AXX...XX......,,,,,,,,,,,,,,,,,,,...,.XXXXXXXX--------------------------------------------------
--------XA..,,............................,.....X:...........XXX.<...........XX-X....E..XX...XX..................T.........,.....X-----------------------------------------------------
--------XA....,..........................,.:....XX....E..E...,L,...,,,,,,,...,.XXAXAXXH:XX...X.:...........................,A.E.:X-----------------------------------------------------
--------X.....,..........................,.....XXXtt.,,,,,,,.XXX<..,,,,,,,...,...XXXXXXXXX,,,X..............XX,,,,XX.......,....:X-----------------------------------------------------
--------X,A..,............................,...BXX,.t.,E,,,,,:X-X...,,,,,,,...,...............XA............X-X,,,,X-X......,HXXXXX-----------------------------------------------------
-------X..,,,..........,,,.............X...,...XXXtt.........H-X<..,,,,,,,...,..........E..T.X....:,......X--X,,,,X--X.....XXX---------------------------------------------------------
-------XH..............,H,............XX...,,,.XXX...:.....E.X-X.............,..............AX.E.E,,.:.A.X---X.,,.X---XH.EAX-----------------------------------------------------------
-------X...............,,,...........X--X,,...,X-:...,,,,,,,.:XX<..,,,,,,,...,...XXXXXXXXXXXXXXXXXXXXXXXX---:X,..,:X---XXXXX-----------------------------------------------------------
---XXX-X............................:X--X......X-:...,,,,,,E.XX,...,,,,,,,...,.XX----XXXXXX-----------------XX,..,XX-------------------------------------------------------------------
-:X...XX..:..........................X-XA.....AX-X...:.......XXXH.........E..XX----XX,,,...XXXXXX------------X.,,.X--------------------------------------------------------------------
-XE..E,,............................X--X.......X-:.........E.:--XX..........:X----X..,:,........,XX----------X.E..X--------------------------------------------------------------------
HH....,,..........,A,,,,,,,,,A......X-X.....E..X--X.HH.H.:..X-----X..........X---X...,,,....E...,.,X---------X.,,.X--------------------------------------------------------------------
X:E..E,,.........H,..........,.H.....XX.:.....A----XXXXXXXXX-------XXA......AX-XX...............,..X--------:X,..,:X-------------------------------------------------------------------
-XXXXXXX..........,..........,........,.......X----------------------XXX,XXXXXX........,,,.......,.,X-------XX,..,XX-------------------------------------------------------------------
-------X..........,..........,.........,,....:X------------------------X:X---X.......H,.,,,,.....,,HX-------X..,,.X--------------------------------------------------------------------
--------X.........,...E.E.E..,.........H,,,,..X------------------------XXX---X.......,,:..,,...,,XXXXX------X..E.AX--------------------------------------------------------------------
--------X.........,..........,........,,....,,X-----------------------------X........,,...,.,..,:X--------XX......X--------------------------------------------------------------------
--------X,,,>,,,..,..........,........,......X-----------------------------X,.......,,.AA..,,....XHXXXXXXX......:X---------------------------------------------------------------------
---------X:>.>:,..,...E...E..,.......,.....:.X----------------------------X,,.......,,....,,.....,....:..E.......X---------------------------------------------------------------------
---------X,,>,,,..,..........,.......,......X-----------------------------X,:........,,,,,.,.....,..E.........E.X----------------------------------------------------------------------
---------X........,...E...E..,.E....,E.....X-----------------------------X,...........,,,,,......,............XX-----------------------------------------------------------------------
---------X........,..........,......,...E.X----------------------------XX,.......................,.E......A.XX-------------------------------------------------------------------------
----------X.......,,,,,,,,,,,,.......,....X--------------------------XX,,......................,,XXXXXtttXXX---------------------------------------------------------------------------
----------X................,,,...E...,E..X-------------------------XX,,........................,:X---X.EHX-----------------------------------------------------------------------------
----------X..............,,...,.....,...A------------------------XX,,,,..:.......................XXXXX.W.X-----------------------------------------------------------------------------
-----------X.............,,...,....,....X----------------------XX,,,,,,............................:.:AAAX-----------------------------------------------------------------------------
-----------X...H....E....,,...,,,H.,...X---------------------XX,,.,,..,,.............,,.........E...,XXXXX-----------------------------------------------------------------------------
-----------X..............,H,,...,,...:----------------------X,,.,,:E.,,..........,,,,,,............X----------------------------------------------------------------------------------
------------X.......E......,...:...,.X----------------------X,,:.,,...,..........,.,,..,,..........,X----------------------------------------------------------------------------------
------------XX............H,.......,.X----------------------X.....,,,,,..........,,....,,........,XX-----------------------------------------------------------------------------------
--------------XX....E.....,........BX-----------------------X.......,,XXX.......,,...A.,,......,,X-------------------------------------------------------------------------------------
----------------XX......E.,..:..AXX------------------------X........XHHH.......,,.....H.,,...,,XX--------------------------------------------------------------------------------------
------------------XX.......,.XXX---------------------------X........XH.........,,.:.....,,...,X----------------------------------------------------------------------------------------
--------------------XX....XXX-----------------------------X........XH..........,,.....E,.,...,X----------------------------------------------------------------------------------------
----------------------XXXX--------------------------------X........XX,,,XX.....,H,A.E..,,...,X-----------------------------------------------------------------------------------------
----------------------------------------------------------X........XXEKEXX.....,.,...,,.,...,X-----------------------------------------------------------------------------------------
----------------------------------------------------------X........HX...XX......,,,,,,,,....,X-----------------------------------------------------------------------------------------
----------------------------------------------------------X........HXE.EXX........,,,.......,X-----------------------------------------------------------------------------------------
----------------------------------------------------------X........XX..:XX.................,X------------------------------------------------------------------------------------------
----------------------------------------------------------X,...E...XAE.EXX..........,......,X------------------------------------------------------------------------------------------
---------------------------------------------------------X,:.......XX,,,XX..:.....,,,......,X------------------------------------------------------------------------------------------
---------------------------------------------------------X.........,......,,....,,.A.,....E.,X-----------------------------------------------------------------------------------------
---------------------------------------------------------X...E.....,..E.,,..,,,,.....,......,X-----------------------------------------------------------------------------------------
---------------------------------------------------------X..........,.,,....,...,...,......,,,X----------------------------------------------------------------------------------------
---------------------------------------------------------X...........,...E..,...,.H,.....E.,:,X----------------------------------------------------------------------------------------
----------------------------------------------------------X...........,,...,..E,,,..........,X-----------------------------------------------------------------------------------------
-----------------------------------------------------------X..E.........,,,,,,,........E...,X------------------------------------------------------------------------------------------
------------------------------------------------------------X......:......................,.X------------------------------------------------------------------------------------------
-------------------------------------------------------------X........E..................,.X-------------------------------------------------------------------------------------------
-------------------------------------------------------------X,........................,,XX--------------------------------------------------------------------------------------------
--------------------------------------------------------------X,.,,..................,,XX----------------------------------------------------------------------------------------------
---------------------------------------------------------------X,,:...........,,...,,XX------------------------------------------------------------------------------------------------
----------------------------------------------------------------X,,,,,,,,.....,:.,,XX--------------------------------------------------------------------------------------------------
-----------------------------------------------------------------XXXXXXXX,,,,,,,,XX----------------------------------------------------------------------------------------------------
-------------------------------------------------------------------------XXXXXXXX------------------------------------------------------------------------------------------------------
