--------------------------------------------------------------------------------------------------------KX------------
------------------------------------------------------------------------------------------------------XH.EXX----------
----------------------------------------------------------------------------------------------------XXA..AH.AX--------
-----------------------------------------------------------------------------------------XXX--------XE..E...EX--------
-----------------------------------------------------------------------------------------X<X--------XA...E..AX--------
-----------------------------------------------------------------------------------------X.X--------X..E.A..EX--------
------XXXXXXXXXXXXXXXXXXXXXXXXXXXXXXXXXXXXXXXXXXXXXXXXXXXXXXXXXX------------------------XX,XX-------XE.......X--------
------X......................................................W.X-------------------XXXXXX...X-------XXA..E..AX--------
------X..................................A............:..:.....X-------------------H..HXX..AX----------XXAXX----------
------X..........XXXXXXXXXXXXXXXXXXXX.......................:..X-------------------X...XX...X-----------XEX-----------
------X.....A....XXXXXXXXXXXX-------X................A...:.....X-------------------XE.EXX...X-----------XEX-----------
------X..........XX.........X-------X..........................X-------------------XE..XX.W.X----------XXHXX----------
------X..........XX.......E.X-------X..XXX,,,,,XXX,,,,,XXXXXXXXX-------------------X..HXX...X--------XX.,,,X----------
------X..E.......XX.E..E....X-------X..XXX,,,,,XXX,,,,,XX-----------XXXXXXXXXXXXXXXX,,,XX,,,XXX----XX...,,,X----------
------X..........XX.........X-------X..XXK.,H,........A.X-----------X.....A.........+.E.......X--XX......,,X----------
------X..........XX.........X-------X..XX..,.,.,,,......XXXXXXXXXXXXX..A.........E..+.........XXX........,,X----------
------X......E...XX.........X-------X..XXH,,,,.:H,.E,,..,,.,,.,,.,,E,......E........+.........,+,.........,X----------
------X..........XX.........X-------X..XX.,....,,,.,H,.E,E.,,.,,.,,.,...............+.........,+,..........X----------
------X..........XX.........X-------XE.XX,,........,,,.E,,.,,.,,.,,.,...............+.........,+,...A......X----------
------X..........XX.........X-------X..XX...,,,.....,,,.XXXXXXXXXXXXX...............+.........XXX..........X----------
------X...E......XX.........X-------X..XX...:H,.....,H,.XXXX+++HXXXXX...............+.........X-XH.........X----------
------X..........XX.........X-------X..XX...,,,,,,..,,,.X.E......E:XX.......XX,,,,,,+,,,,,,,XXX--X.........X----------
------X..........XX.........X-------X..XX......,H,..,,,.X..........,,.......XX,A,,,,,,,,,,,,XXX--X........X-----------
------X..E.......XX.........XXXXXXXXX..XXA,,,..:,,..,H,.X..........,,.......,,,E..,.A...H.E..HX---X......X------------
------X........A.XX....................XX...,.......,,,,X.........E,,.......,,...,............X---X.....X-------------
------X.W........XX....................,,..A,.XXX....,H,X..........,,.......,..,,.............X---X....X--------------
------X........E.XX....................XX...,.XXX....,,,X.:........XX.....E.,A,...A...........X---X...X---------------
------XXXXXXXXXXXXXXXXXXXXXXXXXXXXXXX..XXE,,,.XXX.......X.........:XX.......,,...A..A...A...H.X--X...X----------------
------------------------------------X..XX.....:......,,,X.....A....XX.......,.................X--X...X----------------
------------------------------------X..XX.........A..,H,X..........,,.......,.................X--X....X---------------
------------------------------------XE.XX,,,.........,,,X..........,,.......,................EX--X....X---------------
------------------------------------X..X:,H,...,,,......X.........E,,.......,.E.....A...A...:.X--X....X---------------
------------------------------------X..XX,,,...,H,.,,,,,X..:.......,,.......X:................X-X.....X---------------
------------------------------------X..,,......,,,.,...,X..........XX.......XXXXXXXXXX+++XXXXXX-X......X--------------
------------------------------------X..,,......:...,...,X.........:XX.......XXXXXXXXXX,,,XXXXXX-X......X--------------
------------------------XXXXXXXXXXXXX.:,,...,,,....,...,X..........XX.......X:.E.E....E......:X-X......X--------------
------------------------X:..K...K..K...,,...:H,....,,,,,X..........,,.......X..W............E.X-X......X--------------
------------------------X..............,,...,,,.......E.X..........,,.......X................AX--X....X---------------
------------------------K..............XX....E......E..EX.:.......E,,.......+.................X--X....X---------------
------------------------X..............XXXXXXXXXX,,,XXXXX..........,,.......+.................X--X....X---------------
------------------------X..............X--------X+++X---X..........XX.......X.................X--X....X---------------
XXXXXXXXXXXXXXXXXXXXXXXXK..............X:XXXXXXXX,,,XXXXX.........:XX.......X.................X--X....X---------------
X..K...K..:..K...K..K..:...............X...........................XX.......X.................X--X...X----------------
X.tttE............A....................X...........................,,.......X.................X---X..X----------------
K.t.t.................................KX..........................E,,.......X.................X---X..X----------------
X.ttt..................................X...........................,,.......X...............A.X---X..X----------------
X.......E..............................X...........................,,.......,.................X---X...X---------------
XXX:XXKXXXX:XXXKXX:XXKXXKXXKX:XKX......X...........................XXE....E.,.................X---X...X---------------
--------------------------------X......X..........................:XX.......X:...............:X----X...X--------------
------XXXXXXXXXXXXXXXXXXXXXXXXX-X......X:X,X:XXXXXXXXXXXXXXXXXXXXXXXXXX,,,XXXXXXXXXXXXXXXXXXXXX----X...X--------------
------:,,,,,,,:,,,,,,:,,,,,,:,X-X......XXX+XXXXXXXXXX-------XXXXXXXXXXX,,,XXEXXXXX:X---------------X....X-------------
------X.,,,................W.,X-X......XX..........TXX------X:A...,,,XX,,,X....E...X---------------X...HX-------------
------X.,T,..................,X-X......X,.......t.t.,X------X.....,T,XX,,,X.......EX---------------X....X-------------
------X.,,,.......A.........E,X-X......X,...tt.tt.tt,X------X.....,,,XX,,,X........X--------------X....X--------------
------X......................,X-X......X,.....t.ttt.tX------X.E..E...XX,,,X........X--------------X....X--------------
------X......................,X-X......X,....t.ttttt,X------X........XX,,,X........X--------------X...X---------------
------X......................,X-X......X,...tttKt.t.,X------X......E.XX,,,X........X--------------X...X---------------
------X......................,X-XXXXXXXXX..tt....H.tXX------X........XX,,,X........X--------------X..X----------------
------X:.....................,X---------XXXXXXXXXXXXX-------X........XX,,,X...A....X-------------X...X----------------
------X.....................:,X-----XXXXXXXXXXXXXXXXXXXXXXXXX........XX,,,X........X-------------X..X-----------------
------X......................,X-----XT....H...t..........E.EX......................X-------------X,,XXXX--------------
------X......................,X-----XXXXXXXXXXXXXXXXXXXXXXXXX......................X-----------XX.......XXX-----------
------X......................,X-----------------------------X......................X---------XXA...........X----------
------X......................,X-----------------------------X......................X-------XX..............AXX--------
------X.......A..............,X-----------------------------X......................X-----XX...................X-------
------X......................,X-----------------------------X......................X----X......................X------
------X:.....................,X-----------------------------X......A..............:X---X..............,,,,,.....X-----
------X......................,X-----------------------------X:.....................X--X.............,,t,,,,,,....X----
------X......................,X-------------------------------XX.................XX---X..A.........,tt.tttttt,....XX--
------X.....................:,XXXXXXXXXXXXXXXXXXXXXXXXXXXXXXX---XX.............XX----X.............t.tt.....ttt...A.X-
------X.................A....,,,,,,,,,,,,,,,,,,,,,,,,,,,,,:,X-----XX.........XX-----X.............,tt........t.t.....X
------X........................................A...........,X-------XX.....XX-----XX.............,tt..........tt....AX
------X....................................................,X---------XX:XX-----XXH..............,tt..........t.t....X
------X....................................................,X-----------X-----XX................,tt............tt....X
------X:................................................ttt,X--------------XXX..................,,t......H.....tt.:.AX
------X........A............E.......................E...t.t,X------------XX.....................,,t............tt...X-
------X.................................................ttt,X----------XX.......................,,t........E...tt...X-
------X...E................................................,X----------X.A....XXXXXXX............,t............t,...X-
------X....................................................,X-----------X.....XXXX:XX............,.tt.........tt.T.AX-
------X....................................................,X-----------X.....X.E..XX.............,t.tt.....tt,,....X-
------X:.....:.......:.......:.............................:X-----------X.A...,...:XX..............,t..ttttt.,,..HXX--
------XXXXXXXXXXXXXXXXXXXXXXXXXXXXXXXXXXXXXXXXXXXXXXXXXXXXXXX-----------X.....X....XX...............,tt...tt,,..XX----
-------------------------------------------------------------------------X....X...:XX.................,ttt,,..XX------
-------------------------------------------------------------------------X....X....XX.......................XX--------
-------------------------------------------------------------------------X....X.E..XX.....................XX----------
-------------------------------------------------------------------------X....X...EXX..............A...HXX------------
--------------------------------------------------------------------------X...XX>>>XX................XXX--------------
--------------------------------------------------------------------------XXA.HXXXXXX........A...XXXX-----------------
----------------------------------------------------------------------------XXXA..E...........XXX---------------------
-------------------------------------------------------------------------------XX.......A..XXX------------------------
---------------------------------------------------------------------------------XXX...XXXX---------------------------
------------------------------------------------------------------------------------XXX-------------------------------
