---------------------------------------------------------------------------XXXXXX------------------------------------------------------
---------------------------------------------------------------------------X----X------------------------------------------------------
---------------------------------------------------------------------------X----XXXXXXXX-----------------------------------------------
---------------------------------------------------------------------------X----X------X-----------------------------------------------
---------------------------------------------------------------------------X,,,XX------X-----------------------------------------------
---------------------------------------------------------------------------XLLLXX--XX--X-----------------------------------------------
-----------------------------------------------------------------------XXXXX,,,XX,,XX--X-----------------------------------------------
-----------------------------------------------------------------------X-----------XX--X-----------------------------------------------
-----------------------------------------------------------------------X-,,,-------XX--X-----------------------------------------------
-----------------------------------------------------------------------X-,-,-,,--,,XX--X-----------------------------------------------
-----------------------------------------------------------------------X-,-,-,,--,,,---X---------------XXXXXXX-------------------------
-----------------------------------------------------------------------X-,-,-,,--,,,---X---------------X-,,--X-------------------------
-----------------------------------------------------------------------X-,,,-,,--,,XX--X---------------X-tt--X-------------------------
-----------------------------------------------------------------------X-----,,--,,XX--X---------------X-----X-------------------------
-----------------------------------------------------------------------X-----------XX--X---------------X-----X-------------------------
-----------------------------------------------------------------------X,,,-----,,,XX--XX--------------X-----X-------------------------
-----------------------------------------------------------------------X,-,-,,,-,,,XX--ttX-------------X,,,,,X-------------------------
-----------------------------------------------------------------------X,-,-,-,-,,,XX--t-X-------------X-----X-------------------------
--------------------------------------------------------------------XXXX,-,-,-,-,,,XX--ttX-------------X,,XX-X-------------------------
------------------------------------------------------------------XX-,-,,,,-,-,-,,,XX--XX-------------XX,,XX-X-------------------------
------------------------------------------------------------------X--,-,----,,,----XX--X--------------X,--,,-X----------XX-------------
-----------------------------------------------------------------X-,--,,-----------XX--X------------XXX,,,,XXXX--------X--X------------
-----------------------------------------------------------------X-,--,,-----------XX--X------------X---,,,---X---XXXXX,-X-------------
----------------------------------------------------------------X,--,,,,-,,--,,-,,,,---X------------X---,-,---X-XX------X--------------
----------------------------------------------------------------X-,,-----,,--,,-,-,,---X------------X---,,,---X-X-------X--------------
----------------------------------------------------------------X--,,,---,,--,,-,-,XX--X------------X-------,,XXX-------X--------------
----------------------------------------------------------------X--,,,---tt--,,-,-,XX--X------------X-------,-,-,-------X--------------
----------------------------------------------------------------X-,,-----,,--,,-,,,XX--X------------X-------,,XXX---,,,-X--------------
----------------------------------------------------------------X,--,,,,--,--,-----XX--X------------X---------X-X---,-,-X--------------
----------------------------------------------------------------X---,-,,-,,-,,-----XX--X------------X---------X-X,--,,,-X--------------
-----------------------------------------------------------------X-,--,-,,,,,,XX,,XXX--X------------X---------X-X-XXXXXX---------------
-----------------------------------------------------------------X-,--,-,-----XX--XXX--X------------XXXXX,XXXXXX-X---------------------
------------------------------------------------------------------X--,--,-----XX-------X----------------X+X----X-X---------------------
-------------------------------------------------------------------XX,--,-----XX-------X----------------X-X-----X----------------------
---------------------------------------------------------------------XXXXXXX,-XXXXXXXXXX----------------X-X----------------------------
------------------------------------------------------------------------X-X+-XX----------------XXXXXXXXXX-X----------------------------
----------------------------------------------------------------------XX-XX+X------------------X-------XX-X----------------------------
--------------------------------------------------------------------XX--,,,-XX--XXXXXXXXXXXXX--X-------XX-X----------------------------
------------------------------------------------------------------XX-------,,-X-X-----,--,,,X--X-------XX-X----------------------------
------------------------------------------------------------------X-----------X-X-----,--,-,X--X-------XX-X----------------------------
--------------XXXXXXXXX-------------------------------------------X----,,-----X-X-----,--,,,X--X--,,,--,,-XXXXXXXXXXXXXXXXXXXXX--------
-------------X---------X------------------------------------------X----,-,---,XXX-----,-----X--X--,-,--,,------------+---,-,,,-X-------
------------X-----------X---------XXXXXXXXX-----------------------X,--,--,---,,+,-----,-----X--X--,,,--,,---XXXXXXXXXXXXXXXXXXX-X------
------------X-----------X--------X----,---X-----------------------X,--,--,---,XXX-----,-----X--X-------XX---X------,,,X-------X,X------
------------X-----------X------XX-----,---X-----------------------X----,,----,X-X-----,-----X--X-------XX---+------,-,X--------X,X-----
------------X-----------X-----X---XXXXX,XXXXX---------------------X-----------X-X-----,---,-X--X-------XX---+---,,,,,,X--------X,X-----
------------X----,,,----X----X--XXX-,XX,XX--X---------------------XX----------X-X-----,---,-X--X-------XX---+---,----,X--------X,X-----
------------X----,-,----X--XX-XX--X-,,,,,,--X-----------------------XX------XX--XXXXXXXXXXXXX--XX,XXXXXXX---X---,----,X-----XXXX,XXXX--
------------X----,,,----X-X,XX----X---------X-------------------------XX--XX--------------XX----X,X-----X---XXXXXXXXXXX--XXXX-------X--
------------X-----------X-X,X---XXX---------X---------------------------XX----------------XX----X,X-----X---X-X---XXXXXXXX-XX-------X--
------------X-----------XXX,XXXXXXX---,,,---X---------------------------------------------XX----X-X-----X---X-X---XXXXXXXX-XX-------X--
------------X-----------X--------XX---,-,---X---------------------------------------------XX----X,X-----X---XXXXX,XXXXX--X-XX----,,,X--
------------X-----------X--------XX---,,,---X---------------------------------------------XX----X,X-----X---X--XX,XX--X--X-,,----,-,X--
-------------X---------XX---,,,--XX---------X---------------------------------------------XX----X-X-----X---X---------X--X-XX----,,,X--
--------------XXX,,,XXX-X---,-,--XX---------X---------------------------------------------XXXXXXX,X-----X---X---------X--XXXX-------X--
-XXXXXXXXXXXXXXXX,,,XXXXX---,,,--XX---------X---------------------------------------------X-,,,,,-X-----X---X---------XXXXXXX,,-----X--
-X-,,,------------------X--------XX---------X---------------------------------------------XXXXXXXXX-----X---X---------X-----,-,-----X--
-X-,-,------------------X--------XXXXXXXX+XXX------------------------------------XXXXXXXXXXXXXXXXXXXXXXXX,,,X---,,,---X-XXXXX,,,,,--X--
-X-,,,------------------,--------X------X-X--------------------------------------X--------------,------,,---X---,-,---X-X---X--,,,--X--
-X----------------------,------,,X------X-X--------------------------------------X------------,,,------XX---X---,,,---X-X---XXXX,XXXX--
-X----------------------,------,,X------X-X--------------------------------------X------------,t,-,,,--,,---,---------X-X---XXXX,XXXX--
-X----------------------XXXXXXXXXX------X-X--------------------------------------X------------,,,-,-,--,,---,---------X-X---X-------X--
-X----------------------XXXXXXXXXXXXXXXXX-X--------------------------------------X-------------,,-,,,--,,---,---------X-X---X-------X--
-X----------------------+-----------------X--------------------------------------X-------------,,------XX---X---------X-X--X---------X-
-X----------------------XXXXXXXXXXXXXXXXXXX--------------------------------------X--------------,------,,---X---------X-X--X---------X-
-X----------------------,---X----------------------------------------------------X--------------,,,,,,,,,---XXXXXXXXXXX-X--X---,,,---X-
-X-----------------++---,---X----------------------------------------------------X----------------------,---X---------X-X--X---,-,---X-
-X------,,,,,,,,,,,,,,,,,---X----------------------------------------------------X------,,,,,,,,,,,,,,,,,---X---------X-X-X----,,,----X
-X------,,-,,,,,,,,-,,t,,---X----------------------------------------------------X------,,-,,,,,,,,-,t,,,---X---------X-X-X-----------X
-X------,-,,,,,,,,,-,,t,,---X----------------------------------------------------X------,-,,,,,,,,,-,t,,,---X---------X-X--X---------X-
-X-------,,,,,-,,,,,,,,,,---X----------------------------------------------------X-------,,,,,-,,,,,,t,,,---XXXXXXXXXXX-X---XX------X--
-X-------,,-,,,,,,,,,,--,---X-XXX------------------------------------------------X-------,,-,,,,,,,,,,--,---X---------X-X-----X---XX---
-X-------,,-,,,,,,,---,,,---X-X-X------------------------------------------------X-------,,-,,,,,,,---,,,---X---------X-X------X-X-----
-X-------,-,,,,---,,,,--,---X-X-X------------------------------------------------X-------,-,,,,---,,,,--,---X---------X-X-------X------
-X--------,,,,,,,,------XXXXXXX,XXXXXX-------------------------------------------X--------,,,,,,,,------,---X---------X-X--------------
-X--------,,,-----------X----XX,XX---X-------------------------------------------X--------,,,---,,,,,,,,,---X---,,,---X-XXXXXXXXXX-----
-X----------------------X----,,,,,---X-------------------------------------------X--------------,------,,---X---,-,---X-XX-------X-----
-X----------------------X------------X-------------------------------------------X--------------,------XX---X---,,,---X-XX-------X-----
-X----------------------,------------X-------------------------------------------X--------------,------,,---,---------X-+,-------XXXX--
-X,---------------------,------------X-------------------------------------------X,-------------,------,,---,---------X-+,-------+t,X--
-X-,--------------------,------------X-------------------------------------------X-,------------,-,,,--,,---,---------X-XX-------XXXX--
-X--,-------------------X------------X-------------------------------------------X-,,-----------,-,-,--XX---X---------X-XX-------X-----
-X---,------------------X------------X------------------------------------------X---,,----------,-,,,--X,---X---------X-XX-------X-----
X---XXXXXXXXXXXXX,,,XXXXXXXXXXXXXXXXXX------------------------------------------X--XXXXXXXXXXXXXX-----,XX+++X--------tX-XXXXXXXXXX-----
X-XX--------XXXXX,,,XXXXXXXX----------------------------------------------------XXX------------X,-----tXX,,,XXXXXXXXXXX-X--------------
XX----------X--------------X------------------------------------------------------XXXXXXXXXXXXXX,-----tX------------X-X-X--------------
------------X,-------------X------------------------------------------------------X-----------XXX-,,,-tX------------XXX-X--------------
------------X,-------------X------------------------------------------------------X-ttttttttt-X-X-,-,--X------------XXXXX--------------
--------XXXXX,-------------X------------------------------------------------------X-t-------t-X-X-,,,-,X-----------,X------------------
--------X--,,,-------------X------------------------------------------------------X-t-------t-X-X-----tX-----,,,---,XXXX---------------
--------X--,,,-------------X------------------------------------------------------X-t--,,,--t-X-X-----tX-----,-,---,,--X---------------
--------X+XXX,-------------X------------------------------------------------------X-t--,-,--t-X-X-----tX-----,,,---,XX-X---------------
--------X-X-X,---------XX+XX------------------------------------------------------X-t--,,,--t-X-X------X-----------,XX-X---------------
--------X-X-X----------XX-X-------------------------------------------------------X-t-------t-X-XXX,XXXX-----------,XXXX---------------
--------X-X-X----------XX,X-------------------------------------------------------X-t-------t-X---X,XX-X------------X------------------
--------X-X-XXXXX,,XXXXXX,XXXXX---------------------------------------------------X-ttttttttt-X---X--X-X------------X------------------
--------X-X----X----X---X,,,,,X---------------------------------------------------X-----------X---X--X-X------------X------------------
--------X-XXXXXX----X---XXXXX,X---------------------------------------------------XXXXXXXXXXXXX---X--X-XXXXXXXXXXXXXX------------------
--------X-----------X-------X,X--------------------------------------------------------------XXXXXX,,XXXXXX----------------------------
--------X-----------X-------X,XXXXX----------------------------------------------------------X,,-------,,,X----------------------------
--------XXXXXXXXXXXXX-------X,,,t-X----------------------------------------------------------X-t-------t-,X----------------------------
----------------------------XXXXXXX----------------------------------------------------------X,,-------t,,X----------------------------
---------------------------------------------------------------------------------------------XXXXXXXXXXXXXX----------------------------
