------------X---------------------------------------------------------------------------------------------------------
-----------X,XX-------------------------------------------------------------------------------------------------------
----------X.,..X------------------------XXXXXXXXXXXXXXXXXXXXXXXXXXXXXXXXXXXXXXXXXXXXXXXXXXXXXXXXXXXXXXXXXXXXXXXXXX----
---------X..,...X-----------------------X...............A...................,,,,,................,..............WX----
--------X...,....XX------XXXXXXXXXXXXXXXX....:..............................,,,,,................,...............X----
-------X....,......X-----X............E+,...................E.....E.....E...,...,................,...............X----
------X.....,.......X----X.XXXXXXXXXXXXXX...................................,,,,,................,...............X----
-----X......,........XX--X.X------------X......B............................,,,,A................,...............X----
----X.......,..........X-X.X------------XXXXXXXXXXXXXXXXXXXXXXXXXXXXXXXXX,XXXXXXXXXXXXXXXXXXXXXXXX...............X----
----X.......,...........XX.X--------------------------------------------X.X----------------------X...............X----
----X.......,...........XXLX--------------------------------------------X.X----------------------X...............X----
---X........,...........XXLX-------XXXXXXXXXXXXXXXXX-XXXXXXXXXXXXXXXXXXXX,XXXX-------------------X...............X----
---X........,...........XXEX-------XH.....E.....A.AX-X...............E.......X-------------------X...............X----
---X.E......,...........XX.X-------X.:.E...........X-X.XXX.XXXXX.XXXXX.XXXXX.X-------------------X...............X----
---X........,...........,,.X-------XH....E.........X-X.X-X.X---X.X---X.X---X.X-------------------X...............X----
--X.........,...........XX.X-------XXXXXXXXXXXXXXX,X-X.X-X.X---X.X---X.X---X.X-------------------X...............X----
--X.........,...........XX.X---------------------X.X-X.X-X.X---X.X---X.X---X.X-------------------X...............X----
--X.........,...........XX.X---------------XXXXXXX,X-XEX-X.X---X.X---X.X---X.X-------------------X,,,,,,,,,,,,,,,X----
--X.........,...........XX.X---------------X.......X-X.X-X.X---X.X---X.X---X.X-------------------X...,...,.......X----
-X.E........,...........XX.X---------------XEXXXXXXX-X.X-X.X---X.X---X.X---X.X-------------------X,,,,,,,,,,,,,,,X----
-X..........,...........,,.X---------------X.X-------X.X-X.X---X.X---X.X---X.X-------------------X.E.,...,.E...E.X----
-X..........,...........XX.X---------------X.XXXXXXXXX.X-X.X---XEX---XEX---X.X-------------------X,,,,,,,,,,,,,,,X----
-X..........,...........XX.X---------------X......E....X-XEX---X.X---X.X---XEX-------------------X...,...,.......X----
X...........,...........XX.X---------------XXXXXXXXXXX.X-X.X---X.X---X.X---X.X-------------------X...,,,,,.......X----
X.E.........,...........XX.X-------------------------X:X-X.X---X.X---X.X---X.X-------------------X...,...,.......X----
X...........,...........XX.X-------------------------X.X-X.X---X.X---X.X---X.X-------------------X,,,,,,,,,,,,,,,X----
-X..........,...........,,.X-------------------------X.X-X.X---X.X---X.X---X.X-------------------X...,...,.......X----
-X..........,...........XX.X---------------XXXXXXXXXXX.X-X.X---XEX---XEX---X.X-------------------X...,,,,,.......X----
-X..........,...........XX.X---------------X...........X-XHX---X.X---X.X---X.X-------------------X...,...,.......X----
-X.E........,...........XX.X-------XXXXXXX-X.XXXXXXXXX.X-X.X---X.X---X.X---X.X-------------------X,,,,,,,,,,,,,,,X----
--X.........,...........XX.X-------X..E..X-XEX-------X.X-X.X---X.X---X.X---X.X-------------------X...,...,.......X----
--X.........,...........XX.X-------X.XXX.X-X.X-------X.X-X.X---X.X---X.X---X.X-------------------X...,,,,,.......X----
--X.........,...........,,.X-------X.X-X.X-X.X-------X.X-X.X---XEX---XEX---X.X-------------------X...,...,.......X----
--X.........,...........XX.XXXXX---X.X-X.X-X.X-------X.X-X.X---X.X---X.X---X.X-------------------X,,,,,,,,,,,,,,,X----
---X........,...........XX....EX---X.X-X.X-X.X-------X.X-X.X---X.X---X.X---X.X-------------------X...,...,.......X----
---X.E......,...........XXXXXX.X---X.X-X.X-X.X-------X.X-X.X---X.X---X.X---X.X-------------------X...,,,,,.......X----
---X........,...........X----X.X---X.X-X:X-X.X-------X.X-XEX---X.X---X.X---X.X-------------------X...,...,.......X----
---X........,...........XXXX-X.XXXXX.X-X.X-X.X-XXXXXXX.X-X.X---X.XXXXX.X---X.X-------------------X,,,,,,,,,,,,,,,X----
----X.......,.........XX-XHX-X.......X-X.X-X.X-X..E....X-X.X---XE..W..EX---X.X-------------------X...,...,.......X----
----X.......,.......XX---X.X-XXXXXXXXX-X.X-X.X-X.XXXXXXX-X.X---XXXXXXXXX---X.X-------------------X...,,,,,......BX----
-----XX.....,......X-----XAX-----------X.X-X.X-X.X-------X.X---------------X.X-------------------X...,...,.......X----
-------XX...,....XX------XEX---XXXXXXXXX.X-X.X-X.XXXXXXXXX.XXXXXXXXXXXXXXXXX.XXXXX---------------X,,,,,,,,,,,,,,,X----
---------X..,..XX--------X.X---X......E..X-X.X-X........E........................X---------------X...,...,.......X----
----------XX,XX----------X.X---X.XXXXXXXXX-X.X-XXXXXXXXXXXXXXXXXXXXXXXXXXXXXXXXX.X---------------X...,,,,,.......X----
------------X------------X.X---X.X---------X.X---------------------------------X.X---------------X...,...,.......X----
-------------------------X.X---X.X-----XXXXX.XXXXXXXXXXXXXXXXXXXXXXXXXXXXXXXXXXX.X---------------X,,,,,,,,,,,,,,,X----
-------------------------X.X---X.X-----X..........E.E.E.E.....:.......E.E.E.E.E..X---------------X...,...,.......X----
-------------------------X.X---X.X-----X.XXX.XXXXXXXXXXXXXXXXX.XXXXXXXXXXXXXXXXXXX---------------X...,,,,,.......X----
-------------------------X.X---X.X-----XEX-X.X---------------X.X---------------------------------X...,...,.......X----
-------------------------X.X---X.X-----X.X-X.X---------------X.X---------------------------------X,,,,,,,,,,,,,,,X----
-------------------------X.X---X.X-----X.X-X.X---------------X.X---------------------------------X...,...,.......X----
-------------------------X.X---X.X-----X.X-X.X-------------XXX.XXX-------------------------------X...,,,,,.......X----
-------------------------X.X---X.X-----X.X-X.X-------------XE,.,EX-------------------------------X...,...,.......X----
-------------------------X.XXXXX.X-----X.X-X.X-------------XXX.XXX-------------------------------X,,,,,,,,,,,,,,,X----
-------------------------X.......X-----X.X-X.X---------------X.X---------------------------------X...,...,.......X----
-------------------------X.XXXXX.X-----X.X-X.X---------------X.X---------------------------------X...,,,,,.......X----
-------------------------X.X---X.X-----X.X-X.X---------------X.X---------------------------------X...,...,.......X----
-------------------------X.X---X.X-----X.X-X.X-------------XXX.XXX-------------------------------X,,,,,,,,,,,,,,,X----
-------------------------X.X---X.X-----X.X-X.X-------------XE,.,EX-------------------------------X...,...,.......X----
-------------------------X.X---X.XXXXXXX.X-X.X-------------XXX.XXX-------------------------------X...,,,,,.......X----
-------------------------X.X---X....E....X-X.X---------------X.X---------------------------------X...,...,.......X----
-------------------------X.X---XXXXXXXXXXX-X.X---------------X.X---------------------------------X,,,,,,,,,,,,,,,X----
-------------------------X.X---------------X.X---------------X.X---------------------------------X...............X----
-------------------------X.XXXXXXXXXXXXXXXXX.X----XXXXXXXXXXXX.XXX-XXXXXXXXXXXXXXXXX-------------X...............X----
-------------------------X...................X---X.A..H..H,,E,.,EX-XH..B..........HX-------------X...............X----
-------------------------X.XXXXXXXXXXXXXXXXX.X---X..XXXXXXXXXX.XXX-X......W........X-------------X...............X----
-------------------------X.X---------------X.X--XH.X---------X.X---X.E.......E.....X-------------X...............X----
-------------------------X.XXXXXXXXXXXXXXX-X.X-X...X---------X.X---X.,,,.......,,,.X-------------X...............X----
-------------------------X.XXHHHXXHHH....X-X.X-X..XXXXXXXXX--X.X---X.,.,..:..B.,.,.X-------------X...............X----
-------------------------X:XXHHHXX.XXXXX.X-X.X-XHX-XW,,A.HX--X.X---X.,.,.......,.,.X-------------X...............X----
-------------------------X.,,HHHXX.X---X.X-X.X-X.X-X,XXXXXX--X.X---X.,.,.......K.,.X-------------X.......E.......X----
-------------------------X.XXXXXXX.X-XXX.X-X.X-X.X-X,XXXXX-XXX.X---X.,,,...E...,,,.X-------------X...............X----
-------------------------X.X-----X.X-XE..X-X.X-XHX-XH..<HX-XH..X---X...............X-------------X...............X----
-------------------------X.XXXXXXX.X-XXX.X-X.X-X.XXX.<...XXX...X---X...............X-------------X...............X----
-------------------------X....E..,.X---XWX-X.X-X.XX<..:..,.,..WX---XH.............HX-------------X...............X----
-------------------------X.XXXXXXX.X-XXX.X-X.X-XHXXX.....XXX...X---XXXXXXX+XXXXXXXXX-------------X...............X----
-------------------------X.X-----X.X-XE..X-X.X-X.X-XH<..HX-XH..X-XXXXXXXXX+XXXXXXXXX-------------X...............X----
-------------------------X.XXXXX-X.X-XXX.X-X.X-X.X-XXXXXXX-XXX.X-XH...........B...HX-------------X...............X----
-------------------------X.....X-X.X---X.X-X.X-XHX-----------X.X-X.................X-------------X.......:.......X----
-------------------------X.XXX.X-X.X---X.X-X.X-X..X----------X.X-X.......E.......E.X-------------X...............X----
-------------------------X.X-XHX-X.X---X.X-X.X-X...X---------X.X-XB................X-------------X...............X----
-------------------------X.XXX.X-X.XXXXX.X-X.X--XH..X--------X.X-X..E..............X-------------X...............X----
-------------------------X.....X-XHHH....X-X.X---X..X--------X.X-X............E....X-------------X...............X----
-------------------------X.XXXXX-XXXXX,XXX-X.X----XH.X-------X.X-XH...............HX-------------X...............X----
-------------------------X.X---------XAX---XEX-----X,X-------X.X-XXX,XXXXX+XXXXX,XXX-------------X...............X----
-------------------------X.XXXXXXXXXXX,XXXXX.XXXXXXX,XXXXXXXXX.XXXXX,XXXXX+XXXXX,XXXXXXXXXXXXXXXXX...............X----
-------------------------X....................E.E..E..E..E...........E..E...E.E.....E...........XX...............X----
-------------------------XXXXXXXXXXXXXXXXXXXXXXXXXXXXXXXXXXXXXXXXXXXXXXXXXXXXXXXXXXXXXXXXXXXXXXLXX...............X----
----------------------------------------------------------------------------------------------XLXX...............X----
----------------------------------------------------------------------------------------------X.XX....E..........X----
----------------------------------------------------------------------------------------------X:XX...............X----
----------------------------------------------------------------------------------------------X.XX...............X----
----------------------------------------------------------------------------------------------X.XX...............X----
-----------------------------------------HXXXXXXXXXXXXXXXXXXXXXXXXXXXXXXXXXXXXXXXXXXXXXXXXXXXXX.XX...............X----
-----------------------------------------X....E..........E.........,E.,,.,,.,,.,,.,,.,,.,,.,,.,.XX...............X----
-----------------------------------------X...XXXXXXX+XXXXXXXXX+XXXXXXXXXXXXXXXXXXXXXXXXXXXXXXXXXXX...............X----
-----------------------------------------X.:.X-----X+X-------X+X-----XXXXXXXXXXXXXXXXXXXXXXXXXXXXX...............X----
-----------------------------------------X...X--XXXX,XXBX-XXXX,XXXX--X....E.E.E.E.E.E.E.E.E....,.,...............X----
-----------------------------------------X...X--X.......X-XA....,AX--X.E.....................E.,.,.........E.....X----
-----------------------------------------X...X--X.,,,,,.X-X,,,..,,X--X.........................,.,...............X----
-----------------------------------------B..HX--XE,...,.X-X,W,....X--XE.E.E.E.E.E.E.E.E.E.E.E..,.,...............X----
-----------------------------------------X...X--X.,.W.,.X-X,,,...EX--X,,,,,,,,,,,,,,,,,,,,,,,,,,.,...............X----
-----------------------------------------H..HX--X.,...,EX-X..,,...X--X...........................,...............X----
-----------------------------------------XX+XX--X.,,,,,.X-X.,,,...X--X,,,,,,,,,,,,,,,,,,,,,,,,,,,,...............X----
-----------------------------------------XX+XX--X.E..E..X-X.,H,...X--X...........................................X----
-----------------------------------------X.E.X--X.XXXXX.X-XE,,,..EX--X...........................................X----
-----------------------------------------H,EHX--X.X---X.X-X....E..X--X...........................................X----
-----------------------------------------H,.HX--X.X---X.X-X,,,,...X--XBB.........................................X----
-----------------------------------------H,EHX--X.X---X.X-X...B..EX--XHB.........................................X----
-----------------------------------------X,E,X--XEXXXXX.X-X...,...X--XBB,,,,,,,,,,,,,,,,,,,,,,,,,,,,,,,,,,,,,,,,,X----
-----------------------------------------X,.,X--X....E.BX-X...,...X--X...........................................X----
-----------------------------------------X,E,X--X..E....X-X,,,,.E.X--X...........................................X----
-----------------------------------------X,.,X--XH...:.EX-XE..E...X--X...........................................X----
-----------------------------------------X,K,X--XXXXXXXXX-XXXXXXXXX--X...........................................X----
-----------------------------------------A,.AX-----------------------X.............................E.............X----
-----------------------------------------X,.,X-----------------------X.....E.....................................X----
-----------------------------------------X,.,X-----------------------X...........................................X----
-----------------------------------------A,.AX-----------------------X.................................B.........X----
-----------------------------------------XXXXX-----------------------X...........................................X----
---------------------------------------------------------------------X.............B.............................X----
---------------------------------------------------------------------X,,.........................................X----
---------------------------------------------------------------------X,,..E......................................X----
---------------------------------------------------------------------XB,.................................E.......X----
---------------------------------------------------------------------X,,.....................E...................X----
---------------------------------------------------------------------X,,.........................................X----
---------------------------------------------------------------------X,,....E....................................X----
---------------------------------------------------------------------X,,.........................................X----
---------------------------------------------------------------------X,,...........E.............................X----
---------------------------------------------------------------------X,,.........................................X----
---------------------------------------------------------------------X,,.........................................X----
---------------------------------------------------------------------X,,.........................................X----
---------------------------------------------------------------------X,,.........................E...............X----
---------------------------------------------------------------------XB,.....................................E...X----
---------------------------------------------------------------------X,,...E.....................................X----
---------------------------------------------------------------------X,,...............................E.........X----
---------------------------------------------------------------------X,,B........................................X----
---------------------------------------------------------------------X,,,,,,,,,,.................................X----
---------------------------------------------------------------------X.,,,,,,,,,.................................X----
---------------------------------------------------------------------XE.E.,E.E,,.................................X----
---------------------------------------------------------------------X....B.B.,,.E...............................X----
---------------------------------------------------------------------X.E.E.W.E,,..........E......................X----
---------------------------------------------------------------------X..B..,B.,,...................E.............X----
---------------------------------------------------------------------X.E.E.E,E,,.................................X----
---------------------------------------------------------------------XB.H...,.,,.................................X----
---------------------------------------------------------------------X,,,,,,,,,,.................................X----
---------------------------------------------------------------------X,,,,,,,,,,.....................B...........X----
---------------------------------------------------------------------X...............................,,,,,,,,B,,BX----
---------------------------------------------------------------------X............................E..,,,,,,,E,...X----
---------------------------------------------------------------------X...............................,,,,,,,,,...X----
---------------------------------------------------------------XXXXXXX.................E.............,,,,,,,,B..BX----
---------------------------------------------------------------X.E.E,,.......................,,XXXXXXXXXXXXXXX,,,X----
---------------------------------------------------------------XE.E.,,.......................,.X-------------X.E.X----
---------------------------------------------------------------X.E.E,,..........B............XXX-------------X...X----
---------------------------------------------------------------XE.E.,,.......................X---------------X.E.X----
---------------------------------------------------------------X.E.E,,.......................X---------------X...X----
---------------------------------------------------------------XE.E.,,.......................X---------------X.E.X----
---------------------------------------------------------------X.E..,,.......................X---------------X...X----
---------------------------------------------------------------XE.E,,........................X----------------XEX-----
---------------------------------------------------------------X.E.,,........................X----------------X.X-----
---------------------------------------------------------------XE..,,........................X----------------XEX-----
---------------------------------------------------------------X.E.,,........................X----------------XHX-----
---------------------------------------------------------------XE.,,.........................X----------------X.X-----
---------------------------------------------------------------X..,,.........................X----------------XWX-----
---------------------------------------------------------------XE.,,...........:.............X----------------XXX-----
---------------------------------------------------------------X.,,..........................X------------------------
---------------------------------------------------------------XE,,..........................X------------------------
---------------------------------------------------------------X.,,..........................X------------------------
---------------------------------------------------------------X.,,.........................X-------------------------
---------------------------------------------------------------X,,..........................X-------------------------
---------------------------------------------------------------X,,,.........................X-------------------------
---------------------------------------------------------------X,,.,,,.....................X--------------------------
---------------------------------------------------------------X,.....,,,..................X--------------------------
---------------------------------------------------------------X,........,,,...............X--------------------------
---------------------------------------------------------------X,...........,,,...........X---------------------------
---------------------------------------------------------------X.,,,...........,,,........X---------------------------
---------------------------------------------------------------X....,,,,..........,,,.....X---------------------------
---------------------------------------------------------------X........,,,..........,,,.X----------------------------
---------------------------------------------------------------X...........,,,..........,X----------------------------
---------------------------------------------------------------X..............,,,........X----------------------------
---------------------------------------------------------------X.................,,,,....X----------------------------
---------------------------------------------------------------X.....................,,,.X----------------------------
---------------------------------------------------------------X........................,X----------------------------
---------------------------------------------------------------X.........................X----------------------------
---------------------------------------------------------------X.........................X----------------------------
---------------------------------------------------------------X.........................X----------------------------
---------------------------------------------------------------X.,,,,,,,,,...,,,,,,,,,...X----------------------------
---------------------------------------------------------------X.,E.E.E.E,...,E.E.E.E,...X----------------------------
---------------------------------------------------------------X.,,,,,,,,,...,,,,,,,,,...X----------------------------
---------------------------------------------------------------X.........................X----------------------------
---------------------------------------------------------------X.........................X----------------------------
---------------------------------------------------------------X.........................X----------------------------
---------------------------------------------------------------X,,,,,,,,,,,,,,,,,,,,,,,,,X----------------------------
---------------------------------------------------------------X.........................X----------------------------
---------------------------------------------------------------X.........................X----------------------------
---------------------------------------------------------------X.........................X----------------------------
---------------------------------------------------------------X.....,,,,,,,,,,,,,,,.....X----------------------------
---------------------------------------------------------------X.....,E.E.E.E.E.E.E,.....X----------------------------
---------------------------------------------------------------X.....,,,,,,,,,,,,,,,.....X----------------------------
---------------------------------------------------------------X.........................X----------XXXXXX------------
---------------------------------------------------------------X.........................X--------XX......XXXXX-------
---------------------------------------------------------------X.........................X------XX.............X------
---------------------------------------------------------------X.........................X----XX................X-----
---------------------------------------------------------------X.........................X--XX...................X----
---------------------------------------------------------------X.........................X--X.....................X---
---------------------------------------------------------------X.........................X-X.......................X--
---------------------------------------------------------------X.........................X-X........................X-
---------------------------------------------------------------X.........................X-X........................X-
---------------------------------------------------------------X.........................XX.........................X-
---------------------------------------------------------------X.........................XX.........................X-
---------------------------------------------------------------X,,,,,,,,,,,,,,,,,,,,,,,,,XX.........................X-
---------------------------------------------------------------X.........................X..........................X-
---------------------------------------------------------------XXX,XXX,XXX,XXXXX,XXX,XXXXX..........................X-
----------------------------------------------------------------XE.:,E.:.E.:++.,E,:E.EH.XX...........................X
----------------------------------------------------------------X+XXXXX+XX+XXX.,,,......:X...........................X
---------------------------------------------------------------XX+HX-XX+XX+XXXE....A:..:.,...........................X
---------------------------------------------------------------X..AX-A,.XX.,AX..:...:....X...........................X
---------------------------------------------------------------X.:,X-X,:XX:,XX:......:H.:X...........................X
--------------------------------------------------------------->X,HX-HX,XX,XHXXX,X:X,XXXX............................X
-------------------------------------------------------------XXXX,XXXXX,XX,XXXXX,XXX,XX..............................X
-------------------------------------------------------------X......................................................X-
-------------------------------------------------------------X......................................................X-
-------------------------------------------------------------X.....................................................X--
-------------------------------------------------------------X.....................................................X--
-------------------------------------------------------------X....................................................X---
-------------------------------------------------------------X....................................................X---
-------------------------------------------------------------X...................................................X----
-------------------------------------------------------------X...................................................X----
-------------------------------------------------------------X,,,,,,,,,,,,,,,,,,,,,,,,,.........................X-----
-------------------------------------------------------------X.........................,,,,,,,,,,,,,,,,,,,,,,,,XX-----
-------------------------------------------------------------X...............................................XX-------
--------------------------------------------------------------X............................................XX---------
--------------------------------------------------------------X.........................................XXX-----------
--------------------------------------------------------------X.......................................XX--------------
--------------------------------------------------------------X..........................E.........XXX----------------
---------------------------------------------------------------X...E.............................XX-------------------
---------------------------------------------------------------XX..............................XX---------------------
-----------------------------------------------------------------XX.....E....E.....E........XXX-----------------------
-------------------------------------------------------------------XX...................XXXX--------------------------
---------------------------------------------------------------------XX.............XXXX------------------------------
-----------------------------------------------------------------------XXXXXXXXXXXXX----------------------------------
