--------------------------------------------------------------------------------------XXXXXXXXXXXXXXXXXXXXXXXX---------------------
--------------------------------------------------------------------------------------XH.HH.HXXAA.WA.AXA.AA.AX---------------------
--------------------------------------------------------------------------------------X......XX..,,...X......X---------------------
--------------------------------------------------------------------------------------XH.HH..++HA,KA.H+A.AA.AX---------------------
--------------------------------------------------------------------------------------X......XX.......X......X---------------------
--------------------------------------------------------------------------------------XH.HH.HXXAA.HA.AXA.AA.AX---------------------
--------------------------------------------------------------------------------------XXXXXXXXXXXX,XXXXXXXXXXX---------------------
-----------------------------------------------------------------------------------XXXXXXXXXXXXXXX,XXXXXXXXXXXXXXX-----------------
----------------------------------------------------------------------------------X.,............,.,E....E......,.X----------------
---------------------------------------------------------------------------------X..,............,.,.......E....,..X---------------
--------------------------------------------------------------------------------X....,...........,.,..E........,....X--------------
-------------------------------------------------------------------------------X......,,,,,,,,,,,,,,,,,,,,,,,,,......X-------------
------------------------------------------------------------------------------X......,..........E..E...........,......X------------
-----------------------------------------------------------------------------X......,..........,....,...........,......X-----------
----------------------------------------------------------------------------X......,...........,,...,,...........,......X----------
---------------------------------------------------------------------------X......,.............,,,,,.............,......X---------
-------------------------------------------------------------------------XX......,...............,,,........E......,......X--------
------------------------------------------------------------------------X...E...,.....E.............................,......X-------
-----------------------------------------------------------------------X.......,.....................................,..E..AX------
----------------------------------------------------------------------X.......,.......................................,.....AX-----
---------------------------------------------------------------------X.......,.........................................,......X----
--------------------------------------------------------------------X.......,.....,,,,,,,,,,,,,,,,,,,,,,,,,,,,,,,,,.....,.....AX---
-------------------------------------------------------------------X.......,......XX,,,,XXXX,,,,XXXX,,,,XXXX,,,,XX,......,......X--
------------------------------------------------------------------X.......,.......XX,,,,XXXX,,,,XXXX,,,,XXXX,,,,XX,.......,......X-
-----------------------------------------------------------------XB......,........,,.....,.,.....,.,.....,.,.....,,........,......X
-----------------------------------------------------------------XB,....,.........,,.....,.,.....,.,.....,.,.....,,.........,....,X
-----------------------------------------------------------------XB.,,.,..........,,..H..,.,..H..,.,..H..,.,..H..,,..........,.,,EX
-----------------------------------------------------------------X....,...........,,.....,.,.....,.,.....,.,.....,,...........,,X,X
-----------------------------------------------------------------X....,...........,,.....,.,.....,.,.....,.,.....,,...........,,X,X
-----------------------------------------------------------------X....,...........XX,,,,XXXX,,,,XXXX,,,,XXXX,,,,XX,...........,,X,X
-----------------------------------------------------------------X....,...........,,,,,,,,,,,,,,,,,,,,,,,,,,,,,,,,,...........,HX,X
-----------------------------------------------------------------X....,.......................................................,.X,X
-----------------------------------------------------------------X....,...........H...............................H...........XXX,X
-----------------------------------------------------------------X....,.......................................................,H..X
-----------------------------------------------------------------X....,.......................................................,...X
-----------------------------------------------------------------X....,.......................................................,...X
-----------------------------------------------------------------X....,......................................E................,...X
-----------------------------------------------------------------X....,........................E..............................,...X
-----------------------------------------------------------------X....,.......................................................,...X
-----------------------------------------------------------------X.E..+++++++++++++++++++++++++++++++++++++++++++++++++++++++++.H.X
-----------------------------------------------------------------X....,.................................................E.....,...X
-----------------------------------------------------------------X....,.......................................................,...X
-----------------------------------------------------------------X....,.......................................................,..AX
-----------------------------------------------------------------X....,.......................................................,...X
-----------------------------------------------------------------X....,........E..............................................,...X
-----------------------------------------------------------------X....,.......................................................,..EX
-----------------------------------------------------------------X....,.......................................................,...X
-----------------------------------------------------------------X....,,,,,,,,,,,,,,,,,,,,,,,,,,,,,,,,,,,,,,,,,,,,,,,,,,,,,,,,,...X
-----------------------------------------------------------------X....,.......................................................,..AX
-----------------------------------------------------------------X....,.......................................................,...X
-----------------------------------------------------------------X....,.......................................................,...X
-----------------------------------------------------------------X....,.......................................................,,..X
-----------------------------------------------------------------X..,,.,....................................................,,,.,,X
-----------------------------------------------------------------X,,....,.........................E.........................,,.X,.X
-----------------------------------------------------------------X.......,................................................XX.HXX.X-
------------------------------------------------------------------X.......,...............................E..............,.X.XX,X--
-------------------------------------------------------------------X.......,............................................,..HX,.XX--
--------------------------------------------------------------------X.......,..........................................,.....,X----
---------------------------------------------------------------------X.......,........................................,.......X----
----------------------------------------------------------------------X..E....,......................................,.....E.X-----
-----------------------------------------------------------------------X.......,....................................,.......X------
------------------------------------------------------------------------X..E....,...................................,......X-------
-------------------------------------------------------------------------X.......,.................................,..H...X--------
--------------------------------------------------------------------------X..E....,...............................,......X---------
---------------------------------------------------------------------------X.......,.............................,......X----------
----------------------------------------------------------------------------X..E....,...........................,......X-----------
-----------------------------------------------------------------------------X.......,.........................,......X------------
------------------------------------------------------------------------------X.......,,,,,,,,,,,,,,,,,,,X,,,,,......X-------------
-------------------------------------------------------------------------------X..E..,....,,,,,.,.......HX.HE,,.....X--------------
--------------------------------------------------------------------------------X....,....,...,.,........+++XXX....X---------------
---------------------------------------------------------------------------------X..,E...E,...,.,........XXXXXX...X----------------
----------------------------------------------------------------------------------X.,.....,...,.,..HBB...,,,,,,..X-----------------
-----------------------------------------------------------------------------------X,,,BB,,...,.XXXXXXXXXXXXXXXXX------------------
--------------------------------------------------------------------------------XXXXH.........,.,.EX-------------------------------
---------------------------------------------------XXXXXXXXXXXXXXXXXXXXXXXXX----X,,,..........,.,..X-------------------------------
---------------------------------------------------X,,,,,,,,,,,,,,,,,,,,,,,X----X,,,..........,.,..X-------------------------------
---------------------------------------------------X,.....................,X----X,,,..........,.,H.X-------------------------------
---------------------------------------------------X,......,,,,,,,........,X----X,,,..........,.,..X-------------------------------
---------------------------------------------------X,......,XXXXX,........,X----X,,,..........,.,..X-------------------------------
---------------------------------------------------X,...,,,,XX>XX,,,......,X----XXXX..........,.,.EX-------------------------------
---------------------------------------------------X,...,,:,XX.XX,:,......,X-------X,,,,,,,,,,,,X,XX-------------------------------
---------------------------------------------------X,...,,.,,,E,,,.,......,X-------X........A.,.X,X--------------------------------
---------------------------------------------------X,...,,H,XX,XX,H,......,X--------X.........,.X,XXXXXXXXXXX----------------------
---------------------------------------------------X,...,,.,XX,XX,.,......,X--------X.........,.X,XXHH....E.X----------------------
---------------------------------------------------X,...,,E,,,,,,,.,......,X---------X........,.X,XX,X,XX,X.X----------------------
---------------------------------------------------X,...,,.......E.,......,X---------X........,.X..,......X.XXX--------------------
---------------------------------------------------X,...,,.........,......,X---------X........,.X..,.....E,.,.X--------------------
XXXXXXXXXXXXXXXXXXXXXXXXXXXXXXXXXXXXXXXXXXXXXXXXXXXX,...,,.........,......,X----------X.......,.X..,E.....X.XXX--------------------
X.................................................XX,...,,..E......,......,X----------X..E....,.XXXX,X,XX,X.X----------------------
X.,,,,,,,,,,,,,,,,,,,,,,,,,,,,,,,,,,,,,,,,,,,,,,,.XX,...,,.........,......,X---XXX-----X......,.X--X,X,XX,X.X----------------------
X.,.............................................,.XX,,,.XX+++++++++X......,X---XKX-----X......,.X--XHH....E.X----------------------
X.,.............................................,.XXXXXXXX::.....::X......,X--XX,XX-----B.....,.XXXXXXXXXXXXXXXXXXX----------------
X.,.............................................,.X------X.........X......,X--X...X-----B.....,.BB.......,...,...AX----------------
X.,.............................................,.X------X......E..X......,X-XX,,,XX----X.....,,,,,,,,,,,,,,,,,,,,X----------------
X.,.............................................,.X------X.E.......X......,X-X.....X-----X.....E.,................X----------------
X.,.............................................,.X------X.......E.X......,XXX,,,,,XX----X.E......,..A............X----------------
X.,.............................................,.X-XXXXXX...E.....X......,XX.......X-----X.....E.,...............X----------------
X.,.............................................,.X-XE..,+.........XXXXXXXXXX,,,,,,,XX----XXXXXXXXXXXXXXBBXBBXXX,XX----------------
X.,.............................................,.X-X...XX........E,....,,,,.........X--------------------X,X--X.X-----------------
X.,.............................................,.X-X.E.XX.E.......,....,,,,.......E.X------------------X:X,XX:X.X-----------------
X.,.............................................,.X-X...XX..........,...,,,,..:......XXXXXX-------------X.....XX.X-----------------
X.,.............................................,.X-XW.HXX..........,...,,,,.........XX.E.X-------------XE,,,,XX.X-----------------
X.,.............................................,.X-XXXXXX..........,...,,,,.........L,...+-------------X.....LL.X-----------------
X.,.............................................,.X------X..........,...,,,,....:....XX...X-------------X.....XXXX-----------------
X.,..............,,,,,,,,,,,,,,,,,,,,,,,,,,,,,,,X.X------X..........,...,,,,.........XXXXXX-------------X:....X--------------------
X.,..............,,,,,,,,,,,,,,,,,,,,,,,,,,,,,,,XXX------X.E.........,.E,,,,.........X------XXXXBBXXBXXXX,,,,,X--------------------
X.,..............,,,,,,,,,,,,,,,,,,,,,,,,,,,,,,,XXX------X...........,..,,,,.........X------XE......BX..,E,,,.X--------------------
X.,..............,,,,,,,,,,,,,,,,,,,,,,,,,,,,,XXX-X------X,,,,,,,,,XXXXXXXXXXXXX,XXXXX------X.......XX..XXXXXXX--------------------
X.,..............,,,,,,,,,,,,,,,,,,,,,,,.,,..:X----------XE,E,E,E,EX-----------X,X----------X......,XX..X--------------------------
X.,..............,,,,,............,...,..,,...X----------X.........X----------XX,XX---------X,,...,EXX..X--------------------------
X.,..............,,,,,............,...,..,,...X----------H........HX----------X.:.X---------X,,...,.,+..B--------------------------
X.,..............,,,,,............,...,..,,...XXXXX-XXXXXXXXXXXXXXXXXXXXXXXXXXX,,,XXXX-X+---X,,:.,..:X..B--------------------------
X.,..............,,,,,............,...,..,,...,..:X-X:.......:X-X:.......:,,:.......:XXXXXX:X,XXXXXXXXXXX--------------------------
X.,..............,,,,,..E.........,...,..,,...,...X-X.....E...X-X.....E...XX...E...,,XX....,,,X------------------------------------
X.,..............,,,,,............,...,..,,...,...XXX.........XXX..,,,,,..XX.......,.,L...E,,,X------------------------------------
X.,..............,,,,,............,...,..,,...,...,.,.........+E,..,...,..L,.......,,XX....,,,X------------------------------------
X.,..............,,,,,............,...,..,,...,...,.,.E.......+.,..,.:.,..XX.........XX....,,,X------------------------------------
X.,..............,,,,,............,...,..,,...,...,.,.........+.,..,...,..,,.......E.XX,,,.,,,X------------------------------------
X.,..............,,,,,............,...,..,,...,...XXX....E....XXXE.,,,,,..,,.........XX,,,.,,BX------------------------------------
X.,..............,,,,,............,...,..,,...,...X-X.........X-X.........,,.........XX,,:.BBBX------------------------------------
X.,..............,,,,,............,...,..,,...,...X-X:....E..:X-X:.......:,,:....E..:XX,,,,,,,X------------------------------------
X.,..............,,,,,B...........,...,..,,...,...X-XXXX,,,XXXX-XXXXXXXXXXXXXXXXXXXXXXX.,,,,..X------------------------------------
X.,..............,,,,BBB..........,...,..,,...,..:X----X...X--------------------------XXXXXXX,X------------------------------------
X.,..............,,,,,BBB.........,...,..,,...,...X-XXXX,,,XXXX-XXXXXXXXXXX-XXXXXXXXXXX-XXXXX+XXXXX--------------------------------
X.,..............,,,,B............,...,..,,...,...X-X:.......:X-X:.......:X-X:.......:X-X:.......:X--XXXXXXXX----------------------
X.,..............,,,,,............,...,..,,...,...X-X.........X-X.........X-X...E.....X-X.........XXXX<X,XX<X----------------------
X.,..............,,,,,............,...,..,,...,...XXX.........XXX.........XXX.........XXX....:....,W,,H....HX----------------------
X.,..............,,,,,............,...,..,,...,...,,,.........,.,.........,.,.........,.,.E.......XXXX...:..X----------------------
X.,..............,,,,,............,...,..,,...,...,,,....:....,.,....:....,A,....:....,.,....:....X--XH:...HX----------------------
X.,..............,,,,,............,...,..,,...,...,,,.........,.,.........,.,.........,.,.........X--X<....<X----------------------
X.,..............,,,,,............,...,..,,...,...XXX.........XXX.........XXX.........XXX.........X--XXX+XXXX----------------------
X.,..............,,,,,............,...,..,,...,...X-X.........X-X.........X-X.........X-X.........X--------------------------------
X.,..............,,,,,............,...,..,,...,...X-X:.......:X-X:.......:X-X:.......:X-X:.......:X--------------------------------
X.,..............,,,,,............,...,..,,...,...X-XXXX,,,XXXX-XXXX,,,XXXX-XXXX,,,XXXX-XXXX,,,XXXX--------------------------------
X.,..............,,,,,............,...,..,,...,..:X----X.E.X-------X...X-------X...X-------X.E.X-----------------------------------
X.,..............,,,,,............,...,..,,...,...X-XXXX,,,XXXX-XXXX,,,XXXX-XXXX,,,XXXX-XXXX,,,XXXX--------------------------------
X.,..............,,,,,............,...,..,,...,...X-X:.......:X-X:.......:X-X:.......:X-X:.......:X--------------------------------
X.,..............,,,,,............,...,..,,...,...X-X.........X-X.........X-X.........X-X.........X--------------------------------
X.,..............,,,,,............,...,..,,...,...XXX.........XXX...E.....XXX.........XXX.........X--------------------------------
X.,..............,,,,,............,...,..,,...,...,,,.......E.,.,.........,.,.........,.,.........X--------------------------------
X.,..............,,,,,............,...,..,,...,...,,,....:....,.,....H....,A,....H....,.,....:....X--------------------------------
X.,..............,,,,,............,...,..,,...,...,,,.........,.,.E....E..,.,.........,.,.........X--------------------------------
X.,..............,,,,,............,...,..,,...,...XXX.........XXX.........XXX..E......XXX.........X--------------------------------
X.,..............,,,,,............,...,..,,...,...X-X.........X-X.........X-X.........X-X.........X--------------------------------
X.,..............,,,,,............,...,..,,...,...X-X:.......:X-X:.......:X-X:.......:X-X:.......:X--------------------------------
X.,..............,,,,,............,...,..,,...,...X-XXXX,,,XXXX-XXXX,,,XXXX-XXXX,,,XXXX-XXXX,,,XXXX--------------------------------
X.,..............,,,,,............,...,..,,...,..:X----X.A.X-------X.A.X-------X.A.X-------X.A.X-----------------------------------
X.,..............,,,,,............,...,..,,...,...X-XXXX,,,XXXX-XXXX,,,XXXX-XXXX,,,XXXX-XXXX,,,XXXX--------------------------------
X.,..............,,,,,............,...,..,,...,...X-X:.......:X-X:.......:X-X:.......:X-X:.......:X--------------------------------
X.,..............,,,,,............,...,..,,...,...X-X.........X-X.........X-X.........X-X.........X--------------------------------
X.,..............,,,,,............,...,..,,...,...XXX.........XXX.........XXX....E....XXX.........X--------------------------------
X.,..............,,,,,............,...,..,,...,...,,,.........,.,.........,.,.........,.,.........X--------------------------------
X.,..............,,,,,............,...,..,,...,...,,,....:....,.,....H....,A,....H....,.,....:....X--------------------------------
X.,..............,,,,,............,...,..,,...,...,,,.........,.,.........,.,.........,.,.........X--------------------------------
X.,..............,,,,,............,...,..,,...,...XXX.........XXX..E......XXX.........XXX.........X--------------------------------
X.,..............,,,,,............,...,..,,...,...X-X..E......X-X.........X-X.........X-X.........X--------------------------------
X.,..............,,,,,............,...,..,,...,...X-X:.......:X-X:.......:X-X:.......:X-X:.......:X--------------------------------
X.,..............,,,,,............,...,..,,...,...X-XXXX,,,XXXX-XXXX,,,XXXX-XXXX,,,XXXX-XXXX,,,XXXX--------------------------------
X.,..............,,,,,............,...,..,,...,..:X----X...X-------X...X-------X.E.X-------X...X-----------------------------------
X.,..............,,,,,............,...,..,,...,...X-XXXX,,,XXXX-XXXX,,,XXXX-XXXX,,,XXXX-XXXX,,,XXXX--------------------------------
X.,..............,,,,,............,...,..,,...,...X-X:.......:X-X:.......:X-X:.......:X-X:.......:X--------------------------------
X.,..............,,,,,............,...,..,,...,...X-X.........X-X.........X-X.........X-X.........X--------------------------------
X.,..............,,,,,............,...,..,,...,...XXX,........XXX.........XXX.........XXX.........X--------------------------------
X.,..............,,,,,..E.........,...,..,,...,...,,,,........,.,.........,.,.........,.,.........X--------------------------------
X.,..............,,,,,............,...,..,,...,...,,+,...:....,.,....:....,A,....:....,.,....:....X--------------------------------
X.,..............,,,,,............,...,..,,...,...,,,,........,.,.........,.,.........,.,.........X--------------------------------
X.,..............,,,,,............,...,..,,...,...XXX,........XXX.........XXX.........XXX.........X--------------------------------
X.,..............,,,,,............,...,..,,...,...X-X.........X-X.........X-X.........X-X.........X--------------------------------
X.,..............,,,,,............,...,..,,...,..:X-X:.......:X-X:.......:X-X:.......:X-X:.......:X--------------------------------
X.,..............,,,,B............,...,..,,...XXXXX-XXXXXXXXXXX-XXXXXXXXXXX-XXXXXXXXXXX-XXXXXXXXXXX--------------------------------
X.,..............,,,B,............,...,..,,...X------------------------------------------------------------------------------------
X.,..............,,,,,............,...,..,,...X------------------------------------------------------------------------------------
X.,..............,,,B,,,,,,,,,,,,B,,,,,,.,,..:X------------------------------------------------------------------------------------
X.,..............,,,B,,XXX,,,XX,BBB,,,,,,,,,,,XXX-X--------------------------------------------------------------------------------
X.,..............,,,,,,X-XX+XXX,,,,,,,,,,,,,,,,,XXX--------------------------------------------------------------------------------
X.,..............,,,,,,XKXX,X-X,,,,,,,,,,,,,,,,,XXX--------------------------------------------------------------------------------
X.,..............,,,,,,XXX..XXX,,,,,,,,,,,,,,,,,X.X--------------------------------------------------------------------------------
X.,....................,H....H,.................,.X--------------------------------------------------------------------------------
X.,....................,A..W.A,.................,.X--------------------------------------------------------------------------------
X.,....................,,,,,,,,.................,.X--------------------------------------------------------------------------------
X.,....................,,,,,,,,.................,.X--------------------------------------------------------------------------------
X.,.............................................,.X--------------------------------------------------------------------------------
X.,.............................................,.X--------------------------------------------------------------------------------
X.,.............................................,.X--------------------------------------------------------------------------------
X.,.............................................,.X--------------------------------------------------------------------------------
X.,.............................................,.X--------------------------------------------------------------------------------
X.,.............................................,.X--------------------------------------------------------------------------------
X.,.............................................,.X--------------------------------------------------------------------------------
X.,.............................................,.X--------------------------------------------------------------------------------
X.,.............................................,.X--------------------------------------------------------------------------------
X.,.............................................,.X--------------------------------------------------------------------------------
X.,,,,,,,,,,,,,,,,,,,,,,,,,,,,,,,,,,,,,,,,,,,,,,,.X--------------------------------------------------------------------------------
X.................................................X--------------------------------------------------------------------------------
XXXXXXXXXXXXXXXXXXXXXXXXXXXXXXXXXXXXXXXXXXXXXXXXXXX--------------------------------------------------------------------------------
