--------------------------------------------XXXXXXXXX----------------------------------------------------------------------------------------------------
------------------------------------------XX........X----------------------------------------------------------------------------------------------------
----------------------------------------XX......H...X----------------------------------------------------------------------------------------------------
--------------------------------------XX............XXX--------------------------------------------------------------------------------------------------
------------------------------------XX............H.,EX--------------------------------------------------------------------------------------------------
----------------------------------XX....,,,.........XXX--------------------------------------------------------------------------------------------------
--------------------------------XX...,,,...,,,......X--XXX-----------------------------------------------------------------------------------------------
------------------------------XX...,,.........,,....X--XEX-----------------------------------------------------------------------------------------------
--------------------XXXXX---XX.....,...........,....XXXX,XXXX--------------------------------------------------------------------------------------------
--------------------X...X---XA.....,...........,............X--------------------------------------------------------------------------------------------
--------------------X.E.X---X......,...........,............AX-------------------------------------------------------------------------------------------
--------------------X...X---X......,.....T.....,.............X-------------------------------------------------------------------------------------------
--------XXXXXXXXX---X...XXXXX......,...........,..............X------------------------------------------------------------------------------------------
--------X.......X---X.......,......,..........,...............X------------------------------------------------------------------------------------------
----XXX-X.E...E.X---X.E...E.,......,..........,................X-----------------------------------------------------------------------------------------
----X.X-X.......X---X.......,......,,.........,................X-----------------------------------------------------------------------------------------
----XtXXX.......XXXXX.......,........,,,.....,..................X-----------------------------------------------XXXXXXXXXXXXX----------------------------
----XE.W,...................,...........,,,,,,..................X-----------------------------------------------X............X---------------------------
---X..B.,.E...E...E...E...E.,....................................X----------------------------------------------X............X---------------------------
---X...E,...................,....................................X----------------------------------------------X.............X--------------------------
--X.E...XXXXX...........XXXXX.....................................X-------------XXXXXXXXXXXXXX------------------X..............X-------------------------
--X...A.X---X...........X---X.....................................X-------------X.............XX----------------X..............X-------------------------
-XB.A..BX---X.E...E...E.X----X.....................................X-----------X................XX--------------X...............X------------------------
-X......X---X...........X----X.....................................X-----------X..................XX------------X................X-----------------------
X.H...B.XXXXX,,,,,,,,,,,XX----X.........XXXX,XXXX...........:.......X---------X.....E.,,,,........H.X-----------X,...............X-----------------------
X........................X--XX,.......XX---XEX--X..................AX---------X.......,...,,........X-----------X.,,..............X----------------------
-X......................A.XX...,....XX-----XXX---X..................X--------X.......,..K...,.A.....X-----------X...,..............X---------------------
-X........................,..H.,....X------------X..................XXX------X.......,......,.......XXX---------X...,..............X---------------------
--X.....T..................,....X,,,XXXXX---------X.................,EX-----X...E...,.:.:.:.,...E...,EX---------X.W.,...............X--------------------
--X........................,..XXXK.A...TX---------X.................XXX-----X.......,.......,.......XXX---------X...,................X-------------------
---X........................XX--X.......X----------X................X--XXX--X........,..T..,..H...H.X-----------X...,................X-------------------
---X.A......................X---XA.W...:X----------X................X--XEX--X........,.....,........X-----------X...,.................X------------------
----XXX,XXXXXXXXX,,,XXX.....XXX-XXXXXXXXX-----------X...............XXXX,XXXX...E.....,,,,,.E.......XXXXXXXXXXXXX...,..................X-----------------
------XEX-------XA.WX-X.....,EX---------------------X...............,.......,.....................,,................,..................X-----------------
------XXX-------X...X--X....XXX-----XXXX----------XXX...............,.......,...................,,.................,....................X----------------
---------------XX+++XX-X....X-----XX....XX--------XE,...............,.......,.................,,...................,.....................X---------------
---------------XX+++XX--X...X---XX......H.X-------XXX...............,.E...E.,.A.....E...E...,,......,,,,,,,,,,,,,,,......................X---------------
----------------X...X---X...X---X.E.......X---------X...............,.......,...............,.....,,......................................X--------------
----------XXXXXXX...X-XXX...X---XX........X---------XXXXX...........,.......,...............,...,,.........................................X-------------
----------X<,<,<,<..X-X.t...X-----XX......X-------------X...........,.......,...............,...,..........................................X-------------
----------XXXXXXX...X-XXX...X-------X....XXXXX----------X...........,.E...E.,...E.......E...,...,...........................................X------------
----------------X,,,X---X...X---XX--X....+,:.X----------X...........,.......,...............,...,...........................................X------------
----------------X,,,XXXXX...XXXXXXXXX...+,..A.X-XXXXXXXXX...........,.......,...............,...,...........................................X------------
----------------X...............,,..+...+,....X-XA.A................,.......,...............,...,...........................................X------------
---------------XA.............E.,,T.+.H.+,.E..KXX...................,.E...E.,.......E.......,...,...........................................X------------
---------------X................,,..+...+,.....XXA.A................,.......,...............,...,...........................................X------------
--------------X.W...XXXXX...XXXXXXXXX...+,..A.X-XXXXX...............,.......,.............E.,...,...........................................X------------
--------------X.....X---X...X---XX--X...+,.:..X-----X...............,.......,...............,...,...........................................X------------
---------------XA...X---X...X-------X....XXXXX------X...............XXXX,XXXX...E...........,...,...........................................XXXXX--------
---------------X....X---X...X-----XX.....X----------X...............X--XEX--X...............,...,...........................................,...X--------
---------------X..E.X--XX,,,XX--XX........X---------X...............X--XXX--X...............,...,...........................................,.E.X--------
----------------X...X--XX,,,XX--X.E.......X---------X...............XXX---XXX...............,...,...........................................,...X--------
----------------XXXXX---X...X---XX..W.....X---XXX--X..............A.,EX---XE,.......E...E...,...,...........................................XXXXX--------
------------------------XE.EX-----XX....XX----XEX--X................XXX---XXX...............,...,...........................................X------------
-----------------------X....X-XLLLX-XtXXXXXXXXX,XXX.................X-------X..............,...,............................................X------------
--------------XX---XX--XE.E.X-X...X-X.X-X...........................X-------X..............,...,............................................X------------
---------XXXXXXXXXXXXXX.H..X--L.H.L-XXXXA...E.......................XXXXXXXXX...E.........,...,.............................................XXXXXXXXXXXXX
---------X....,,E.E,,E.E.E.X--L...L----X............................,.......,.............,...,.............................................,...........X
--------X...E.,,...,,.....X---L:.WL---X............................,......A..,...........,...,..............................................,.........E.X
--------X.....,,E.E,,E.E..X---X...X---X............................,.........,...........,...,..............................................,...........X
-------X..A.XXXXXXXXXXXXXX---XX+++XX-X..E...XXXX,XXXXXXXX..........,.........,......E...,...,...............................................,.E...E.....X
-------X....X-XX---XX--------XX+++XX-X......X--XEX------X.........,...........,.........,...,...............................................,...........X
------X....X----------------XXX,,,XXX......X---XXX------X.........,.A.........,........,...,................................................,.........E.X
------X.E..X----------------XA.............X------------X.........,...........,........,...,................................................,...........X
------X...X-----------------X.......E.....X-------------XX.......,....T...:....,......,...,.................................................XXXXXXXXXXXXX
-----XX,,,XX----------------X...E.........X---------------XX.....,.............,......,...,.................................................X------------
-----XX,,,XX----------------X...........AX------------------XX...,..H.......A..,.....,...,..................................................X------------
------X...X-----------------XA...........X--------------------XX,...............,....,...,..................................................X------------
------X.E.X-----------------XXXXXXXXXXXXX-----------------------XXXXXXXXXXXXXXXXXXXXX...,...................................................XXXXXXXXXXX--
------X...X-------------------------------------------------------------------------X...,...................................................,.........X--
------X.:.X-------------------------------------------------XXXXXXXXXXXXXXXXXXXXXXX-X...,...................................................XXXXXXXXXXX--
------X...X-------------------------------------------------XE.Et.tE.Et.tE.Et.tE.EX-X...,...................................................X------------
------XX>>X-------------------------------------------------X...t.t...t.t...t.t...X-X...,...H...............................................XXXXXXXXX----
------------------------------------------------------------XE.Et.tE.Et.tE.Et.tE.EX-X...,...................................................,.......X----
------------------------------------------------------------X...t.t...t.t...t.t...XXX..,....................................................,.E...E.X----
------------------------------------------------------------XE.Et.tE.Et.tE.Et.tE.E,.,..,....................................................,.......X----
------------------------------------------------------------X...t.t...t.t...t.t...,.,.,.....................................................XXXXXXXXX----
------------------------------------------------------------XE.Et.tE.Et.tE.Et.tE.E,.,.,.....................................................X------------
------------------------------------------------------------X...t.t...t.t...t.t...XXX,......................................................X------------
------------------------------------------------------------XE.Et.tE.Et.tE.Et.tE.EX-X,......................................................X------------
------------------------------------------------------------X...t.t...t.t...t.t...X-X.......................................................X------------
------------------------------------------------------------XE.Et.tE.Et.tE.Et.tE.EX-X.......................................................X------------
------------------------------------------------------------XXXXXXXXXXXXXXXXXXXXXXX-X.......................................................X------------
------------------------------------------------------------------------------------X.......................................................X------------
----------------------------------------------------------------------------XXXXXXXXX.......................................................X------------
----------------------------------------------------------------------------X...............................................................X------------
----------------------------------------------------------------------------X...............................................................X------------
----------------------------------------------------------------------------X...............................................................X------------
----------------------------------------------------------------------------X...............................................................X------------
----------------------------------------------------------------------------X.............................................................XX-------------
----------------------------------------------------------------------------X...........................................................XX---------------
----------------------------------------------------------------------------X.........................................................XX-----------------
----------------------------------------------------------------------------X.......................................................XX-------------------
----------------------------------------------------------------------------X.....................................................XX---------------------
----------------------------------------------------------------------------X.....................ttt...........................XX-----------------------
----------------------------------------------------------------------------X.....................t.t.........................XX-------------------------
----------------------------------------------------------------------------XXX...................ttt.......................XX---------------------------
-------------------------------------------------------------------------------XXXX.......................................XX-----------------------------
-----------------------------------------------------------------------------------XXXX.................................XX-------------------------------
---------------------------------------------------------------------------------------XXXX...........................XX---------------------------------
-------------------------------------------------------------------------------------------XXXX.....................XX-----------------------------------
-----------------------------------------------------------------------------------------------XXXX...............XX-------------------------------------
---------------------------------------------------------------------------------------------------XXXX.........XX---------------------------------------
-------------------------------------------------------------------------------------------------------XXXX...XX-----------------------------------------
-----------------------------------------------------------------------------------------------------------XXX-------------------------------------------
