----------------------------------------------------------XXXXXXXXXX-----------------------------------------------------------
-------------------------------------------------------XXX..........XXXX-------------------------------------------------------
-----------------------------------------------------XX.....E....E......XX-----------------------------------------------------
---------------------------------------------------XX.E................E..XX---------------------------------------------------
--------------------------------------------------X.......XXXX+++XXXX.......X--------------------------------------------------
------------------------------------------------XXE....XXX---X...X---XXX..E..XX------------------------------------------------
-----------------------------------------------X......X------X,H,X------X......X-----------------------------------------------
----------------------------------------------X.....XX-------X,,,X-------XX.....X----------------------------------------------
---------------------------------------------X.....X--------XX,,,XX--------X.....X---------------------------------------------
--------------------------------------------X..E..X------XXX.,...,.XX-------X..E..X--------------------------------------------
-------------------------------------------X.....X-----XX,..H,.T.,H.,XX------X.....X-------------------------------------------
------------------------------------------X.....X-----X...,..,..,..,...X------X.....X------------------------------------------
-----------------------------------------X.E..XX-----X.,.H,..,,,,,.,.H,.X------X..E..X-----------------------------------------
----------------------------------------X....XX------X..,..,,.....,,.,..X-------X.....X----------------------------------------
---------------------------------------X....XXAX----X,.H.,,....A....,..H.X-----XAX....X----------------------------------------
--------------------------------------X....X.A..X---X.,,.,....,,,....,.,,X----X..AX....X---------------------------------------
-------------------------------------X....,.X..HX---X...,.A.,,,,,,,A..,...X--XH..XX,....X--------------------------------------
------------------------------------X....X.E.X:..X-X.H..,..,,....,,...,.H.X-XA.:XXE.X....X-------------------------------------
-----------------------------X-----X....X.X.E,X..AXX,,,,..,,,,,,,,,,...,,,,X...X,E.XXX....X-----X------------------------------
----------------------------X.X---X....XA.AX..XXAX-X...,..,,......,,...,...XXXAX...XAAX....X---X.X-----------------------------
---------------------------X...X-X....XAA.AAX.EXX--X.H.,A.,,.E.H.E.,.A.,H..X--XE..XAAAAX....X-X...X----------------------------
--------------------------X..H..X....X.......X.EX--X..,,..,,......,,...,,,.X-XE.XX......X....X...H.X---------------------------
-------------------------X..H..,,,,.XXAAA.AAA.X..X-X,,.,...,......,....,H.,XX..X.A.AAAA.AX..,,,,..H.X--------------------------
------------------------X..H.X.,T,.XXAAAA.AAAXH,.EXX.H..,...,,..,,,...,...XXE..HXA.AAAA.AAX.,,T,X..H.X-------------------------
-----------------------X..HH.XX,,,XXAAAAA.AAX...,,EXX.,,,.A..,,,,,.A.,.,,.XE.,,..X.AAAA.EAAX.,,X-X..H.X------------------------
----------------------X..H..A.XX.XA.AAAEA.AX...E..,.X,...,..........,....X,.,.....XXAAA.AAAAX.X-XA,H.H.X-----------------------
---------------------X.,H..A.A.XXX........XX.....A,,......,....A...,.......,A.E....XX.......XXXXA,A...H.X----------------------
--------------------X..H,.X.A,AAXHA.AAAAAXX......,.........,,.....,.........,.......XAA.AAAA.H.A,,AX.,.H.X---------------------
-------------------X..H..X-XXA,,AXW.AAAAXX......,............,,,,,...........,.......XA.AAAWX.A.,AX-X...H.X--------------------
------------------X..H..,.XXXA,.,AXXXXXXX......,..............................,.......XXXXXXXA.,AX.X.,...H.X-------------------
-----------------X..H..,.,H.,XA,.A.X-XXX.X.....,...............................,....X+.XXXXXA,,AX.,H,.,...H.XX-----------------
----------------X..H..,.,....,XAA,A.XXtH.XXW..,.................................,.W.XXH,tXXA,AAXX,...,.,...H..X----------------
---------------X..H..,.,......,XXA,..XXXXX,X.,...................................,X,,XXXXX..,AXX......,.,...H..X---------------
--------------X..H..,,,........XXX.W.:XXX,XXX.....................................XX,,XXX:.W.XX........,,,...H..X--------------
-------------X..H..,,.E,EE,EE,..X,...XXX,XXX.......................................XX,,XX...,XX.,E,EE,EE.,,...H..X-------------
------------X..H..,,.EH,A.AA.A...+,<X-X,XXX.........................................XX,,XX<,++..,AA.AA,HE.,,...H..X------------
-----------X..H..,,....,,,,,,,....,X-XHXXX...........................................XX,HXX.+...,,,,,,,....,,...H..X-----------
----------X,....,,.E.EE.EE.EE......X-X,XX.XX......XX......XX......XX......XX......XX..XX,X-X.....E.EE.EE.EE.,,.....X-----------
---------X,,..H.,,.,,,,,,,,,,,.....X-XAX,:XX:,,A,:XX:,,A,:XX:,,A,:XX:,,A,:XX:,,A,:XX:,,XAXXX....,,,,,,,,,,,.,,..H..,X----------
--------X.,,....,,W,.AA.AA.AA,....,X:......X.......X.......X.......X.......X.......X.....:XX,...,A.AA.AA.A,W,,.....,.X---------
-------X..,,..H.,,.,,,,,,,,,,,...,+........................................................++,..,,,,,,,,,,,.,,..H..,..X--------
------X.E.,,....,,.E.EE.EE.EE...X+A........................................................A+.X..E.EE.EE.EE.,,.....,.E.X-------
-----X....,,..H.,,.,,,,,,,,,,,XXX:.....H.......H.......H.......H.......H.......H.......H.....:-X,,,,,,,,,,,.,,..H..,....X------
X>XXX.H...,,....XXHXXAAXAAXAAX--X............................................................XX-XAXAAXAAXAXHXX.....,....HXXX+++
XEEE,.W..E,+++H+XXXXXAAXAAXAAX--XX...........................................................X--XAXAAXAAXAXXXX++H+++.E..W++EEEX
XXXXX.H...,,....,,H,,,,,,,,,,,XXX:...........................................................:XX,,,,,,,,,,,H,,.....,....HXXXXXX
-----X..E.,,..H.,,.E.EE.EE.EE...X,A....H.......H.......H.......H.......H.......H.......H...A,XX..E.EE.EE.EE.,,..H..,.E..X------
------X...,,....,,.,,,,,,,,,,,...,+........................................................++,..,,,,,,,,,,,.,,.....,...X-------
-------X..,,..H.,,W,.AA.AA.AA,....,X......................................................X.,...,A.AA.AA.A,W,,..H..,..X--------
--------X.,,....,,.,,,,,,,,,,,.....X:.A..:XX:..A.:XX:..A.:XX:..A.:XX:..A.:XX:..A.:XX:...A:XX....,,,,,,,,,,,.,,.....,.X---------
---------X,,..H.,,.E.EE.EE.EE......X-X,X,,XXX,,,,,XXX,,,,,XXX,,,,,XXX,,,,,XXX,,,,,XXX,,X,XXX.....E.EE.EE.EE.,,..H..,X----------
----------XX....,,,....,,,,,,,....,X-XHXX..X.......X.......X.......X.......X.......X-XX.HXXX,...,,,,,,,....,,,.....X-----------
------------X.H..,,,.EH,A.AA.A...+,.XX.,XX..........................................XX,,.X.,+,..,AA.AA,H.E,,,...H.X------------
-------------X.H..,,,..,,,,,,,..X,.<.XX,,XX........................................XX,,XX.<.,.X.,,,,,,,..,,,...H.X-------------
--------------X.H..,,,E.EE.EE..XXX...:XX,,XX......................................XX,,XX.:...XX..E.EE.EE,,,...H.X--------------
---------------X.H..,,.,......,.XA,W..X-X,,XX.....................................X,,XX-X..W,AX,......,.,,...H.X---------------
----------------X.H..,,.,....,.XA,,..XXXXX,W.,...................................,W.XXXXXX.,.AXX,,...,.,,...H.X----------------
----------------X..H..,,.,..,XXA,AAXXXtH.XX...,.................................,...XXH,tXXAA,AXX.,H,.,,...H.X-----------------
-----------------X..H..,,.HXXXA,,A.XXXXX++.....,..............................,,.....+XXXXXX.A,A.X.X.,,...H.X------------------
------------------X..H..,XXXXA,,AXW.AAAAX.......,............................,........AAA.AWX.A.AAXXX,...H.X-------------------
-------------------X..H..X-XA,,AXX.......X.......,...........,,,,,..........,........X......XX.A.,A-X...H.X--------------------
--------------------X..H,.XA,.AXXHA.AAAAA.X......A,........,,.....,,.......,A.......XAAAA.AAHXXA,,AX.,.H.X---------------------
---------------------X.,H..,.A.X.XA.AAAEA.AX...E..,,.....,,....A....,.....,.,..E..XA.AAAA.AAX.XXAA,...H.X----------------------
----------------------X..H.H,.X,,,X.AAAAA.AAX....,E.X,,..,....,,,....,..,X.E.,...XAA.AAEA.AXX..XX.,H.H.X-----------------------
-----------------------X..H..X.,T,.X.AAAA.AAAXH.,E.XX..,,..A,,,,,,,A..,,..X.E.,HXAAA.AAAA.XX.,,,XX..H.X------------------------
------------------------X..H...,,,,.X.........X,..XX.H..,..,,....,,...,.H.XX...X.........XX.,,T,...H.X-------------------------
-------------------------X..H....,...XAAA.AAAX.E.X-X,,,,..,,......,,...,,,,XX.E.XAAA.AAAXX..,,,,..H.X--------------------------
--------------------------X..H..X.....XAA.AA.XE.X--X...,..,,.......,...,...X-X.E.XAA.AAXX....X...H.X---------------------------
---------------------------X...X-X.....XA.A.X..XX--X.H.,.A,,.E.H.E.,.A.,.H.X--X..,.A.AX.....X-X...X----------------------------
----------------------------X.X---X.....X.XXE.XXAX-X..,,..,,.......,...,,,,XXXAX,EXX.X.....X---X.X-----------------------------
-----------------------------X-----X.....XXE.X:..AXX,,.,...,,,,,,,,....,...X.A..XXE.X.....X-----X------------------------------
------------------------------------X.....,.X..H.X-X.H..,...,,..,,,...,.H.X-X.H:.X.,.....X-------------------------------------
-------------------------------------X.....X.A..X---X.,,,..A.,,,,,.A.,.,,.X--XX..AX.....X--------------------------------------
--------------------------------------X.....XXAX----X,.H.,..........,..H.X-----XAX.....X---------------------------------------
---------------------------------------X.....XX------X..,.,....A...,.,..X-------X.....X----------------------------------------
----------------------------------------X..E..X------X.,...,,.....,...,.X------X..E...X----------------------------------------
-----------------------------------------X.....X------X..H,..,,,,,.,H..X-------X.....X-----------------------------------------
------------------------------------------X.....X------XX.,.H.,.,.H,.XX-------X.....X------------------------------------------
-------------------------------------------X..E..X-------XX..,.T.,..X--------X.....X-------------------------------------------
--------------------------------------------X.....X--------XX,,,,,XX--------X.E...X--------------------------------------------
---------------------------------------------X.....XX--------X,,,X--------XX.....X---------------------------------------------
----------------------------------------------X...E..XX------X,H,X------XX......X----------------------------------------------
-----------------------------------------------X.......XX----X...X----XX...E...X-----------------------------------------------
------------------------------------------------XX.......XX--X,,,X--XX.......XX------------------------------------------------
--------------------------------------------------X....E...XXX,,,XXX........X--------------------------------------------------
---------------------------------------------------XX.......E.........E...XX---------------------------------------------------
-----------------------------------------------------XX..........E......XX-----------------------------------------------------
-------------------------------------------------------XXX...........XXX-------------------------------------------------------
----------------------------------------------------------XXXXXXXXXXX----------------------------------------------------------
