-----XXX-------------XXXXXXXXXXXXXXXXXX-------------------------
-----XEX-------------X:..............:X-------------------------
-----XtX-------------X.....E...E....:.X-------------------------
----X..X-------------X................X-------------------------
XXXXX.EX-XXXX--------X...XXXX,XXXXX...X-------------------------
X.AXXttX-XW.X--------X...X--X+X---X...X-------------------------
XE.XX,,X-X.EX--------X...XXXX,XXXXX...X-------------------------
X..XX,,XXX..X--------X.E.X.W....HXX...X-------------------------
XXt.,,,.,.XXX--------X...X.......XX...X-------------------------
-X,,,,,,.,X----------X...X.H.....XX...XXXXXXXXXXXXXXXXXXX:XX----
-X..,,,,,.X----------X...X......HXX.E...E...E....E......E..X----
-X:..,,..:X----------X...X.......X:A.......................X----
-X...,,...X----------X...X.......XXXXXXXXXXXXXXXXX..XXXX...X----
XX...,,...XXX--------X...X.E..H.EXX..K...E.E.....X..X--X...X----
Et,..,,...,tX--------X...X:......XXE.............,..X--X...X----
Xt.XX,,XXX.EX--------X...XXXXX,XXXX..............X..X--X...X----
XEtXX.EX-XtEX--------X...X--XH..EXX............E.X..X--XA..X----
XXXXX..X-XXXX--------X...XXXXH...XXH...W.H.W....,X,.X--X...X----
----X.:X-------------X...,++,....,,H............,L,.X--X...X----
----X..X-------------X...XXXX....,,.A...........,X,.X--X...X----
----X,,X-------------X...XXXX....XX..............X.EX--X...X----
----X,,X-------------X...X....A..XXE..........A.EX..X--X...X----
----X,,X-------------X...XE..AA.EXXXXX,XXX,,XXXXXX..X--X...X----
----X,,XXXXXXXXXXXXXXX...XK......X:XXX,XXX,,XXXXXX..X--XW..X----
----X..,,,,,,,,..,,,,,...X......EXX.................X--X,,,X----
----X.:E,E,,E,,.E,,,,,...X.......XXE......,,,.......:--X...X----
----X..,,,,,,,,..,,,,,..:XH..E..:XX.XXXXXXX+XXX..XXXX-X,,,X-----
----XXXXXXXXXXX,,XXXXXXXXXXXXXXXXXX.XXHE.E,,,EX..X-HX-X,,,X-----
------------XXX,,X---XXXXXXXXXXXXXX.XX........X..X-XX-X...X-----
--------------X,,X---XK..H..AAAA.XX.XE....A...X..XXXXXXX,,,X----
--------------X,,X---X...HH.AAAA.XX.XX....HA.EX..XX..A,,...X----
--------------X..X---X...H.......XX.XX..A.....X..XX..,,,E..X----
--------------X,,X---X.H.........XX.,,A......EX..XXEXXXXXXXX----
--------------X..X---X...........XX.XX........X..XX.XXXXX:X-----
--------------X..X---X.W....AA..TXXAXX.EE.E..EX..XX.,E....X-----
--------------X..X---X...H.AAAXXXXXEXXXXXXXXXXX..XX.,,..E.X-----
--------------X..X---X........X:XXX.XXXXXXXXEXX..XX,XXXX..X-----
--------------X..X---XAA.....,XX..,,,....,.......XE,XXXX..X-----
--------------X..X---X.A.A...,XX........H,.E.....XXT.:XX..X-----
--------------X..X---XAAA....,L,.........,......A:X..AXX..X-----
--------------X..X---X.AA.W..,XX.XXXXXXXXX,,XXXXXXX.A.,,..X-----
--------------X..X---XXXXXXXXXXX.XXE.T.EXX,,XWXXE..E..,,..X-----
--------------XE.XXXXXXXXXXXXXXX.XX.....XX,,X:WX.E...EXX.,XXXX--
--------------X.:E.....E...,,....,,E.E..XX,,X,XX...E.XXX.,,,AX--
--------------X......E.....,,....,,..H.EXX,EXA.,.E...XXX.,XX,X--
--------------XXXXXXXXXXXXXXXXX..XXE..A.XX,,X,XXA..E.,+,..XXAX--
------------------------------X..XX..E..XE,,X.XX.E...XXX..XXAX--
------------------------------X..XXE,,,EXX,,XHXXE..AEX-X..XX.X--
------------------------XXXXXXX..XXXX+XXXX,,XEXXX,,,XX-X..XX,XX-
------------------------A.<.........,,,.....X.XXX,,,XXXX..,..E.X
------------------------<.W<.W..AA.......E...,,..........W....AX
------------------------A.<..H..A......................T.W.E..AX
------------------------XXXXXXX..........................,...E.X
------------------------------X..,:A,,,,,,A,,,,,,,,,,A:,.,.....X
------------------------------X..,,...................,,..XXXXX.
------------------------------X..,,...................,,..X.....
------------------------------X..,,.,,,.:......:..,,,.,,E.X.....
------------------------------X..,,.,H,.:..,H,.:..,H,.,,..X.....
------------------------------X..XXX,,,XXXX,,,XXXX,,,XXX..X.....
------------------------------X..XX.....XX..E..XXA....XX..XE....
------------------------------X..XXE.A.EXX.....XXE.E.EXX..X.....
------------------------------X..XX.....XXE...EXX.....XXE.X.....
------------------------------X.EXX.....,,.....,,..E..XX..X.....
------------------------------X..XXE.E.E,,..E..,,....HXX..X.....
------------------------------X..XX.....,,E...E,,E....XX..X.....
------------------------------X..XX.E...XX.....XX..E..XX..X.....
------------------------------:,,:X.E.EEXX.....XXE..EEX:,:X.....
------------------------------X,,XXW...AXX,.T.EXXE....XX,,X.....
------------------------------X,,XXXX,XXX->X,XXXXXX,XXXX,,X.....
------------------------------:..:--X+X----XLX----X+X--:.:X.....
------------------------------XH,XXXX,XXXXXX,XXXXEX,XXXX,,X.....
------------------------------X.:,..E...E.E.HE.........,:.X.....
------------------------------X:.,...E.........E....E..,.:X.....
------------------------------XXXXXXXXXXXXXXXXXXXXXXXXXXXXX.....
