-----------------------------XXXXXXXXXXXXXXXXXXXXXXXXXXXXXXXXXXXXXXXXXXXXXXXXXXXXXXXXXXXXXXXXXXXXXXXXXXXXXXXXXXXXXXXXXXXXXX------------------------------
-----------------------------X............................................................................................X------------------------------
----------------------------X..............................................................................................X-----------------------------
----------------------------X..............................................................................................X-----------------------------
----------------------------X..............................................................................................X-----------------------------
---------------------------X................................................................................................X----------------------------
---------------------------X................................................................................................X----------------------------
---------------------------X................................................................................................X----------------------------
--------------------------X..................................................................................................X---------------------------
--------------------------X..................................................................................................X---------------------------
--------------------------X..................................................................................................X---------------------------
-------------------------X....................................................................................................X--------------------------
-------------------------X....................................................................................................X--------------------------
-------------------------X.........E......................................................................E...................X--------------------------
------------------------X......................................................................................................X-------------------------
------------------------X......................................................................................................X-------------------------
------------------------X......................................................................................................X-------------------------
-----------------------X........................................................................................................X------------------------
-----------------------X........................................................................................................X------------------------
-----------------------X........................................................................................................X------------------------
----------------------X...................H......................................................................................X-----------------------
----------------------X..........................................................................................................X-----------------------
----------------------X..........................................................................................................X-----------------------
----------------------X...........................................................................................................X----------------------
---------------------X............................................................................................................X----------------------
---------------------X............................................................................................................X----------------------
---------------------X.............................................................................................................X---------------------
--------------------X..............................................................................................................X---------------------
--------------------X..............................................................................................................X---------------------
--------------------X...............................................................................................................X--------------------
-------------------X................................................................................................................X--------------------
-------------------X................................................................................................................X--------------------
-------------------X.................................................................................................................X-------------------
------------------X..................................................................................................................X-------------------
------------------X..................................................................................................................X-------------------
------------------X...................................................................................................................X------------------
-----------------X....................................................................................................................X------------------
-----------------X....................................................................................................................X------------------
-----------------X.....................................................................................................................X-----------------
----------------X......................................................................................................................X-----------------
----------------X......................................................................................................................X-----------------
----------------X.......................................................................................................................X----------------
---------------X........................................................................................................................X----------------
---------------X........................................................................................................................X----------------
---------------X.........................................................................................................................X---------------
--------------X..........................................................................................................................X---------------
--------------X...........................................................................................................................X--------------
--------------X...........................................................................................................................X--------------
-------------X............................................................................................................................X--------------
-------------X.............................................................................................................................X-------------
-------------X.............................................................................................................................X-------------
------------X..............................................................................................................................X-------------
------------X...............................................................................................................................X------------
------------X...............................................................................................................................X------------
-----------X................................................................................................................................X------------
-----------X.................................................................................................................................X-----------
-----------X.................................................................................................................................X-----------
----------X..................................................................................................................................X-----------
----------X...................................................................................................................................X----------
----------X...................................................................................................................................X----------
---------X....................................................................................................................................X----------
---------X..............................................................A...A..................................................................X---------
---------X.....................................................................................................................................X---------
--------X......................................................................................................................................X---------
--------X.......................................................................................................................................X--------
--------X.................................................................HW..A.................................................................X--------
-------X........................................................................................................................................X--------
-------X.........................................................................................................................................X-------
-------X.........................................................................................................................................X-------
-------X................................................................A...A....................................................................X-------
------X...........................................................................................................................................X------
------X...........................................................................................................................................X------
------X...........................................................................................................................................X------
-----X.............................................................................................................................................X-----
-----X.............................................................................................................................................X-----
-----X.............................................................................................................................................X-----
----X...............................................................................................................................................X----
----X...............................................................................................................................................X----
----X...............................................................................................................................................X----
---X.................................................................................................................................................X---
---X.................................................................................................................................................X---
---X....:............................................................................................................................................X---
--X...................................................................................................................................................X--
--X...:...:...........................................................................................................................................X--
--X.........................................................................................................................................H.........X--
-X..:.....:...E........................................................................................................................................X-
-X.....................................................................................................................................................X-
-X....E.....:......................................................................................................................................<...X-
X.......................................................................................................................................................X
X.........:.............................................................................................................................................X
-XX...................................................................................................................................................XX-
---X..:...:..........................................................................................................................................X---
----X...............................................................................................................................................X----
-----XX.:.........................................................................................................................................XX-----
-------X.........................................................................................................................................X-------
--------X.......................................................................................................................................X--------
---------XX...................................................................................................................................XX---------
-----------X.................................................................................................................................X-----------
------------XX.............................................................................................................................XX------------
--------------X...........................................................................................................................X--------------
---------------X.........................................................................................................................X---------------
----------------XX.....................................................................................................................XX----------------
------------------X...................................................................................................................X------------------
-------------------XX...............................................................................................................XX-------------------
---------------------X.............................................................................................................X---------------------
----------------------X...........................................................................................................X----------------------
-----------------------XX.......................................................................................................XX-----------------------
-------------------------X.....................................................................................................X-------------------------
--------------------------X...................................................................................................X--------------------------
---------------------------XX...............................................................................................XX---------------------------
-----------------------------X.............................................................................................X-----------------------------
------------------------------XX.........................................................................................XX------------------------------
--------------------------------X.......................................................................................X--------------------------------
---------------------------------X.....................................................................................X---------------------------------
----------------------------------XX.................................................................................XX----------------------------------
------------------------------------X...............................................................................X------------------------------------
-------------------------------------XX............................................................................X-------------------------------------
---------------------------------------X.........................................................................XX--------------------------------------
----------------------------------------X.......................................................................X----------------------------------------
-----------------------------------------XX....................................H..............................XX-----------------------------------------
-------------------------------------------X.................................................................X-------------------------------------------
--------------------------------------------X...............................................................X--------------------------------------------
---------------------------------------------XX...........................................................XX---------------------------------------------
-----------------------------------------------X.........................................................X-----------------------------------------------
------------------------------------------------XX.....................................................XX------------------------------------------------
--------------------------------------------------X...................................................X--------------------------------------------------
---------------------------------------------------X.................................................X---------------------------------------------------
----------------------------------------------------XX.............................................XX----------------------------------------------------
------------------------------------------------------X...........................................X------------------------------------------------------
-------------------------------------------------------X.........................................X-------------------------------------------------------
--------------------------------------------------------XX.....................................XX--------------------------------------------------------
----------------------------------------------------------X...................................X----------------------------------------------------------
-----------------------------------------------------------XX...............................XX-----------------------------------------------------------
-------------------------------------------------------------X.............................X-------------------------------------------------------------
--------------------------------------------------------------X...........................X--------------------------------------------------------------
---------------------------------------------------------------XX.......................XX---------------------------------------------------------------
-----------------------------------------------------------------X.....................X-----------------------------------------------------------------
------------------------------------------------------------------XX..........E......XX------------------------------------------------------------------
--------------------------------------------------------------------X...............X--------------------------------------------------------------------
---------------------------------------------------------------------X.............X---------------------------------------------------------------------
----------------------------------------------------------------------XX.........XX----------------------------------------------------------------------
------------------------------------------------------------------------X.......X------------------------------------------------------------------------
-------------------------------------------------------------------------X.....X-------------------------------------------------------------------------
--------------------------------------------------------------------------XX.XX--------------------------------------------------------------------------
----------------------------------------------------------------------------X----------------------------------------------------------------------------
---------------------------------------------------------------------------------------------------------------------------------------------------------
