------------------------------------------------------XXXXXXXXXXXXXXXXXXXXXXXXXXXXX-----XXXXXXXXXXXXXXX
-----------------------------------------------------X.............................X----X-------------X
----------------------------------------------------X.A.............E.............A.X---X-XXXXX-XXXXX-X
----------------------------------------------------X...............................X---X-X---X-X---X-X
----------------------------------------------------X...............................X---X-X---X-X---X-X
----------------------------------------------------X..........................A....X---X-X---X-X--X--X
----------------------------------------------------X...............H...............X---X--XXXX-XXXX-X-
----------------------------------------------------X...............................X----X-----X----X--
----------------------------------------------------X...............................X-----XXXXX-XXXX---
----------------------------------------------------X...............................X------------------
----------------------------------------------------X.A.............................X---XXXXXXXXXXXXXXX
----------------------------------------------------X..........t....................X---X-------------X
----------------------------------------------------X..........t....................X---XXXXXXXXXXXXX-X
----------------------------------------------------X...............................X---------------X-X
----------------------------------------------------X.......................t.......X---------------X-X
----------------------------------------------------X.......................t.......X--------------X--X
----------------------------------------------------X...............................X---XXXXXXXXXXXX-X-
----------------------------------------------------X...............................X---X-----------X--
----------------------------------------------------X...............................X---XXXXXXXXXXXX---
----------------------------------------------------X................,,.............X------------------
----------------------------------------------------X...............,..,............X---XXXXXXXXXXXXXXX
----------------------------------------------------X..............,.W.,............X---X-------------X
----------------------------------------------------X..............,...,.........H..X---X-XXXXX-XXXXX-X
----------------------------------------------------X...............,,,,............X---X-X---X-X---X-X
----------------------------------------------------X...............................X---X-X---X-X---X-X
----------------------------------------------------X...............................X---X-X---X-X--X--X
----------------------------------------------------X...............................X---X--XXXX-XXXX-X-
----------------------------------------------------X...............................X----X-----X----X--
----------------------------------------------------X.......t.......................X-----XXXXX-XXXX---
----------------------------------------------------X.......t.......................X------------------
----------------------------------------------------X...............................X---------------XXX
----------------------------------------------------X..........................tt...X--------------XX-X
----------------------------------------------------X.............A............t....X-------------X-XXX
----------------------------------------------------X...............................X----------XXX-XXX-
----------------------------------------------------X...............................X---------X--XXX-X-
----------------------------------------------------Xt..............................X---------X-X--X-X-
----------------------------------------------------X...............................X---------X-X---X-X
----------------------------------------------------X...............t...............X---------X-X---X-X
----------------------------------------------------X...............t...............X---XXXXXXX-XXXXX-X
----------------------------------------------------X...............................X---X-------------X
----------------------------------------------------X...............................X---XXXXXXXXXXXXXXX
---------------------------------------------------X................................X------------------
--------------------------------------------------X.................................X---XXX---XXXXXXXXX
-------------------------------------------------X..................................X---X-X---X-------X
------------------------------------------------X...................................X---X-X---X-XXXXX-X
-----------------------------------------------X,...................................X---X-X---X-X---X-X
----------------------------------------------X.,.......A...........................X---X-X---X-X---X-X
---------------------------------------------X..,.............t.....................X---X-X---X-X---X-X
XXXXXXXXXXXXXXXXXXXXXXXXXXXXXXXXXXXXXXXXXXXXX...,.............t.....................X---X--XXXX-X---X-X
X...............................................,...................................X----X------X---X-X
X..................t............................,...................................X-----XXXXXXX---XXX
X..................t............................,...............................tt..X------------------
X...............................................,...................................X------------------
X..............................H................,...................................X------------------
X........A............................t.........,.....................tt............X-------XXX--------
X...............................................,...................................X-----XX.<.XX------
X...........,...............,...............,...,...................................X---XX.......XX----
X...tt.....,.,.............,.,.............,.,..,.......t...........................X-XX...........XX--
X....t....,...,...........,...,...........,...,.,.......t...........................XXXXXXXXXXXXXXXXXX-
X........,.....,.........,.....,.........,.....,,...........................,,,,....X------------------
X.......,.......,.......,.......,.......,.......,...........................,..,....X------------------
X........,.....,.........,.....,.........,.....,,..........................,.W.,....X------------------
X.........,...,...........,...,...........,...,.,...........................,..,....X------------------
X..........,.,.............,.,.............,.,..,............................,,.....X------------------
X...........,...............,...............,...,...................................X------------------
X................................t.....A........,...................................X------------------
X................................t..............,......................A............X------------------
X...............................................,...................................X------------------
X.....tt........................................,...................................X------------------
X...............................................,...................................X------------------
X....................A.................tt.......,...............................A...X------------------
X......................................tt.......,...............tt..................X------------------
X...........,...............,...............,...,.....t.............................X------------------
X..........,.,.............,.,.............,.,..,.....tt............................X------------------
X.........,...,...........,...,...........,...,.,...................................X------------------
X........,.....,.........,.....,.........,.....,,...................................X------------------
X.......,.......,.......,.......,.......,.......,...................................X------------------
X........,.....,.........,.....,.........,.....,,...................................X------------------
X.........,...,...........,...,...........,...,.,........H..........................X------------------
X..........,.,.............,.,.............,.,..,.................,.................X------------------
X.t.........,...............,..t............,...,................,.,................X------------------
X.t............................t................,...............,.W.,...............X------------------
X...............................................,...............,...,........t......X------------------
X...............................................,................,,,.........t......X------------------
X.........................................t.....,...................................X------------------
X.........................................t.....,...................................X------------------
X....................t..........................,...................................X------------------
X....................t..........................,...................................X------------------
X....tt.....,...............,...............,...,...................................X------------------
X....tt....,.,.............,.,.............,.,..,...................................X------------------
X.........,...,...........,...,...........,...,.,...................................X------------------
X........,.....,....H....,.....,.........,.....,,.................A.................X------------------
X.......,.......,.......,.......,.......,.......,........t..........................X------------------
X........,....,,.........,.....,.........,.....,,........t..........................X------------------
X.........,...>...........,...,...t.......,...,.,...................................X------------------
X..........,.>.............,.,....t........,.,..,...................................X------------------
X...........,...t...........,...............,...,...................................X------------------
X...............t...............................,...................................X------------------
X...............................................,...................................X------------------
X....t........................................tt,...................................X------------------
X...tt..............tt........................t.,................................A..X------------------
X.............................A.................,.....................t.............X------------------
X...............................................,...................................X------------------
X...............................................,...................................X------------------
XXXXXXXXXXXXXXXXXXXXXXXXXXXXXXXXXXXXXXXXXXXXX...,...................................X------------------
---------------------------------------------X..,...................................X------------------
----------------------------------------------X.,...................................X------------------
-----------------------------------------------X,.............................tt....X------------------
------------------------------------------------X...................................X------------------
-------------------------------------------------X..................................X------------------
--------------------------------------------------X...A.............................X------------------
---------------------------------------------------X................................X------------------
----------------------------------------------------XXXXXXXXXXXXXXX,,,XXXXXXXXXXXXXXX------------------
------------------------------------------------------------------X+++X--------------------------------
------------------------------------------------------------------X,,,X--------------------------------
------------------------------------------------------------------X...X--------------------------------
------------------------------------------------------------------X...X--------------------------------
------------------------------------------------------------------X.A.X--------------------------------
------------------------------------------------------------------X...X--------------------------------
------------------------------------------------------------------X...X--------------------------------
------------------------------------------------------------------X,,,X--------------------------------
------------------------------------------------------------------X...X--------------------------------
------------------------------------------------------------------X...X:X------------------------------
------------------------------------------------------------------X.W.,<X------------------------------
------------------------------------------------------------------X...X:X------------------------------
------------------------------------------------------------------XX..XX-------------------------------
--------------------------------------------------------------------XXX--------------------------------
