XXXXXXXXXXXXXXXXXAX--------
X.A...H..<...H....X--------
X.................X--------
X........W........X--------
X.................X--------
X........A........X--------
X........A........X--------
X.................X--------
X.................X--------
X.................X--------
X.................X--------
X.................X--------
X.................X--------
X.................X--------
X.................X--------
X.................X--------
X....E.E.E..E.E...X--------
X..E.............EX--------
X.................X--------
X....E..E.E.E.E.E.X--------
X..E..............X--------
X.................X--------
X.................X--------
X.................X--------
X.................X--------
X..E...........E..X--------
X.................X--------
X.................X--------
XW...............WX--------
XXXXXX+X+++XXXXXXXX--------
-------X...X---------------
-------X...X---------------
-------X...X---------------
-------X...X---------------
-------X...X---------------
-------X...XXXXX-----------
-------X....EE.X-----------
-------X.......X-----------
-------XH.....EX-----------
-------XXXXX...X-----------
-----------X...X-----------
-----------X...X-----------
-----------X.A.X-----------
-----------X...X-----------
-----------X...X-----------
-----------X...X-----------
-----------X...X-----------
-----------X...X-----------
----------XX+++XXX---------
-------XXX........XX-------
------XH..........H.X------
-----X..............X------
-----X...............X-----
----XA...E.E.E..E...A.X----
---X..................X----
--X....................X---
--X.E......E...E......E.X--
-XH.....................X--
XXXXX+XXXX,XXXX,XXXXX+XXXX-
----X.X-XX,XXXX,X---X.X----
----XEX-X....XX.X---XEX----
----X.X-+.E..XX.X---X.X----
----XEX-+....XX.X---XEX----
----X.X-+....XX.X---X.X----
----X.X-X....XX.X---XEX----
----XEX-XXXXXXX.X---X.X----
----X.X-------X.X---X+X----
----X.X-------X.X----------
----XEX-------X.X----------
----X.X-------X.X----------
----XEX-------X.XXXX-------
----X.X-------X..E..XX+----
----X.X-------X.......+----
----XEX--------XXA..E.X----
----X.X----------X....X----
---->>>----------X....X----
-----------------X.E..X----
-----------------X....X----
-----------------X....X----
-----------------XXXXXX----
