----------XXXXXXXXXXX------------------------------------------------------
----------X.........X------------------------------------------------------
---------Xtt:ttttttttX-----------------------------------------------------
---------Xt.........tX-----------------------------------------------------
---------X...........X-----------------------------------------------------
---------X...........X-----------------------------------------------------
--------Xt......:....tX----------------------------------------------------
--------Xt...........tX----------------------------------------------------
--------X.....E.......X----------------------------------------------------
-------Xt.............tX---------------------------------------------------
-------Xt.........E...tX---------------------------------------------------
-------Xt..............X---------------------------------------------------
------Xt..E............tX--------------------------------------------------
------Xt...............tX--------------------------------------------------
------Xt................X--------------------------------------------------
------X.................X--------------------------------------------------
-----Xt.................tX-------------------------------------------------
-----Xt.................tX-------------------------------------------------
-----Xt...........:......X-------------------------------------------------
----Xt...................tX------------------------------------------------
----Xt..:................tX------------------------------------------------
----Xt....................X------------------------------------------------
----Xt...............tttttX------------------------------------------------
---Xt.....ttttttttttt......X-----------------------------------------------
---Xtttttt..........tttttttX--------------------------XXXXXXXXXXX----------
---X.......XXXX,XXX.t.....tX--------------------------X.........X----------
--X.tttttttXXXX,XXX.t.....t.X-------------------------X.E.....E.X----------
--X.t.....tXX.....X.t......tX-------------------------X.........X----------
--Xt..:...tXX.XXX.X.t......tX-------------------------X.,,,,,,,.X----------
-X.t......t,,.....,.t......t.X------------------------X.,.....,.X----------
-X.tE.....t,,..H..,.t...:.Et.X------------------------X.,.....,.X----------
-Xt.......t,,.....,.t.......tX------------------------X.,.....,.X----------
-XtttttttttXX.E.E.X.tttttttttX------------------------X.,.....,.X----------
X..........XX.....X...........X-----------------------X.,.....,.X----------
XXXXXXXXXXXXX...T.XXXXXXXXXXXXX-----------------------X.,.....,.X----------
------------XXXLXXX-----------------------------------X.,.....,.X----------
------------XXXLXXXXXXXXXXXXXXXXXXXXXXXXX-------------X.,.....,.X----------
------------X...........................X-------------X.,.....,.X----------
------------X.<.............E...........X-------------X.,.....,.X----------
------------X...........................X-------------X.,.....,.X----------
------------X...,,,,,,.........,,,,,....X-------------X.,,,,,,,.X----------
------------X...,,,.,,.........,,.,,....X-------------X.........X----------
------------X...,,,.,,..E......,,.,,....X-------------X.E.......X----------
------------X...,,,.,,.........,,.,,....X-------------X.........X----------
------------X...,,,.,,......E..,,.,,..E.X-------------X,XXXXXXXXX----------
------------X...,,,.,,.........,,.,,....X-------------X.X------------------
------------X...,,,.,,.........,,.,,....XXXXXXXXX-----X,XXXXXXXXXXXXXXX----
------------X...,,,.,,.........,,.,,....,.......X-----X...............X----
------------X...,,,.,,.........,,.,,....X,,,,,,,XX:---X...:.....K...:.X----
------------X...,,,.,,.........,,.,,....X.......:.X---X...............X----
------------X.E.,,,.,,.........,,.,,....X...E...:.:---X.:.....E.......X----
------------X...,,,.,,.........,,.,,....X.......,.X---X...............X----
------------X...,,,,,,.........,,,,,....X.......:.:---X.E.....:.E.:...X----
------------X...........................,.......::X---X...............X----
------------X...........................,.......:.:---X...:...........X----
------------X...........................,.......,,X---X...............X----
------------X.....E.........E...E.......,.....E.H.X---X....H......:...X----
------------X...........................,.......,,X---X...............X----
------------X...........................,.......H.X---X.:.....:.....:.X----
------------X...........................,.......,,X---X...............X----
------------X....,,,,,.........,,,,,....X.......,.X---X.E.......:.....X----
------------X....,,.,,.........,,.,,....X.......,.X---X...............X----
------------X...E,,.,,.........,,.,,....X...E...H.X---X.K...........:.X----
------------X....,,.,,.........,,.,,....X.......,,X---X...............X----
------------X....,,.,,....E....,,.,,E...X,,,,,,,XXX---X.....K...:.K...X----
------------X....,,.,,.........,,.,,....,.......X-----X...............X----
------------X....,,.,,.........,,.,,....XXXXXXXXX-----X...:...........X----
------------X....,,.,,.........,,.,,....X-------------X...............X----
------------X....,,.,,.........,,.,,....XXXXXXXXXXXXXXX.........E...:.X----
------------X....,,.,,.........,,.,,....+.............,...............X----
------------X....,,.,,.........,,.,,....XXXXXXXXXXXXXXXXXXXXXXXXXXXXXXX----
------------X....,,.,,......H..,,.,,....X----------------------------------
------------X.E..,,,,,.........,,,,,....X----------------------------------
------------X...........................X----------------------------------
------------X...........................X----------------------------------
------------X...........................X----------------------------------
------------XXXXXXXXXXXXX+++XXXXXXXXXXXXX----------------------------------
--------------------X...............X--------------------------------------
--------------------X...............X--------------------------------------
--------------------X...............X--------------------------------------
--------------------X...E.......E...X---------XXXXXXXXXXXXXXXXXXXXXXXXXXXXX
--------------------X...............X---------X...,.............,.........X
--------------------X...............X---------X...XXXXXXXXXXXXXXX.......E.X
--------------------X...............X---------X...X-------------X.........X
--------------------X...............X---------X.E.X-------------X.........X
--------------------X...............X---------X...X-------------X.........X
--------------------X...............X---------X...X-------------X.........X
--------------------X...............X---------X...X-------------X.........X
--------------------X...............X---------X.H.X-------------X.........X
--------------------X...............X---------X...X-------------X.........X
--------------------X.........E.....X---------X...X-------------X.....E...X
--------------------X...............X---------X...X-------------X.........X
--------------------X.E.............X---------X...X-------------X.........X
--------------------X...............X---------X...X-------------X.........X
--------------------X...............X---------X.E.X-------------X.........X
--------------------X...............X---------X...X-------------X.........X
--------------------X...............X---------X...X-------------X.........X
--------------------X...............X---------X...X-------------X.........X
--------------------X.......E.......X---------X...X-------------X...H.....X
--------------------X.............H.X---------X...X-------------X.........X
--------------------X...............X---------X...X-------------X.........X
--------------------X...............X---------X...X-------------X.........X
--------------------X...E...........XXXXXXXXXXX,,,XXXXXXXXX-----X.....E...X
--------------------X...............+.....................X-----X.........X
--------------------X...........E...XXXXXXXXXXXXXXXXXXXXXXX-----X.........X
--------------------X...............X---------------------------X.........X
--------------------X...............X---------------------------X.........X
--------------------X...............X---------------------------X.........X
--------------------XXXXXXXXXXXXXXXXX---------------------------X.........X
----------------------------------------------------------------X.........X
----------------------------------------------------------------X.........X
----------------------------------------------------------------X.........X
----------------------------------------------------------------X...E.....X
----------------------------------------------------------------X.........X
----------------------------------------------------------------X.........X
----------------------------------------------------------------X.........X
----------------------------------------------------------------X.........X
----------------------------------------------------------------X.........X
----------------------------------------------------------------X.E.......X
----------------------------------------------------------------X.........X
----------------------------------------------------------------X.........X
----------------------------------------------------------------X.........X
----------------------------------------------------------------X.......K.X
----------------------------------------------------------------X.........X
----------------------------------------------------------------XXXXXXXXXXX
