------------------------------------------------------------------------------------------------------------------------------------XX-XXX-------------
------------------------------------------------------------------------------------------------------------------------------------XX-X.X-------------
----------------------------------------------------------------------------------------------------------------------------------XXXXXX,XX------------
----------------------------------------------------------------------------------------------------------------------------------X.......X------------
----------------------------------------------------------------------------------------------------------------------------------XB..,,..XX-----------
----------------------------------------------------------------------------------------------------------------------------------XB,,..,,+X-----------
-------------------------------------------------------------------------------------------------------------------------------XXXX...:.T.XX-----------
-------------------------------------------------------------------------------------------------------------------------------X..,,..,,..X------------
-------------------------------------------------------------------------------------------------------------------------------X.XXB,,B,,,B-XXXXXXXXXXX
---------------------------------------------------------------------------------------XXXXXXXXXX------------------------------X,XXXXXXXXXXXX.........X
--------------------------------------------------------------------------------------XA.......,X------------------------------X.XXXXXXXXXXXX,,,,,,,,,X
-------------------------------------------------------------------------------------X.........,X------------------------------X.XXX........,.......,.X
-------------------------------------------------------------------------------------X........,.X-----------------XXXXXXXXXXXXXX,X+X....:..A,.......,.X
-------------------------------------------------------------------------------------X.W.AXXXXXXXXXXX-------------X.,.,.,.,...XX.X+,.......A,....:..,.X
-------------------------------------------------------------------------------------X...X----XXX,,,XXX-----------X.XXXXXXXXX,XX+X+X........,.......,.X
-------------------------------------------------------------------------------------X...X----X......XX-----------X,X------X:.,:.,:X.......H,.......,.X
-------------------------------------------------------------------------------------X...X----X.E....XXXXX-XXXXXXXX,XXXXXA-X.,..,.XX........,.......,.X
-------------------------------------------------------------------------------------X...X----X......,,A,X-X,,,,,,,,,,E,,X-X.....H,,........,.......,.X
----------------------XXX------------------------------------------------------------XX>XX----X......,,.,XXX,,,,,,,.E...EX-X,T....,,...:....,.......,.X
----------------------XTX-------------------------------------------------------------X+X-----X......,,A,,L,,...........,X-X,....A,,..,,,...,.......,.X
----------------------XtXXA-----------------------------------------------------------X.X-----X......,,.,XXX,...........,X-X,....A,,..,,,...,.......,.X
----------------------X...X-------------------------------------------------------XXXXX,XXXXX-X......,,A,X-X,,,,,,,,,,,,,X-X,.:,,,XX.:,K,,:.,.......,.X
----------------------XX..X-------------------------------------------------------X.,,....,.XXX......XXXXX-X,,,,,,,,,,,,,XXXA..,.,XX..,,,...,.......,.X
-----------------------X..X-------------------------------------------------------X..,...,,.,.,.......X----XXA..........XXX,X.X,,,XX...:....,.......,.X
----------------------X...A-------------------------------------------------------X...,..,..XXX..E..H.X-----X,,,,,,,,,,,XX,XX,XXXXX.........,.......,.X
----------------------X...A-------------------------------------------------------XXXXXXXXXXX-X.......X-----X.,,,,,,,,,.XX,XX.XX..........:.,.:.....,.X
----------------------X,,,X-------------------------------------------------------------------XXXXXXXXX-----X.,,,,T,,,,.XX,XX,XX............,.......,.X
----------------------X,.,X---------------------------------------------------------------------------------XH..,,,,,...XX,XX.XX............,.......,.X
----------------------X,.,X---------------------------------------------------------------------------------XXXXX,,,XXXXX,,XX.XXttt.........,.......,.X
----------------------X,.,X-------------------------------------------------------------------------------------X+++X-X.,.,,,.XXtTt.........,.......,.X
----------------------X,.,X-------------------------------------------------------------------------------------X,,,XXX.,.,,,.XXttt.........,.......,.X
----------------------X,.,X------------------------------------------------------------------------------------X,...,X,..,,,,.XX............,.......,.X
----------------------X,E,X------------------------------------------------------------------------------------XA,.,AXX..,,XX.XX....:.......,.......,.X
----------------------X,.,X------------------------------------------------------------------------------------X.,.,.XX.,A,XX.XX:.........,,.......,..X
----------------------X,.,X-----------XX+++---------------------------------------------------------------------X..:XXX.,.,XXtXXXX,,XXX,,,......:..,..X
----------------------X,.,X-----------X.,,X---------------------------------------------------------------------X...XX,.,W,XX.XXXX.E.XX............,..X
----------------------X,.,X-----------X,.,X---------------------------------------------------------------------X...XXX,.,,XXtXXXX...XX...........,...X
----------------------X,.,X-----------X,E,X--------------------------------------------------------------------X,...,XX.,..,,.XXXXXXXXX...........,...X
----------------------X,.,.AXXXXXXX---X.,,X--------------------------------------------------------------------XE,.,EXXXXXXXXXXXX-----X..........,....X
----------------------X,,.,.,,,,,,X---XE,,X--------------------------------------------------------------------X.,.,.X----------X-----X,.:.....,,.....X
----------------------X,.,..,,,,,.X---X.,.X---------------------------------------------------------------------X...X-----------X------X.....,,.......X
----------------------X.,,,A,,,,,,X---X.,:X---------------------------------------------------------------------X.T.X-----------X-----X,.,,,,.........X
-----------------------XXXXXXXXXX,X---X.,,X---------------------------------------------------------------------X...X---------XXXXX----X,.............X
--------------------------XXXXXXX,XXX-X.,,X--------------------------------------------------------------------X,...,X--------X..EX----X..............X
--------------------------XA,,,,,,,,X-X,.,X--------------------------------------------------------------------XA,.,.A--------X,ttX---XXXXXXXXXXXXXXXXX
--------------------------X.:,,,,...X-X,.,X--------------------------------------------------------------------X.,.,.X--------X.t.X--------------------
-------------------------XX,,,,,,...X-X.,,X---------------------------------------------------------------------X...X---------XXXXX--------------------
-------------------------X,,........XXX.,,X----------------------------------------------------------------XXXXXX,,,XXXXXX-----------------------------
---XXXXXXXXXXX-----------X,.....,,,.X,X.,.X---------------------------------------------------------------XX,,,,,,,,,,,,,XX----------------------------
---X.....,,,,XXX---------X,.....,.,.,.,.,.X--------------------------------------------------------------XX,,...........,,XX---------------------------
--X.,,,,,....,,X---------XX...,,,,,.XXX.,,X--------------------------------------------------------------X,,,.....T.....,,,X---------------------------
--X.,........,,X----------XX..,,,,,.X-X..AX-------------------------------------------------------------X,..,,.........,,..,X--------------------------
-X.,...,,,,,,,,X----------X-X,XXXXXXX-XXXXX-------------------------------------------------------------X,.T.XXXXXXXXXXX.T.,X--------------------------
-X.,.,,....:.,,X------------XLX---X---------------------------------------------------------------------X,...,X--------X...,X--------------------------
-X.,.,.......,,X------------X,XXXXX---XXXX-XXXX---------------------------------------------------------X,...X---------,X..,X--------------------------
X..,,........,,X------------X,,,,.X--X:,,,X,,,,X----------XXX------------------------------------------X,...,X----------X...,X-------------------------
X.,.,........,,X------------X,X,,,XXX.,,,,,,,A,X----------X,X------------------------------------------X,...,X----------X.:.,X-------------------------
X.,.,.......,.,X------------X.....,,,.,.......,X----------XWX------------------------------------------X,...,X----------X...,X-------------------------
X.,,,,,,,,,,XXXX-------------:,E..,XX.,,,,,,,.,.X---------X,X-----------------------------------------X,....X-----------,X...,X------------------------
X.,.,:......X----------------X..,XXXXXXXXXX.,.,.X---------X,,XXX--------------------------------------X,...,X------------X...,X------------------------
X.,.,.......X----------------X..,,X--------X,.,XX-XX--XXXX....AX--------------------------------------X,..AAX------------XA..,X------------------------
X.,.,.......X----------------X...X---------X,.,,,X,,XX,.,,..,:,X--------------------------------------X,..A,X------------XA..,X------------------------
X.,.,.......X----------------X,..X---------X,.,,,,,.,,,.....,,,X-------------------------------------X,...,X--------------A...,X-----------------------
X.,.,.......X-----------------X,XX---------X,.....,.,,,..E...,:.X------------------------------------XX,,,XX--------------X,,,XX-----------------------
X.,.,...<.<.X-----------------X,XX---------X,,,,,,,.XX,.....,X,X-------------------------------------XX,,,XX--------------X,,,XX-----------------------
X.,.,.......X-----------------X..X---------XXXXXXXXXXXX,....,X,XXX-----------------------------------X,...,X--------------X...,X-----------------------
X.,.,..<.<..X-----------------X,X----------------------XXXX..XXXXX------------------------------------X,...,X------------X...,X------------------------
X.,.,.......X-----------------X..X-------------------------XX-----------------------------------------X,.:.,X------------X...,X------------------------
X.,.,.......X-----------------X..X--------------------------------------------------------------------X,...,X------------X...,X------------------------
X.,.,.......X---XXXXXXXXXXXXX-X,XX--------------------------------------------------------------------X,...,X------------X...,X------------------------
X.,.,.......XXXX...,...,.:..,XX,XX---------------------------------------------------------------------X,...,X----------X...,X-------------------------
X.,.,.......,.,...,...,...,..,X..X---------------------------------------------------------------------X,...,X----------X...,X-------------------------
X.,.,.......,.,.,,,,,,,,,,,,,.,..X---------------------------------------------------------------------X,...,X----------X...,X-------------------------
X.,.,.......,.X.,,,,,,,,,,,,,.,XX----------------------------------------------------------------------X,...,X----------X...,X-------------------------
X.,.,...:....:X.,,,,,,,,,,,,,.X-------------------------------------------------------------------------X,...,X--------X...,X--------------------------
X.,.,........,,XXX.........,,.X-------------------------------------------------------------------------X,...XXXXXXXXXXX...,X--------------------------
X.,.,........XX--XXXXXXXXXXXXX--------------------------------------------------------------------------X,..,XX,,,:t:,XX,..,X--------------------------
X.,.,........X------------------------------------------------------------------------------------------X,..,+....tT:..+,..,X--------------------------
X.,.,........X-------------------------------------------------------------------------------------------X,,.+....:....+.,,X---------------------------
X.,.,........X-------------------------------------------------------------------------------------------XXX+...........+XXX---------------------------
X.,.,.......X----------------------------------------------------------------------------------------------XXHAAXXXXXXXXXX-----------------------------
X.,.,.......X------------------------------------------------------------------------------------------------------------------------------------------
X.,,,,,,,,,,XXXX---------------------------------------------------------------------------------------------------------------------------------------
X.,.,.......,.,X---------------------------------------------------------------------------------------------------------------------------------------
X.,.,.....:.,,,X---------------------------------------------------------------------------------------------------------------------------------------
-X,.,.......,.,X---------------------------------------------------------------------------------------------------------------------------------------
-X,..,.....,,,,X---------------------------------------------------------------------------------------------------------------------------------------
-X.,.,.....,..,X---------------------------------------------------------------------------------------------------------------------------------------
-X.,..,...,,,,,X---------------------------------------------------------------------------------------------------------------------------------------
--X.,..,..,...,X---------------------------------------------------------------------------------------------------------------------------------------
--X..,..,,,,,,XX---------------------------------------------------------------------------------------------------------------------------------------
---XX.,,,.,...X----------------------------------------------------------------------------------------------------------------------------------------
-----XX..,XXXXX----------------------------------------------------------------------------------------------------------------------------------------
-------XX.X--------------------------------------------------------------------------------------------------------------------------------------------
---------XX--------------------------------------------------------------------------------------------------------------------------------------------
----------------------------------------------------------------------------------XX----------XX-----XX------------------------------------------------
----------------------------------------------------------------------------XBBXXXXXXXXXXXXXXXXXXXXXXXXXXXXXAAXXX------X+X-----------------------------
----------------------------------------------------------------------------X,,,E.,,,,A..,.:,.,,,..,.,,.,E,...,.X------X.X-----------------------------
----------------------------------------------------------------------------X,.,,E,,,,W..,..,.,,,..,.,,.,.,..,T.X------X.X-----------------------------
------------------------------------------------------------------------XXXXX,.,,.,,,,....,,.,.,A,,.,.,.,E,.,..,X--XXX-X.X-----------------------------
----------------------------------------------------------------------XX.L..,,.,XXXXX,,AXXXXXXXXXXXXXXXXXXXXX,,,XXXX,XXX,XX----------------------------
---------------------------------------------------------------------X.,.L..,,.,BX..,.,:,XXXX,XXXXXXXXX,XXXXX..,XX....,,..X----------------------------
--------------------------------------------------------X------------X,,.XXXX,,,XX..,.H,,,.................B,..,BX....,,..XX---------------------------
---------------------------------------------------XXX-X,XXXXXXXXXXX-X..X---XA.,XB..X...XX.................BX.,.BX....,,E.,X---------------------------
--------------------------------------------------XA,XX,,WA,.,,,,.,,XX,,X---XXXXXB..XX,,X..................BXX,,XX....,,..XX---------------------------
--------------------------------------------------X:..X..:..........,,E.XXXXXXBBXX....................................,,..X----------------------------
--------------------------------------------------X..E,.............,,..XXXX,,X,X.,.........................,,,.......,,E.X----------------------------
--------------------------------------------------X...,.:........:..XX,,XX,..E,,:.,.........................,T,.......,,..X----------------------------
--------------------------------------------------X,XXX.............XX,,XX,E..B,X.,.........................,,,.......,,..XX---------------------------
--------------------------------------------------X,X-X.............,,..XX,...B,X.,...................................,,..,X---------------------------
--------------------------------------------------X,XXX.............,,.EXX,...,,X.,..........................,,,......,,E.XX---------------------------
--------------------------------------------XXXXX-XXXX..............XX,,XXH..E,,:.,......................T...,T,......,,..X----------------------------
------------------------------------------XAA,,,XXXXXX..............XX,,XX,...,,X.,..........................,,,......,XXXX----------------------------
------------------------------XXXXX-------X..:....,,XX..............,,E.XX,.E.,HX.,...................................,XXXXXX--------------------------
------------------------------X,,,XXXXXXXXX.....E.,,XX..............,,..XX,...,,X.,...........................,,,.....,,...:X--------------------------
------------------------------XA,.,.,.,.,.,.......,,,,,,XX..........XX,,XXX...X,:.,...........................,T,.....,X.E..X--------------------------
------------------------------X,,.,XXXXXXXX....E..,,,,,,XX..........XX,,XXXX,,X,XB,...........................,,,.....,X...TX--------------------------
------------------------------X,,,XXXXXXXXX.......E.,,......:.......,,..XXXXX+XXXB..XX,,X...................XX,,X.....,,....X--------------------------
------------------------------X,,,,,,,,,,XX,,,,,,..AXX:.............,,.,X---XE,.XXB.XX,,XX..................XX,,XX....,X.E..X--------------------------
------------------------------X,,.E...,T,XX..,,,,,.AXX.,,,,,,,,,,,,,XX,,XXXXXXXX,,..,.,,,,..................,...XX....,X....B--------------------------
------------------------------X,,.....,,,XX,,,,,,,..XX.,,,,,,,,,,,,,XX..XX,,,.X-XX..,.H,,,...BBB,,X,,X,,XX,.,...XX....,,:...B--------------------------
------------------------------X,,..E....,XX.,,,.,,..XX.,........,,,,,...X,...AX--XXXX...XXXXXXXXXXXXXXX,XXXXX.E.XX....,X....X--------------------------
------------------------------X,,...E...,XX.,,,,,,..XX.,........,,,,,...X,:.E.X---X,X,,,XX,,,AX----XX-X.X---X,,,XXtXX,XX....X--------------------------
------------------------------X.AA.....XXXX.,..,,...XXXXX,,,XX,XX,X,XX,XX,....XXXXX,.........AX----XX-X.X---XA..AXHXX.XX:AA:X--------------------------
------------------------------XXXXXXXXXX--X,,....,,.XXXXX,,,XX,XXEXEX.....E..E,.X.,.,,,,,,,,,AX----XXXX.X---X,,,XXXXXWXXXXXXX--------------------------
------------------------------------------X....E.,,.X,X.,...XX.XXXXXX,,,,,,,,,,.,.,.,:....E,,.X----X....X---X,,,X---XAX--------------------------------
------------------------------------------X......,,.,.,.,.E.XX.X----X,,,,,,,,,,.,.,.,.,,,,,.,.X----XXtXXX----XtX---------------------------------------
------------------------------------------X......,,.XXXXX.A.XX.XXXXXX..,,.,E,,,.,.,.,.,,..,.,EX-----XTX------X.X---------------------------------------
------------------------------------------XXXXXXXXXXX---XXXXXX.,,,,,,.E,,E,.,.XXXXX.,.,,E.,.,.X-----XXX------XXX---------------------------------------
-------------------------------------------------XX----------XAXXXXXX..,,..,,.X---X.,.,,,,,.,.X--------------------------------------------------------
-------------------------------------------------XX----------XXX----XXXXXXXXXXX---X.,.,,,,,E,.X--------------------------------------------------------
-------------------------------------------------XX-------------------------------XH,,......,.X--------------------------------------------------------
-------------------------------------------------XX-------------------------------XH,,,,,,,,,.X--------------------------------------------------------
-------------------------------------------------XX-------------------------------X.....E....,X--------------------------------------------------------
-------------------------------------------------XX-------------------------------XXXXXXXXKXXXX--------------------------------------------------------
-------------------------------------------------XX-------------------------------------XXXXX----------------------------------------------------------
-------------------------------------------------XX----------------------------------------------------------------------------------------------------
-------------------------------------------------XX----------------------------------------------------------------------------------------------------
-------------------------------------------------XX----------------------------------------------------------------------------------------------------
-------------------------------------------------XX----------------------------------------------------------------------------------------------------
-------------------------------------------------XX----------------------------------------------------------------------------------------------------
-------------------------------------------------XX----------------------------------------------------------------------------------------------------
-------------------------------------------------XX----------------------------------------------------------------------------------------------------
-------------------------------------------------XX----------------------------------------------------------------------------------------------------
------------------------------------------XXXXXXX:XXX:XXX----------------------------------------------------------------------------------------------
------------------------------------------X..:...:...:..X----------------------------------------------------------------------------------------------
------------------------------------------X..:...:...:..XXXXXXX----------------------------------------------------------------------------------------
------------------------------------------X.E:.E.:.E.:.EX----XX----------------------------------------------------------------------------------------
------------------------------------------XtttttttttttttX----XX---------XXXXXXX------------------------------------------------------------------------
------------------------------------------X.............X----XX---------X..Et.X------------------------------------------------------------------------
------------------------------------------XXXXXXXXXXXXXXX----XX---------X...t.X------------------------------------------------------------------------
-------------------------------------------------------------XX---------XE.Et.X------------------------------------------------------------------------
-------------------------------------------------------------XX---------XE..t.X------------------------------------------------------------------------
-------------------------------------------------------------XX---------X..Et.X------------------------------------------------------------------------
-------------------------------------------------------------XXXXXXXXXXXX..Et.X------------------------------------------------------------------------
-------------------------------------------------------------XXXXXXXXXXXX...t.X------------------------------------------------------------------------
-------------------------------------------------------------XX---------X:::::X------------------------------------------------------------------------
-------------------------------------------------------------XX---------X..Et.X------------------------------------------------------------------------
-------------------------------------------------------------XX---------X.E.t.X------------------------------------------------------------------------
-------------------------------------------------------------XX---------X..Et.X------------------------------------------------------------------------
-------------------------------------------------------------XX---------X...t.X------------------------------------------------------------------------
-------------------------------------------------------------XX---------X.EEt.X------------------------------------------------------------------------
------------------------------------------------------XXXXXXX:XXXXXXX---X...t.X------------------------------------------------------------------------
------------------------------------------------------X...:..:..::..X---X...t.X------------------------------------------------------------------------
------------------------------------------------------X.E.:E.:E.:.E.X---XXXXXXX------------------------------------------------------------------------
------------------------------------------------------X...:..:..:...X----------------------------------------------------------------------------------
------------------------------------------------------XtttttttttttttX----------------------------------------------------------------------------------
------------------------------------------------------X.............X----------------------------------------------------------------------------------
------------------------------------------------------XXXXXXXXXXXXXXX----------------------------------------------------------------------------------
