------------------------------XXXXXXXXXXXX-----------------------------------------------
-----------------------------X............XXXXXXXXXXX------------------------------------
----------------------------X.......................X------------------------------------
---------------------------X...W....................X------------------------------------
--------------------------X.........................X------------------------------------
-------------------------X..........................X------------------------------------
------------------------X................,,,,,,,....X------------------------------------
-----------------------X.........,,,,,,,,......,....X------------------------------------
----------------------X..........,.............,....X--XXXXXXXXXXXXXXXXXXXXXXXXXXXXXXXXXX
---------------------X..........,..............,....X--X................................X
---------------------X..........,..............,....X--X................................X
----------------------X......:..,..............,....X--X................................X
----------------------X.........,..............,....X--X..........................,,,,..X
-----------------------X.......,...............,....X--X..................,,,,,,,,...,..X
-----------------------X.......,................,....X-X...........,,,,,,,...........,..X
------------------------X......,................,....X-X...,,,,,,,,..................,..X
--------------XXXXXXX---X.....,.................,....X-X,,,,,,,,,,,,,,,,,,,,,,,,,,,..,..X
----------XXXX.......XXXX.....,.................,....X-X,,,,,,,,,,,,,,,,,,,,,,,,,,,..,..X
--------XX.............XX.....,.................,....X-X.,.,.,.,.,.,..,,,,,,.....,,..,..X
-------X...............XX.....,.................,....X-X.,.,.,.,.,.,..,,,,,,.....,,..,..X
-------X...............XX....,.........,,,,,,,,,,....X-X.,.,.,.,.,.,..,,,,,,.....,,..,..X
-------X....E....E....X-X....,,,,,,,,,,..............X-X.,.,.,.,.,.,..,,,,,,.....,,..,..X
-------X..............X--X...........................X-X.,.,.,.,.,.,..,,,,,,.....,,..,..X
-------X......,,,.....X--X...........................X-X.,.,.,.,.,.,..,,,,,,.....,,..,..X
-------X..,,,,..,.....X--X...........................X-X.,.,.,E,E,.,..,E,,,,.....,,..,..X
-----XXX,,.......,....X--X...........................X-X.,.,.,.,.,.,..,,,,,,.....>,..,..X
-XXXX............,....X--X.......,,,,XXXXXXXX,,,,XXXXX-X.,.,.,.,.,.,..,,,,,,..,..>,..,..X
-X...............,....X--XXXX,,,,....X------X....X-----X.,.,.,.,.,.,..,,,,,,,,,,.>,..,..X
--X...............,..X------X........X------X....X-----X.,.,.,.,.,.,..,,,,,,..,..>,..,..X
--X...............,..X------X........X------X....X-----X.,.,.,.,.,.,..,,,....E...,,..,..X
---X...............,.X------X........X------X....X-----X.E.,.,.,.,.,E.,,,,,,.....,,..,..X
---X....,,,,,,.....XXX-------X.......X------X....X-----X.,.,.,.,.,.,..,,,.,,.....,,..,..X
----X...XXXXX,.....X---------X........X-----X....X-----X.,.,.,.,.,.,..,,,,,,.....,,..,..X
----X...X---X,......X--------X........X-----X....X-----X.,.,.,.,.,.,..,,,,,,.....,,..,..X
-----X..X---X,......X-------X.XXXXX...X-----X....X-----X.,.,.,.,.,.,..,.,,,,.....,,..,..X
-----X..X---X,.......X------X.X---X...X-----X....X-----X.,.,.,.,.,.,..,,,,,,.....,,..,..X
----X...XXXXX,......XX-----X..X---X...X-----X....X-----X.,.,.,.,.,.,....,........,,..,..X
---X....,,,,,,...,XX------X...X---X...X-----X....X-----X.,.,.,.,.,.,.............,,..,..X
---X...........,,.:.XXXX--X...XXXXX..X------X....X-----X.,.,.,.,.,.,,,,,,,,,,,,,,,,..,..X
---X........,,,.........XX...........X------X....X-----X.,.,.,.,.,.,.,.,.,.,.,.,.,,..,..X
--X.......,,....A.A.................X-------X....X-----X.,.,.,.,.,.,.,.,.,.,.,.,.,,..,..X
--X........,...W...A...............X--------X....X-----X.,.,.,.,.,.,.,.,.,.,.,.,.,,..,.X-
--X.........,...A.................X---------X....X-----X.,.,.,.,.,.,.,.,.,.,.,.,.,,.,..X-
---X.........,,...A...............X---------X....X-----X.,.,.,.,.,.,.,.,.,.,.,.,.,,.,..X-
-XX....:.......,.................X----------X....X-----X.,.,.,.,.,.,.,.,.,.,.,.,.,,.,..X-
-X..............,............XXXX--XXXXXXXXXX....X-----X.,.,.,.,.,.,.,.,.,.,.,.,.,,.,..X-
-X<..............,....XXXXXXX------X.......XX....X-----X.,.,.,.,.,.,.,.,.,.,.,.,.,,.,..X-
-X................XXXX-------------X...W...XX....XXXXXXX.,.,.,.,.,.,.,.,.,.,.,.,.,,.,..X-
-X.............:...X---------------X.......XX....,.....,.,.,.,.,.,.,.,.,.,.,.,.,.,,.,..X-
X..:................X---------------X..H...XX....,.....,.,.,.,.,.,.,.,.,.,.,.,.,.,,.,..X-
X....................X--------------X......X-X...,.....,.,.,.,.,.,.,.,.,.,.,.,.,.,,.,..X-
-X.................XX---------------X..H...X-X...,.....,.,.,.,.,.,.,.,.,.,.,.,.,.,,.,..X-
-X...............XX---------XXXXXXX-X......X-X...,.....,.,.,.,.,.,.,.,.,.,.,.,.,.,,.,..X-
--X............,,.X--XXXXXXX......X-X..H...X-X...,.....,.,.,.,.,.,.,.,.,.,.,.,.,.,,.,..X-
--XX.........X,....XXX...,,,..,,,.X-X......X-X...,.....,.,.,.,.,.,.,.,.,.,.,.,.,.,,.,..X-
----XX.....XXX.......,...,.,..,.,.X-X..H...X-X...XXXXXXX.,.,.,.,.,.,.,.,.,.,.,.,.,,.,..X-
------XX.XX--X.......,...,,,..,.,.X-X......X-X...X-----X.,.,.,.,.,.,.,.,.,.,.,.,.,,.,..X-
--------X----X.......,........,.,.X-X..H...X-X...X-----X.,.,.,.,.,.,.,.,.,.,.,.,.,,.,..X-
-------------XXXXXXXXX........,,,.X-X......X-X...X-----X.,.,.,.,.,.,.,.,.,.,.,.,.,,.,..X-
---------------------XXXXXXXXX....X-X.....X--X...X-----X.,.,.,.,.,.,.,.,.,.,.,.,.,,.,..X-
-----------------------------X....X-X.....X--X...X-----X.,.,.,.,.,.,.,.,.,.,.,.,.,,.,..X-
-----------------------------X....X-X.....X--X...X-----X.,.,.,.,.,.,.,.,.,.,.,.,.,,.,..X-
-----------------------------X....X-X.....X--X...X-----X.,.,.,.,.,.,.,.,.,.,.,.,.,,.,..X-
-----------------------------X....X-X.....X--X...X-----X.,.,.,.,.,.,.,.,.,.,.,.,.,,.,..X-
-----------------------------X....X-X.....X--X...X-----X.,.,.,.,.,.,.,.,.,.,.,.,.,,.,..X-
-----------------------------X....X-X.....X--X...X-----X.,.,.,.,.,.,.,.,.,.,.,.W.,,.,..X-
-----------------------------X....X-X.....X--X...X-----X.,.,.,.,.,.,.,.,.,.,.,.,.,,.,..X-
-----------------------------X....X-X.....X--X...X-----X,,,,,,,,,,,,,E,,,,E,,,,,,,,.,..X-
-----------------------------X....X-X.....X--X...X-----X,,,,,,,,,,,,,,,,,,,,,,E,,,,.,..X-
-----------------------------X....X-X.....X--X...X-----X....,,,,,,,,,,..............,..X-
-----------------------------X....X-X.....X--X...X-----X..............,,,,,,,,,,....,..X-
-----------------------------X....X-X.....X--X...X-----X........................,,,,,..X-
-----------------------------X....X-X,,,,,X--X...X-----X................XXXXXXXXXXXXXXXX-
-----------------------------X....XXX+++++XXXX...X-----XXXXXXXXXXXXXXXXX-----------------
-----------------------------X....,..............X---------------------------------------
-----------------------------X....,............W.X---------------------------------------
-----------------------------X....,..............X---------------------------------------
-----------------------------XXXXXXXXXXXXXXXXXXXXX---------------------------------------
