--------------------XXXXXXXXXXXXXXXXXXXXXXXXXXXXXXXXXXXXXXXXXXXX---------------------------------------------------------------------------------------------------------
--------------------X..........................................X---------------------------------------------------------------------------------------------------------
--------------------X..........................................X---------------------------------------------------------------------------------------------------------
--------------------X..........................................X---------------------------------------------------------------------------------------------------------
--------------------X..........................................X---------------------------------------------------------------------------------------------------------
--------------------X..........................................X---------------------------------------------------------------------------------------------------------
--------------------X..........................................X---------------------------------------------------------------------------------------------------------
--------------------X..........................................X---------------------------------------------------------------------------------------------------------
--------------------X..........................................X---------------------------------------------------------------------------------------------------------
--------------------X.........,,,,,,,,,,,,,,,,,,,,,,,,,,,,,,,,,X---------------------------------------------------------------------------------------------------------
--------------------X.........,.....................,...,......X---------------------------------------------------------------------------------------------------------
--------------------X.........,.....................,...,......X---------------------------------------------------------------------------------------------------------
--------------------X.........,.....................,...,......X---------------------------------------------------------------------------------------------------------
--------------------X.........,.....................,...,......X---------------------------------------------------------------------------------------------------------
--------------------X.........,.....................,...,......X---------------------------------------------------------------------------------------------------------
--------------------X.........,.....................,...,......X---------------------------------------------------------------------------------------------------------
--------------------X.........,.....................,...,......X---------------------------------------------------------------------------------------------------------
--------------------X.........,.....................,...,......X---------------------------------------------------------------------------------------------------------
--------------------X.........,.....................,...,......X---------------------------------------------------------------------------------------------------------
--------------------X.........,.....................,...,......X---------------------------------------------------------------------------------------------------------
-------------------XX.........,.....................,...,......X---------------------------------------------------------------------------------------------------------
----------------XXX...........,.....................,...,......X---------------------------------------------------------------------------------------------------------
------------XXXX..............,.....................,...,......X---------------------------------------------------------------------------------------------------------
---------XXX..................,.....................,...,......X---------------------------------------------------------------------------------------------------------
------XXX.....................,.....................,...,......X---------------------------------------------------------------------------------------------------------
--XXXX.......................,,.....................,...,......X---------------------------------------------------------------------------------------------------------
XX.........................,,.,.....................,...,......X---------------------------------------------------------------------------------------------------------
X.......................,,,...,.....................,...,......X---------------------------------------------------------------------------------------------------------
X....................,,,......,.....................,...,......X---------------------------------------------------------------------------------------------------------
X..................,,.........,.....................,...,......X---------------------------------------------------------------------------------------------------------
X...............,,,...........,.....................,...,......X---------------------------------------------------------------------------------------------------------
X............,,,..............,.....................,...,......X---------------------------------------------------------------------------------------------------------
X..........,,.................,.....................,...,......X---------------------------------------------------------------------------------------------------------
X.......,,,...................,.....................,...,......X-------------------------------------------------------------------XXXXXXXXXXXXXXXXXXXXXXXXXXXXXXXXXXXXXX
X.....,,......................,.....................,...,......X-------------------------------------------------------------------X...............................,....X
X.....,.......................,.....................,...,......X-------------------------------------------------------------------X...............................,....X
X.....,.......................,.....................,...,......X-------------------------------------------------------------------X...............................,....X
X.....,.......................,.....................,...,......X-------------------------------------------------------------------X...............................,....X
X.....,.......................,.....................,...,......X-------------------------------------------------------------------X...............................,....X
X.....,.......................,.....................,...,......X-------------------------------------------------------------------X...............................,....X
X.....,.......................,.....................,...,......X-------------------------------------------------------------------X...............................,....X
X.....,.......................,.....................,...,......X-------------------------------------------------------------------X...............................,....X
X.....,.......................,,,,,,,,,,,,,,,,,,,,,,,,,,,,,,,,,X-------------------------------------------------------------------X...............................,....X
X.....,.......................,.....................,...,......X-------------------------------------------------------------------X...............................,....X
X.....,.......................,.....................,...,......X-------------------------------------------------------------------X...............................,....X
X.....,.......................,.....................,...,......X-------------------------------------------------------------------X...............................,....X
X.....,.......................,.....................,...,......X-------------------------------------------------------------------X...............................,....X
X.....,.......................,.....................,...,......X-------------------------------------------------------------------X...............................,....X
X.....,......................,,.....................,...,......X---------------------------------XXXXXXXXXXXXXXXXXXXXXXXXXXXXXXXX--X...............................,....X
X.....,....................,,.,.....................,...,......X---------------------------------XH...................E.E..E....X--X...............................,....X
X.....,.................,,,...,.....................,...,......X---------------------------------XHXXXXXXXXXXXXXXXXXXXXXXXXXXXX.X--X...............................,....X
X.....,..............XX,......,.....................,...,......X---------------------------------X.X-----------------XXXXXXXX-X.X--X...............................,....X
X.....,............XX-X.......,.....................,...,......X---------------------------------XHX---------XXXXXX--X......XXX.X--X...............................,....X
X.....,.........XXX---X.......,.....................,...,......X---------------------------------XHX---------X....X--X...E..,...X--X...............................,....X
X.....,......XXX------X.......,.....................,...,.......X--------------------------------X.X---------X....X--X..,,..XXXXX--X...............................,....X
X.....,....XX---------X......XX.....................,...,.......X--------------------------------XHX---XXXXXXX....XXXXX,H,,XXXXXXXXX...............................,....X
X.....,.XXX-----------X......XX.....................,...,.......X--------------------------------XHX---X....,,....................,,...............................,....X
XXXXXXXX--------------X.......,.....................,...,.......X--------------------------------X.X---X....,,....................,,...............................,....X
----------------------X.......,.....................,...,.......X--------------------------------XHXXXXX...E,,....................,,...............................,....X
----------------------X.......,.....................,...,.......X--------------------------------XH....,....,,....................,,...............................,....X
----------------------X.......,.....................,...,.......X--------------------------------X.XXXXX....XX........E..E.E......,,...............................,....X
----------------------X.......,.....................,...,.......X--------------------------------XHX---XXXXXXX....................,,...............................,....X
----------------------X.......,.....................,...,.......X--------------------------------XHX---------X....................,,...............................,....X
----------------------X.......,.....................,...,.......X--------------------------------X.X---------X....................,,...............................,....X
----------------------X.......,.....................,...,.......X--------------------------------XHX---------X....................,,...............................,....X
----------------------X.......,.....................,...,.......XXXXXXXXXXXXXXXXXXXXXXXXXXXXXXXXXX,XXXXXXXXXXX,,,,,,,,,,,,,,,,,,,,,,,,,,,,,,,,,,,,,,,,,,,,,,,,,,,,,,,,,,X
----------------------X.......,.....................,...,.......XXXXXXXXXXXXXXXXXXXX,XXXXXXXXXXXXX,,,,,,,,,,,,,,,,,,,,,,,,,,,,,,,,,,,,,,,,,,,,,,,,,,,,,,,,,,,,,,,,,,,...X
----------------------X.......,.....................,...,.......XXXXXXXXXXXX-XXHXX<X,XXXXXXXXXXXXX+XXXX,,,,,,,,,,,,,,,,,,,,,,,,,,,,,..............................,,,...X
----------------------X.......,.....................,...,.......X.........X,XX,.TXXT,XX:HX......XX+XH,X.,........................:.,..............................,,,...X
----------------------X.......,.....................,...,.......X...........XX,XXXXX,XXE.X......X.......,..........................,........E..E..E...............,,,...X
----------------------X.......,.....................,...,.......X............X,XXXXX.XX+XX......L.......,..........................,..............................,,,...X
----------------------X.......,.....................,...,.......,....E.......X.......XX+XX......X.......X..........................,.............................,,,,...X
----------------------X.......,.....................,...,.......,............X.......XX..X......X,,,,,,,X..........................,........E..E..E..............,,,,...X
----------------------X.......,.....................,...,.......,............XX+XXXXXXX+XX......X..................................,............................,,,,,...X
----------------------X.......,.....................,...,.......X............X...X..............,..................................,,,,,,,,,,,,,,,,,,,..........,,,,,...X
----------------------X.......,.....................,...,.......,.W..........+...+..............,.E................................,..........,......,.E.E.....,,,,,,...X
----------------------X......XX.....................,...,.......X............X...X..........A.W.X..................................,..........,......,.......,,..,,,,...X
----------------------X.......,.....................,...,.......XXXXXX+XXXX+XX...X..............X..................................,..........,......,.E.E.,,...A,,,,...X
----------------------X.......,.....................,...,.......XXXXXX,XXXX+XXX..XXXXXXXXXXXXXXXX..................................,..........,......,...,,,,,,,,,,,,...X
----------------------X.......,.....................,...,.......X.............X..X,,.E,,XK......X.E.,,,,,,,,,,,,,,,,,,,,,,,,,,,,,,,,..........,.....,,,,,,,,,,,,,,,,,...X
----------------------X.......,.....................,...,.......,.............X..X,XXXX.X.......X...,..,,,,,,,,,,,,,,,,,,,,,,,,,,,,,..........,....,.,,...........,,,...X
----------------------X.......,.....................,...,.......X.............X..XEXX,X,X.......,.E.,..,,,,,,,,,,,,,,,,,,,,,,,,,,,,,..........,...,..,.,........,,.,,...X
----------------------X.......,.....................,...,.......,.............X..XEXX>X,X.......,...,..,,,,,,,,,,,,,,,,,,,,,,,,,,,,,..........,..,...,.E,......,.:.,,...X
----------------------X.......,.....................,...,.......,.............+..X,XXEX,X.......XE..,..,,,,,,,,,,,,,,,,,,,,,,,,,,,,,W..A......,.,....,...,....,....,,...X
----------------------X.......,.....................,...,.......,.:.B..:......XX,XEXX.X,X.......X...,..,,,,,,,,,,,,,,,,,,,,,,,,,,,,,..........,,.....,....,.,,.....,,...X
----------------------X.......,.....................,...,.......,....:........XX,X...X..X.......X...,..,,,,,,,,,,,,,,,,,,,,,,,,,,,,,,,,,,,,,,,,,.....,.E...,.......,,...X
----------------------X.......,.....................,...,.......X...:..:......X..X.E.X.AX.......X...,..,,,,,,,,,,,,,,,,,,,,,,,,,,,,,,................,....,........,,...X
----------------------X.......,.....................,...,.......X....:........X...XXXXLXX.......LE..,..,,,,,,,,,,,,,,,,,,,,,,,,,,,,,,................,.E.,.........,,...X
----------------------X.......,.....................,...,.......X...B..:......X.........X.......LE..,..,,,,,,,,,,,,,,,,,,,,,,,,,,,,,E................,..,..........,,...X
----------------------X.......,.....................,...,.......X.............X........H,.......X...,..,,,,,,,,,,,,,,,,,,,,,,,,,,,,,,................,.,...........,,...X
----------------------X.......,.....................,...,.......X.............X.........X.......X...,..,K,,,,,,,,,,,,,,,,,,,,,,,,,,,,,,,,,,,,,,,,,,,,,,............,,...X
----------------------X.......,.....................,...,.......X.............X..XX+XXXXXXXXXXXXX,,,,..,,,,,,,,,,,,,,,,,,,,,,,,,,,,,,,,,,,,,,,,,,,,,,,,,,,,,,,,,,,,,,...X
----------------------X.......,.....................,...,.......XXXXXXXXXXXXXXX..X..............X,,................................,..................,....,.......,,...X
----------------------X.......,.....................,...,.......X.............X.AX..............X..,,.............................,...................,...,........,,...X
----------------------X.......,.....................,...,.......X.............X..X..............,....,,...........................,....................,..,......:.,,...X
----------------------X......XX.....................,...,.......X.............+.AX..............,......,,.........................,.....................,.,........,,...X
----------------------X.......,.....................,...,.......,.............XXXX..............X........,,.......................,.....................,,......:..,,...X
----------------------X.......,.....................,...,.......,..E..........XXXX..............X..E.......,.....................,.......................,......:..,,...X
----------------------X.......,.....................,...,.......,.............X+.+..............,...........,,...................,.....................,,..........,,...X
----------------------X.......,.....................,...,.......X.............XXXX..............,.............,,.................,....................,....::.:....,,...X
----------------------X.......,.....................,...,.......X.............XXXX..............X...,,,,,,,.....,,...............,..................,,.:.:.........,,...X
----------------------X.......,.....................,...,.......X.............,W+X.....XXX....E.X...,,,,,,,.......,,............,.................,,...............,,...X
----------------------X.......,.....................,...,.......XXXXXXXXXXXXXXXX+XXXXXXX-XXXXXXXX,,,,,,,,,,,,,,,,,,,,,,,,,,,,,,,,,,,,,,,,,,,,,,,,,,,,,,,,,,,,,,,,,,,,,,,X
----------------------X.......,.....................,...,.......XXXXXXXXXXXXXXXXXXXXXXXXXXXXXXXXXXXXXXXXXXXXXXXXXXXXXXXXXXXXXXXXXXXXXXXXXXXXXXXXXXXXXXXXXXXXXXXXXXXX...X-
----------------------X.......,.....................,...,.....XXXXXXXXXXXXXXXXXXXXXXXXXXXXXXXXXXX-------------------------------------------------------------------XX.X-
----------------------X.......,.....................,...,.....X-X..X,,,......XXT,,,,,X....,,,+H,X---------------------------------------------------------------------X--
----------------------X.......,.....................,...,.....X-X..X,,,......XX,,,,,,X.E..,,,XXXX------------------------------------------------------------------------
----------------------X.......,.....................,...,.....X-X..X,,,..E...XX,,,,,,X....,,,X---------------------------------------------------------------------------
----------------------X.......,.....................,...,.....X-X..X,,,......XX......X....,,,X---------------------------------------------------------------------------
----------------------X.......,.....................,...,.....X-X..X,,,......XX......X.E..,,,X---------------------------------------------------------------------------
----------------------X.......,.....................,...,.....X-X..X,,,......XX.XXXXXX....,,,X---------------------------------------------------------------------------
----------------------X.......,.....................,...,.....X-X..X,,,......XX.XXXXXX....,,,X---------------------------------------------------------------------------
----------------------X......XX.....................,...,.....X-X.,X,,,.......+..+..E..E..,,,XX--------------------------------------------------------------------------
----------------------X......XX.....................,...,.....X-X.,X,,,.......+..+........,,,XX--------------------------------------------------------------------------
----------------------X.......,.....................,...,.....X-X.,,.........XX..X........,..,X--------------------------------------------------------------------------
----------------------X.......,.....................,...,.....X-X.,,.........XX..X........,..,X--------------------------------------------------------------------------
----------------------X.......,.....................,...,.....X-X.,XXXXXXXXXXXX..XXXXXXXXXXXXXX--------------------------------------------------------------------------
----------------------X.......,.....................,...,.....X-X.,XXXXXXXXXXXX..XXXXXXXXXXXXX---------------------------------------------------------------------------
----------------------X.......,.....................,...,.....X-X..X,,,......XX..X,,.,,,,,X..X---------------------------------------------------------------------------
----------------------X.......,.....................,...,.....X-X..X,,,......XX..X,.XXXX.,X..X---------------------------------------------------------------------------
----------------------X.......,.....................,...,.....X-X..X,,,.......+..X,,XXXX,,X..X---------------------------------------------------------------------------
----------------------X,,,,,,,,.....................,...,.....X-XXXX,,,.E....XX..X,,X:.X,,X..X---------------------------------------------------------------------------
----------------------X.......,.....................,...,.....X-X,.,,,,......XX..X..XX+X.,X..X---------------------------------------------------------------------------
----------------------X.......,.....................,...,.....X-X,.,,,,......XX..+..X..+,,,..X---------------------------------------------------------------------------
----------------------X.......,.....................,...,.....X-X,E,,,,......XX..X..X..X.,,..X---------------------------------------------------------------------------
----------------------X........,....................,...,.....X-X,.,,,,.E....XX..X..XXXXXXXXXX---------------------------------------------------------------------------
----------------------X........,....................,...,.....X-X,.,,,,......XX..XXXX------------------------------------------------------------------------------------
----------------------X........,....................,...,.....X-X,.,,,,......XXA.,,KX------------------------------------------------------------------------------------
----------------------X,,,,,,,,,,,,,,,,,,,,,,,,,,,,,,,,,,,,,,,X-XXXX,,,......XX..XXXXXXXXXXXXXXXX------------------------------------------------------------------------
----------------------X........,....................,...,.....X-X--X,,,......XXA.X........,,,,XXX------------------------------------------------------------------------
----------------------X........,....................,...,.....X-X--X,,,......XXA.+........,,,,XXX------------------------------------------------------------------------
----------------------X........,....................,...,.....X-X--X,,,......XX..X........,,,,XXX------------------------------------------------------------------------
----------------------X........,....................,...,.....X-XXXXXXXXXXXXXXX+XX........X,,XXXX------------------------------------------------------------------------
----------------------X.........,...................,...,.....X-X,XX,,,..........X...........XXXX------------------------------------------------------------------------
----------------------X.........,...................,...,.....X-X,XX.............X...........,XXX------------------------------------------------------------------------
----------------------X.........,...................,...,.....X-X,XX.............X....E......,XXX------------------------------------------------------------------------
----------------------X.........,...................,...,.....X-X,XX,,,..........X........X,,XXXX------------------------------------------------------------------------
----------------------X.........,...................,...,.....X-X,,,,,,..........X........X,,,XXX------------------------------------------------------------------------
----------------------X.........,...................,...,.....X-X,,,,,,..........X........,,,,XXX------------------------------------------------------------------------
----------------------X.........,...................,...,.....X-X,,,,,,..........X........,,,,XXX------------------------------------------------------------------------
----------------------X.........,...................,...,.....X-X,,,,,,....E.....X........,,,,XXX------------------------------------------------------------------------
----------------------X.........,...................,...,.....X-X,,,,,,..........X........,,,,XXX------------------------------------------------------------------------
----------------------X.........,...................,...,.....X-X,,,,,,....E.....X........,,,,XXX------------------------------------------------------------------------
----------------------X..........,..................,...,.....X-X,,,,,,..........X........,,,,XXX------------------------------------------------------------------------
----------------------X..........,..................,...,.....X-X,,,,,,..........X........,,,,XXX------------------------------------------------------------------------
----------------------X..........,..................,...,.....X-XXXXXXXXXXXXXXXXXXXXXX,XXXXXXXXXX------------------------------------------------------------------------
----------------------X..........,..................,...,.....X-------------XXXXXXXXXX,XXXX------------------------------------------------------------------------------
----------------------X..........,..................,...,.....X----------XXX...............XXX---------------------------------------------------------------------------
----------------------X..........,..................,...,.....X-------XXX.....................XX-------------------------------------------------------------------------
----------------------X..........,..................,...,.....X-----XXXXXXXXXXXXXXXXXXXXXXXXXXXXXX-----------------------------------------------------------------------
----------------------X..........,..................,...,.....X----------------------------------------------------------------------------------------------------------
----------------------X..........,..................,...,.....X----------------------------------------------------------------------------------------------------------
----------------------X..........,..................,...,.....X----------------------------------------------------------------------------------------------------------
----------------------X...........,.................,...,.....X----------------------------------------------------------------------------------------------------------
----------------------X...........,.................,...,.....X----------------------------------------------------------------------------------------------------------
----------------------X...........,.................,...,.....X----------------------------------------------------------------------------------------------------------
----------------------X...........,.................,...,.....X----------------------------------------------------------------------------------------------------------
----------------------X,,,,,,,,,,,,,,,,,,,,,,,,,,,,,,,,,,,,,,,X----------------------------------------------------------------------------------------------------------
-----------------------XX...................................XX-----------------------------------------------------------------------------------------------------------
-------------------------XX...............................XX-------------------------------------------------------------------------------------------------------------
---------------------------XX...........................XX---------------------------------------------------------------------------------------------------------------
-----------------------------XX.......................XX-----------------------------------------------------------------------------------------------------------------
-------------------------------XX....................X-------------------------------------------------------------------------------------------------------------------
---------------------------------X.................XX--------------------------------------------------------------------------------------------------------------------
----------------------------------XX.............XX----------------------------------------------------------------------------------------------------------------------
------------------------------------XX.........XX------------------------------------------------------------------------------------------------------------------------
--------------------------------------XX.....XX--------------------------------------------------------------------------------------------------------------------------
----------------------------------------XX.XX----------------------------------------------------------------------------------------------------------------------------
------------------------------------------X------------------------------------------------------------------------------------------------------------------------------
