--------------XXXXX--------------------------------------------------------------------
-------------X..,,X--------------------------------------------------------------------
-----------XX...,.X--------------------------------------------------------------------
----------X,,...,.X--------------------------------------------------------------------
----------X.,...,.X--------------------------------------------------------------------
----------X.,...,.X--------------------------------------------------------------------
----------X.,...,.X--------------------------------------------------------------------
----------X.,...,.X--------------------------------------------------------------------
----------X.++++,.X--------------------------------------------------------------------
----XXXXX-X.,...,.X--------------------------------------------------------------------
----X...X-X.,...,.X----------------------------------------------------XXXXXXXX--------
----X,,,XXX,,E,.,,X-XXXXXXXXX-----------------------------------------X........XX------
XXXXX.......,.,...X-X.......X----------------------------------------X........LL,X-----
XEE,,.....,,,,,,,.XXX,,,,,,,XXX-------------------------------------X....XXXXLL..,XXX--
X.E,,.....,.,.,.,...+E......,.X---XXXXXXXXXXX-----------------------X....X---X...,XXX--
XE.,,.....,,,,,,,...+.......,.X---H.........X---------------------XXX...X-----X..,XXX--
H.E,,...E...E.,.....+E......,.X---A.E..E,,,,X---------------------X.t...X-----X..,XXX--
XXXXX,,,XXX.,,XXXXXXX,,,,...,.X---X...H.,,,,X---------AXXAX-------XXX...X-XXXXX..,X-XX-
----X...X-X...X-----X...,...,.X---A,,,,,,,,,X---------XEAEX---------X...X-H,,XX..,X-XX-
----XXXXXXX...XXX---XXXXX...XXX-XXX,,,,,,,,,X:X-------X.H.X----XXXXXX,,,XXX.AXX.E,X-XX-
--------X.,...,.X-------X...X--XE..........E..X-------XE.EXXXXX:...,....,WE,XXXE.,X-XX-
--------X.,...,.X---XXXXX+++X--X.,XXX,,,XXX...X------XX,,,XA.AXX...,....,XXXH-X,,,XXX--
--------X.,.E.,.X--X.E......XXX..,X-X...X-X...X------X:...XXE.,,...,....,X---X....XX---
--------X.,...XXXXX.,,,,,,,.,+,..,XXX...XXX...XXXXXXXX....,,..,,...,....,X--X......XHHX
--------X.,...X-X.H.E....W,.,+,..,,,,,,,,,,...,,,,,,+,....,,E.,,...,....,X--X,,,,,,,.:X
--------XXX,,,X-XXX.,,,,,,,.,+,...............,,,,,,+,....,,..XX...,....,X--X,....,,,,X
----------X,E,X---XX.E......XXX.............E.,,,,,,+,....XXXXXX...,....,X--X,....,,,,X
----------E..HX-----X,,,,,,,X-X...XX..........,,,,,,XX....X---X....,....,X--X,....,,,,X
----------XXXXX-----X.......X-X,,,XXX,,,,,XXXXXXXXXXXX....X--X....E,....,X--X,....,,,,X
--------------------XXXXXXXXX-X+++XXX,,,,,XXXXXX-----X..:.XXXX..E..,....,X--X,....,,..X
------------------------------XE...XH.........EXXXXXXX....XXE,.....XXXXX,X--X,,,,,,,..X
---------XXXXXXXXXXXXX--------X....XA..........XXHtttXXX...HA,....,.XXXX.X--XX..E..,E.X
---------X,,,,,,,,,,.X--------X....XX.E........XX.tTt..XX..XE,...,..,..,EXXXXXX,,,,...X
---------X..........,X--------X....XA..........XX.ttt.HXX..XA,,XX....XXX,XX.,........HX
---------X..........,X--------X....X-X.........XX......XX..X..EXX....X-X.++.,..E.E..XX-
---------XXXX,,,,,,XXX--------X....X-X,,,,,,,..XX....E.XX.EXHXXA-X....XXXXXXXXXXX,,X---
-----------X.......A.X--------X....X-X......,..XX.....XXX..X-----X....X---------X,,XX--
-----------X........A.X-------X....X-X......,..+,...XXXXXE,XXXX---X,,,XXXXXXXXX-H...X--
----------X<.........:,XXXXXXXX....XXX,,,,,,,..+,...XX..,..,.HX---X...XX..,H,AX-X...X--
---------XX.........,,.,..E.......:XK,......,E.+,...XX..,..,.HX---X...,,.H,,,AX-X...X--
---------X,<........,,.,...........XXX,,,,,,,..XX...XX..,..,..X---X...,,H.H.A.X-X...X--
---------X,.........,,.,...........X-X......,..XX...XX..,..,..X---X...XXXXXX,,X-X,,,X--
---------X,<.........,,,....E......X-X......,..XX..EXXE.,..,..X---X.T.X----X..X-X..HX--
---------XX.<....,,,,.,XXXXXXXX....X-X,,,,,,,..XXHAXXX..,..,..XXXXX,,,XXXXXX..XXX...X--
----------HXXXX.,....,:X------X....X-H.........XXXH--X,,...,E.XXE..E.....HXX..,.....X--
---------------X,.W..,X-------X....XXX.........,E.X--X.....,..XX,,,,,..,..XX.,......X--
----------------X,,,,X--------X....,,,.E..E....,.EH--X......,,XX,...,:.,,:XX.,.H...:X--
----------------X....X--------X....,,,.........,EAXXX.....E...XX,...,..,.,X-XXXXXXXX---
----------------X....X--------X....,,,.........XXXX....XXX....XX,...,.,,,,X------------
----------------X....X--------X....XXX.........XX......X-X....XX,...,.,,,,XXXXXXXXX----
----------------H....X--------X.E..X-XXXXX,,,XXXX.....X--H.H.AXX,...,.,...,,..H...X----
---------------X...HX---------X....X----XX,,,XXXX,,,XXX--X,,,XXX,...,.,...XX......X----
--------------X..A..X---------XX,,XX----E.......,...,.X--XHH,X-X,...,.,...X-XXX...X----
--------------X.....X----------X..X-----XXXXXXXXXXX,,.X-A...HX-X,,,,,.,.E.X---X...X----
--------------X....X---------XXX,,XXXXXXXXXXX-----X...XX...W.X-X......,...X---X...X----
-------------XH.A..X---------X:.,,,...,,,....XX---X....++AXXHX-X......,.E.X---X...X----
-------------X....X----------X..,.,...,.,......X--X.....+X-----X......,..KX---X...X----
-------------X...X-----------X..,,,...E,,.......X-X...E..X--XXXX......,E..X---XX>>X----
-------------X...X-----------XH,,,,,XXX..........:X:......XXtTt.......,.XX-------------
-------------X.A.H------------XXXXXXX--XX...,,,,,XX,,,,,E.,,ttt..,XXX.XX---------------
-------------X....XX---------------------X..,.E.,XX,,...,.,,.....,X-X.X----------------
-------------XH.....XXXXXXXXXXXX---------X..,...,XX,E...,.,,.....,XXXHX----------------
-------------X....A......H,...H.X--------X..,...,X-X,...E.,,......,,,HX----------------
--------------X........A..,A.....X--------X.,,,,,X-X,,,,,.,,........EX-----------------
---------------XX.........,....A.HX-------X......X--XXXAXHXX.......:.X-----------------
-----------------XHX..H...,..H....X------X,,,,,,,X----------XX,,,,XXX------------------
--------------------XXXXXXXXXXXX..X------X.......X-----------X,,,,XXXXXX---------------
--------------------------------X+XXXXXXX........X-XXXXXXXX--X....,E..HX---------------
-------------------------------XX...,............X-XH...E,X--X....,..E.X---------------
-------------------------------X,E..,:,,,,,,,....X-XXE,,,,X--X....,E..AX---------------
-------------------------------X,...,.,.....,...X--X..,.,,X--X....,E.EHX---------------
-------------------------------X,.E.,.,.....,...XXX...,.,XX-X.....,...AX---------------
-------------------------------X,...,.,.....,..XH++.E.,.,XXX......,E...X---------------
-------------------------------XH...,.,.....,.AXA++...,,,,.......,.E.EHX---------------
-------------------------------X,.E.,.,.....,.AX.++......,.....,,...E.X----------------
-------------------------------X,,,,,.,,,,,,E..XHHX..:...,E...,,..E.AX-----------------
-------------------------------XX:.............X--XA,,XXXXXXXX,.E..AX------------------
--------------------------------XXX,XXXXXXXXXX:X---X..X------X.E..E.X------------------
----------------------------------X.X--------------X..X-------X..E.X-------------------
----------------------------------X.X--------------X..X-------X.H.X--------------------
----------------------------------X.XXXXXXXXXXXXXXXX..X--------X.X---------------------
----------------------------------X.,,,,L,,,,,,,,.,E,,X---------X----------------------
----------------------------------X.,,,,L,,,,,,,,.,...X--------------------------------
----------------------------------X.,E,,L,,,,,,,,.E,,,X--------------------------------
-----------------------------------XXXXXXXXXXXXXXXXXXXX--------------------------------
