---------------------XXXXXXXXXXXXXXX---XXXXXXXXXXXXX-----------------------
---------------------X..........tttX---X...........X-----------------------
---------------------X.H........tTtX---X.....K.....X-----------------------
---------------------X..........tttX---X...........X-----------------------
---------------------X.............X---X...........X-----------------------
---------------------X.............X---X...........X-----------------------
---------------------X.............X---X...........X-----------------------
XXXXXXXXXXXXX--------X.............X---X...........X-----------------------
X...........X--------X.............X---XXXXX...XXXXX--XXXXXXXXXXXXX--------
X...ttt.....X--------X.............X-------XLLLX------X.......ttt.X--------
X...tTt.....X--------X.............X-------X,,,X------X..H....tTt.X--------
X...ttt.....X--------X......W......X-XXXXXXX...XXXXXXX-X......ttt.X--------
X...........X--------X............,.X.................X.,.........X--------
X...........X--------X..A........,.,..ttt...ttt...ttt..,.,........X--------
X...........X--------X..........,.,...tTt...tTt...tTt...,.,.......X--------
X...........X--------X.........,.,....ttt...ttt...ttt....,.,......X--------
X...........X--------X........,.,.........................,.,.....X--------
X...H...E...X--------XXXXXXXXX.,...........................,.X....X--------
X...........X-----------------X.............................X-XXXXX--------
X,,,,,,,,,,,X----------------X..........H....E....H..........X-------------
X...........X----------------X...............................X-------------
X,,,,,,,,,,,X-XXXXXXXXXXXXX--Xttt.........................tttX----XXXXXXX--
X...........X-X...........X--XtTt.........................tTtX----X.....X--
X...H...E...X-X.ttt.......X--Xttt.........................tttX----X.ttt.X--
X...........X-X.t.t.......X--X...............................X----X.tTt.X--
X...........X-X.ttt.......XXXX...............................XXXXXX.ttt.X--
X...........X-X............L,.................................,,........X--
X...........X-X............L,.................................,,........X--
X...........X-X............L,.................................,,........X--
X...ttt.....X-X...........XXXX.............A.E.A.............XXXXXX.ttt.X--
X...tTt.....X-X...........X--X...............................X----X.t.t.X--
X...ttt.....X-X...........X--Xttt.........................tttX----X.ttt.X--
X...........X-X...........X--XtTt.........................tTtX----X.....X--
XXX,,,,,,,XXX-XXXXX+++XXXXX--Xttt.........................tttX----XXXXXXX--
--X.......X-------X,,,X------X...............................X-------------
XXX,,,,,,,XXX-XXXXX...XXXXX--X...............................X-------------
X...........X-X...........X---X.............................X-X------------
X.......ttt.X-X.ttt.......XXXX.,...........................,.X.X-----------
X.......tTt.X-X.t.t.......XX..,.,.........................,.,...X----------
X.......ttt.X-X.ttt.......XX...,.,....ttt.........ttt....,.,..,,,X---------
X...........X-X...........XX....,.,...tTt.........tTt...,.,...,T,.X--------
X...........X-X...........XX.....,.,..ttt..A...:..ttt..,.,....,,,..X-------
X...........X-X...........XX......,.X.................X.,...........X------
X.K.........X-X.......ttt.XX.......XXX,,,,,,,,,,,,,,,X-X.............X-----
X...........X-X.......t.t.XX.......XX....,.......,....X.............X------
X...........X-X.......ttt.XX.......XX....,...W...,.....,..K........X-------
X...........X-X...........XX.......XX....,.......,......,.........X--------
XXXXXXXXXXXXX-XXX,,,,,,,XXXX.......XX....,.......,.......,.......X---------
----------------X.......X--X.......XX....,.......,........,.....X----------
XXXXXXXXXXXXX-XXX,,,,,,,XXXX....tttXX....,.......,.........,...X-----------
X...........X-X...........XX....tTtXX....,.......,..........,.X------------
X.A.........X-X.ttt.......XX....tttXX....,.......,...........X-------------
X...........X-X.tTt.......XX.......XX....,.......,............X------------
X...........X-X.ttt.......XXXXXX++XXX....,.......,.............X-----------
X...........X-X...........X---------X....,.......,.............X-----------
X...........X-X...........X---------X....,...H...,.............X-----------
X...........X-X...........X---------X...,,.......,,............X-----------
X.......ttt.X-X...........X---------X..,.,.,,,,,.,.,...........,X----------
X.......tTt.X-X...........X---------X..,.,.,,,,,.,.,...........,X----------
X.......ttt.X-X.........E.X---------X..,.,.,,,,,.,.,...........,X----------
X...........X-X...........X---------X..,.,.,,,,,.,.,...........,X----------
XXXXXXXXXXXXX-XXXXXXXXXXXXX---------X..,.,,,,,,,,,.,...........,X----------
------------------------------------X..,.,,.....,,.,............X----------
XXXXXXXXXXXXX-XXXXXXXXXXXXX---------X..,.,,XX,X.,,.,............,X---------
X...........X-X...........X---------X..,.,,XX,X.,,.,............,X---------
X.......ttt.X-X.......ttt.X---------X..,.,,XX.X.,,.,............,X---------
X.......tTt.X-X.......tTt.X---------X...,,,XX.X.,,,.............,X---------
X.......ttt.X-X.E.....ttt.X---------X..XXXXXX,XXXXXX............,X---------
X...........X-X...........X---------X..X----X>>----X............,X---------
X...........X-X...........X---------X..X-----------X............,.X--------
X...........X-X...........X---------X..X-----------X............,.X--------
X...........X-X...........X---------X..X-----------X............,.X--------
X...........X-X...........X---------X..X-----------X............,.X--------
X.A.........X-X.......E...X---------X..X-----------X............,.X--------
X...........X-X...........X---------X..X-----------X............,.X--------
XXXXXXXXXXXXX-XXXXXXXXXXXXX---------X..X-----------X............,.X--------
------------------------------------X..X-----------X............,..X-------
------------------------------------X..X-----------X............,..X-------
------------------------------------X..X-----------X............,..X-------
------------------------------------X..XXXXXXXXXXXXX.............,.X-------
------------------------------------X............................,.X-------
-----------------------------------X,............................,.X-------
-----------------------------------X.............................,..X------
-----------------------------------X.............................,..X------
----------------------------------X,.............................,..X------
----------------------------------X,.............................,..X------
----------------------------------X..............................,..X------
---------------------------------X,,,,,,,,,,,,,,,,,,,,,,,,,,,,,,,,..X------
---------------------------------X...................................X-----
---------------------------------X...................................X-----
--------------------------------X....................................X-----
--------------------------------XXXXXXXXXXXXXXXXXXXXXXXXXXXXXXXXXXXXXX-----
---------------------------------------------------------------------------
---------------------------------------------------------------------------
---------------------------------------------------------------------------
---------------------------------------------------------------------------
---------------------------------------------------------------------------
---------------------------------------------------------------------------
---------------------------------------------------------------------------
---------------------------------------------------------------------------
---------------------------------------------------------------------------
---------------------------------------------------------------------------
---------------------------------------------------------------------------
---------------------------------------------------------------------------
---------------------------------------------------------------------------
---------------------------------------------------------------------------
---------------------------------------------------------------------------
---------------------------------------------------------------------------
---------------------------------------------------------------------------
---------------------------------------------------------------------------
---------------------------------------------------------------------------
---------------------------------------------------------------------------
---------------------------------------------------------------------------
---------------------------------------------------------------------------
---------------------------------------------------------------------------
---------------------------------------------------------------------------
---------------------------------------------------------------------------
---------------------------------------------------------------------------
---------------------------------------------------------------------------
---------------------------------------------------------------------------
---------------------------------------------------------------------------
---------------------------------------------------------------------------
---------------------------------------------------------------------------
---------------------------------------------------------------------------
---------------------------------------------------------------------------
---------------------------------------------------------------------------
---------------------------------------------------------------------------
---------------------------------------------------------------------------
---------------------------------------------------------------------------
---------------------------------------------------------------------------
---------------------------------------------------------------------------
---------------------------------------------------------------------------
---------------------------------------------------------------------------
---------------------------------------------------------------------------
----------------------------------------------------------------XXXX-------
-----------------------------------------------------------XXXXX...X-------
---------------------------------------------------------XX........X-------
-------------------------------------------------------XX...........X------
----------------------------------------------------XXX.............X------
--------------------------------------------------XX................X------
------------------------------------------------XX..................X------
---------------------------------------------XXX.....................X-----
-------------------------------------------XX........................X-----
-----------------------------------------XX..........................X-----
--------------------------------------XXX............................X-----
------------------------------------XX................................X----
----------------------------------XX..................................X----
--------------------------------XX,,,,,,,,,,,,,,,,,,,,,,,,,,,,,,,,,,,,X----
--------------------------------X.....................................X----
--------------------------------X.ttt.ttt.ttt.ttt.ttt.ttt.ttt.ttt.ttt.X----
--------------------------------X.t.t.t.t.t.t.t.t.t.t.t.t.t.t.t.t.t.t.X----
----------------------------XXXXX.ttt.ttt.ttt.ttt.ttt.ttt.ttt.ttt.ttt.XXXXX
----------------------------X.............................................X
----------------------------X.ttt.,,,,,,,,,,,,,,,,,,,,,,,,,,,,,,,,,,,.ttt.X
----------------------------X.t.t.,.................................,.t.t.X
----------------------------X.ttt.,.,,,,,,,,,,,,,,,,,,,,,,,,,,,,,,,.,.ttt.X
----------------------------X.....,.,.............................,.,.....X
----------------------------X.ttt.,.,.,,,,,,,,,,,,,,,,,,,,,,,,,,,.,.,.ttt.X
----------------------------X.t.t.,.,.,.........................,.,.,.t.t.X
----------------------------X.ttt.,.,.,.,,,,,,,,,,,,,,,,,,,,,,,.,.,.,.ttt.X
----------------------------X.....,.,.,.,.....................,.,.,.,.....X
----------------------------X.ttt.,.,.,.,.,,,,,,,,,,,,,,,,,,,.,.,.,.,.ttt.X
----------------------------X.t.t.,.,.,.,.,.................,.,.,.,.,.t.t.X
----------------------------X.ttt.,.,.,.,.,.E.E.E.E.E.E.E.E.,.,.,.,.,.ttt.X
----------------------------X.....,.,.,.,.,.................,.,.,.,.,.....X
----------------------------X.ttt.,.,.,.,.,.E.............E.,.,.,.,.,.ttt.X
----------------------------X.t.t.,.,.,.,.,....E.E.E.E.E....,.,.,.,.,.t.t.X
----------------------------X.ttt.,.,.,.,.,.E.............E.,.,.,.,.,.ttt.X
----------------------------X.....,.,.,.,.,....E.E.E.E.E....,.,.,.,.,.....X
----------------------------X.ttt.,.,.,.,.,.E.............E.,.,.,.,.,.ttt.X
----------------------------X.t.t.,.,.,.,.,....E.E.E.E.E....,.,.,.,.,.t.t.X
----------------------------X.ttt.,.,.,.,.,.E.............E.,.,.,.,.,.ttt.X
----------------------------X.....,.,.,.,.,....E.E.E.E.E....,.,.,.,.,.....X
----------------------------X.ttt.,.,.,.,.,.E.............E.,.,.,.,.,.ttt.X
----------------------------X.t.t.,.,.,.,.,....E.E.E.E.E....,.,.,.,.,.t.t.X
----------------------------X.ttt.,.,.,.,.,.E.............E.,.,.,.,.,.ttt.X
----------------------------X.....,.,.,.,.,.................,.,.,.,.,.....X
----------------------------X.ttt.,.,.,.,.,.E.E.E.E.E.E.E.E.,.,.,.,.,.ttt.X
----------------------------X.t.t.,.,.,.,.,.................,.,.,.,.,.t.t.X
----------------------------X.ttt.,.,.,.,.,,,,,,,,,,,,,,,,,,,.,.,.,.,.ttt.X
----------------------------X.....,.,.,.,.....................,.,.,.,.....X
----------------------------X.ttt.,.,.,.,,,,,,,,,,,,,,,,,,,,,,,.,.,.,.ttt.X
----------------------------X.t.t.,.,.,.........................,.,.,.t.t.X
----------------------------X.ttt.,.,.,,,,,,,,,,,,,,,,,,,,,,,,,,,.,.,.ttt.X
----------------------------X.....,.,.............................,.,.....X
----------------------------X.ttt.,.,,,,,,,,,,,,,,,,,,,,,,,,,,,,,,,.,.ttt.X
----------------------------X.t.t.,.................................,.t.t.X
----------------------------X.ttt.,,,,,,,,,,,,,,,,,,,,,,,,,,,,,,,,,,,.ttt.X
----------------------------X.............................................X
----------------------------XXXXX.ttt.ttt.ttt.ttt.ttt.ttt.ttt.ttt.ttt.XXXXX
--------------------------------X.t.t.t.t.t.t.t.t.t.t.t.t.t.t.t.t.t.t.X----
--------------------------------X.ttt.ttt.ttt.ttt.ttt.ttt.ttt.ttt.ttt.X----
--------------------------------X.....................................X----
--------------------------------XXXXXXXXXXXXXXXXXXXXXXXXXXXXXXXXXXXXXXX----
