------------------------------XXXXXXXXXXXXXXXXXXXXXXXXXXXXX--------------------------
------------------------------X...........................X--------------------------
------------------------------X...........................X--------------------------
------------------------------X...........................X--------------------------
------------------------------X...................H.......X--------------------------
------------------------------X.......H.....H.............X--------------------------
------------------------------X.A.....................A...X--------------------------
------------------------------X...........................X--------------------------
------------------------------X........................A..X--------------------------
------------------------------X...........................X--------------------------
------------------------------X..A........................X--------------------------
------------------------------X...........................X--------------------------
------------------------------X.............H..........A..X--------------------------
------------------------------X...........................X--------------------------
------------------------------X..A........................X--------------------------
------------------------------X...........................X--------------------------
------------------------------X........................A..X--------------------------
------------------------------X...........................X--------------------------
------------------------------X..A.......A.....A..........X--------------------------
------------------------------X.............W.............X--------------------------
------------------------------X........................A..X--------------------------
------------------------------X..........A.....A..........X--------------------------
------------------------------X...........................X--------------------------
------------------------------X..A........................X--------------------------
------------------------------X.............W..A..........X--------------------------
------------------------------X..........A............A...X--------------------------
------------------------------X...A............A..........X--------------------------
------------------------------X...........................X--------------------------
------------------------------X.......A..A..W......A......X--------------------------
-------------------------------XX.......................XX---------------------------
---------------------------------X.............A.......X-----------------------------
----------------------------------XX.....A...........XX------------------------------
------------------------------------X.......W.......X--------------------------------
-------------------------------------XX...........XX---------------------------------
---------------------------------------X.........X-----------------------------------
----------------------------------------XX.....XX------------------------------------
------------------------------------------X,,,X--------------------------------------
------------------------------------------X...X--------------------------------------
------------------------------------------X...X--------------------------------------
------------------------------------------X...X--------------------------------------
------------------------------------------X...X--------------------------------------
------------------------------------------X...X--------------------------------------
------------------------------------------X...X--------------------------------------
------------------------------------------X...X--------------------------------------
------------------------------------------X...X--------------------------------------
------------------------------------------X...X--------------------------------------
------------------------------------------X...X--------------------------------------
------------------------------------------X...X--------------------------------------
------------------------------------------X...X--------------------------------------
------------------------------------------X...X--------------------------------------
------------------------------------------X...X--------------------------------------
------------------------------------------X...X--------------------------------------
------------------------------------------X,,,X--------------------------------------
-----------------------------------------X.....X-------------------------------------
----------------------------------------X.......X------------------------------------
---------------------------------------X.........X-----------------------------------
--------------------------------------X.....<.....X----------------------------------
--------------------------------------X...........X----------------------------------
--------------------------------------X...........X----------------------------------
--------------------------------------X...........X----------------------------------
--------------------------------------X...........X----------------------------------
---------------------------------------X.........X-----------------------------------
----------------------------------------X.......X------------------------------------
-----------------------------------------X.....X-------------------------------------
------------------------------------------X,,,X--------------------------------------
------------------------------------------X...X--------------------------------------
------------------------------------------X...X--------------------------------------
------------------------------------------X...X--------------------------------------
XXXXXXXXXXXXXXXXXXXXXXXXXXXXXXXXXXXXXXXXXXX...XXXXXXXXXXXXXXXXXXXXXXXXXXXXXXXXXXXXXXX
X.................................,,,,,,.........,,,,,,.............................X
X...........................,,,,,,.....................,,,,,........................X
X.....................,,,,,,................................,,,,,...................X
X...............,,,,,,...........................................,,,,,,.............X
X.........,,,,,,.......................................................,,,,,........X
X.....,,,,..................................................................,,,.....X
X.....,.......................................................................,.....X
X.....,.......................................................................,.....X
X.....,.......................................................................,.....X
X.....,.......................................................................,.....X
X.....,.......................................................................,.....X
X.....,.......................................................................,.....X
X.....,.......................................................................,.....X
X.....,.......................................................................,.....X
X.....,.......................................................................,.....X
X.....,.......................................................................,.....X
X.....,.......................................................................,.....X
X.....,.......,,,,,...........................................................,.....X
X.....,......,.A...,..........................................................,.....X
X.....,.....,....H..,.............................................,,,,,.......,.....X
X.....,....,...A.A...,...........................................,.....,......,.....X
X.....,...,.HA.....H..,.........................................,.......,.....,.....X
X.....,....,.........,.........................................,.........,....,.....X
X.....,.....,...W...,.........................................,...........,...,.....X
X.....,......,.....,...........................................,.........,....,.....X
X.....,.......,,,,,.............................................,.......,.....,.....X
X.....,..........................................................,.....,......,.....X
X.....,...,,,.....................................................,,,,,.......,.....X
X.....,...,.,.................................................................,.....X
X.....,...,,,.................................................................,.....X
X.....,................................................................A......,.....X
X.....,........A..............................................................,.....X
X.....,.......................................................................,.....X
X.....,.......................................................................,.....X
X.....,.......................................................................,.....X
X.....,.................................................................A.....,.....X
X.....,.......................................................................,.....X
X.....,.......................................................................,.....X
X.....,........A..............................................................,.....X
X.....,.......................................................................,.....X
X.....,.......................................................................,.....X
X.....,.......................................................................,.....X
X.....,.................................................................A.....,.....X
X.....,.......................................................................,.....X
X.....,........A..............................................................,.....X
X.....,.......................................................................,.....X
X.....,.......................................................................,.....X
X.....,.................................................................A.....,.....X
X.....,.......................................................................,.....X
X.....,.......................................................................,.....X
X.....,.......................................................................,.....X
X.....,.......A...............................................................,.....X
X.....,.......................................................................,.....X
X.....,.......................................................................,.....X
X.....,.................................................................A.....,.....X
X.....,.......................................................................,.....X
X.....,.......................................................................,.....X
X.....,.......................................................................,.....X
X.....,.......................................................................,.....X
X.....,.......A...............................................................,.....X
X.....,.......................................................................,.....X
X.....,.................................................................A.....,.....X
X.....,.......................................................................,.....X
X.....,.......................................................................,.....X
X.....,.......................................................................,.....X
X.....,.......................................................................,.....X
X.....,........A..............................................................,.....X
X.....,.................................................................A.....,.....X
X.....,.......................................................................,.....X
X.....,.......................................................................,.....X
X.....,.......................................................................,.....X
X.....,.......,,,,,...............................................,,,,,.......,.....X
X.....,......,.....,.............................................,.....,......,.....X
X.....,.....,.......,...........................................,.......,.....,.....X
X.....,....,.........,.........................................,.........,....,.....X
X.....,...,...........,.......................................,...........,...,.....X
X.....,....,.........,.........................................,.........,....,.....X
X.....,.....,.......,.........................E.................,.......,.....,.....X
X.....,......,.....,.............................................,.....,......,.....X
X.....,.......,,,,,.....................,...........,.............,,,,,.......,.....X
X.....,................................,.,.........,.,........................,.....X
X.....,...............................,..,.........,..,.......................,.....X
X.....,...............................,...,.......,...,.......................,.....X
X.....,................................,...,.....,...,........................,.....X
X.....,......A.........................,...,.....,...,........................,.....X
X.....,.............A...................,...>>>>>...,............A....A.......,.....X
X.....,.................................,...........,.........................,.....X
X.....,..................................,.........,..........................,.....X
X.....,..................................,.........,..........................,.....X
X.....,...................................,,,,,,,,,...........................,.....X
X.....,.......................................................................,.....X
XXXXXXX,,,,,,,,,,,,,,,,,,,,,,,,,,,,,,,,,,,,,,,,,,,,,,,,,,,,,,,,,,,,,,,,,,,,,,,XXXXXXX
------X.......................................................................X------
------X.......................................................................X------
------X.......................................................................X------
------X.......................................................................X------
------X.......................................................................X------
------X.......................................................................X------
------X.......................................................................X------
------X.......................................................................X------
------X.......................................................................X------
------XXXXXXXXXXXXXXXXXXXXXXXXXXXXXXXXXXXXXXXXXXXXXXXXXXXXXXXXXXXXXXXXXXXXXXXXX------
