-------------------------------------------------------------------------------------------------------------XX--------
----------------------------------------------------------------------------------------------------------XXX.X--------
-------------------------------------------------------------------------------------------------------XXX....X--------
----------------------------------------------------------------------------------------------------XXX.......X--------
-------------------------------------------------------------------------------------------------XXX..........X--------
----------------------------------------------------------------------------------------------XXX.............X--------
-------------------------------------------------------------------------------------------XXX................X--------
----------------------------------------------------------------------------------------XXX...................X--------
------------------------------------------XXXXXXXXX-----------------------------------XX........A.............X--------
------------------------------------------X.......X-----------------------------------X...A.A......A..........X--------
------------------------------------------X...H...X----------------------------------X..........A...........E.X--------
------------------------------------------X.......X----------------------------------X..A....A................X--------
------------------------------------------X...E...X-------XXXXXXXXXXXXXXXXXXXXX------X.....A..................X--------
------------------------------------------+....E..X------X....................X-----X.A...........A...........X--------
------------------------------------------+.E.....X------X....................X-----X....A....................X--------
------------------------------------------X.......X-----X.......E...E...E..E...X----XA.........A..............X--------
------------------------------------------XXX,,,XXX----X.......................X---X........................E.X--------
--------------------------------------------X...X-----X...E..E...........E.....X---X..........................X--------
--------------------------------XXXXXXXXX-XXX,,,XXX---X.........E.E.E.E........X---X.A.A...A..............E...X--------
--------------------------------X.......X-X.A...A.X--X..........................X-X.........................E.X--------
--------------------------------X.....E.XXXAA.<AA.XXX.....,,,.......,,,.........XXX.........A.................XXXXXXXX+
--------------------------------+.......,.,.......,.,.....,.,.......,A,.........,.,....................E...E.E........+
--------------------------------+..E....XXX++,,,,+XXX.....,,,.......,++.........XXX.A..A.A....................XXXXXXXXX
--------------------------------X.......X-X.A..AA.X--X..........................X-X.........................E.X--------
--------------------------------X.....E.X-XAA.W.A.X--X..............E...........X--X.......A..............E...X--------
--------------------------------X.......X-X.......X---X...E..E.E..E...E..E.....X---XA.........................X--------
----XXXXXXXXXXXXXXXXX-----------XXXXXXXXX-XXX,,,XXX----X.......................X---X....A...................E.X--------
---X.................X----------------------X...X-------X.......E...E...E..E...X----X.A....A..................X--------
--X..H...H..H.H...A..X--------------------XXX,,,XXX-----X......................X----X.........................X--------
-X..............H.....X-------------------X.E.....X------X....................X-----X.....A....A..............X--------
X...H...H..........A...X------------------X....E..+-------XXXXXXXXXXXXXXXXXXXXX------X.A......................X--------
X...........WW.W.H.....X------------------X.......+----------------------------------X........................X--------
X...H.H..A.........A.A..XXXXXXXXXXXXXXXXXXX...E...X----------------------------------X..A....A..............E.X--------
X.................H..A..,...............,.,AAA..A.X-----------------------------------X....A......A...........X--------
X...H.H..A..........A...XXXXXXXXXXXXXXXXXXX.A..AAAX-----------------------------------XX.....A..A.............X--------
X...H......W.W.W.......X------------------X.......X-------------------------------------XXX...................X--------
X......H.........H.A...X------------------XXXXXXXXX----------------------------------------XX.................X--------
-X....................X---------------------------------------------------------------------X.................X--------
--X......H..H..H..A..X-----------------------------------------------------------------------X....XX..........X--------
---X.................X-----------------------------------------------------------------------X....X-XXX.......X--------
----XXXXXXXXXXXXXXXXX------------------------------------------------------------------------X...X-----XXX....X--------
----------------------------------------------------------------------------------------------X..X--------XXX.X--------
----------------------------------------------------------------------------------------------X,X------------XX--------
----------------------------------------------------------------------------------------------X.X----------------------
----------------------------------------------------------------------------------------------X,X----------------------
----------------------------------------------------------------------------------------------X.X----------------------
----------------------------------------------------------------------------------------------X.X----------------------
----------------------------------------------------------------------------------------------X.X----------------------
--------------------------------------------------------------------XXXXXXXXXXXXXXXXXXXXXXXXXXX.XXXXXXXXXXXXXXXXXXX----
--------------------------------------------------------------------X.............................................X----
--------------------------------------------------------------------X..H..........................................X----
--------------------------------------------------------------------X...........................................H.X----
--------------------------------------------------------------------X.............................................X----
--------------------------------------------------------------------X.............................................X----
--------------------------------------------------------------------X..........A.A..A.A.A.A.A..A.A................X----
--------------------------------------------------------------------X........A....................................X----
--------------------------------------------------------------------X.............A.AA.A.A.A.A.AA.................X----
--------------------------------------------------------------------X......A..A.A.................A...............X----
--------------------------------------------------------------------X.................................,,,,,.......X----
--------------------------------------------------------------------X.......A.A..A..A.A..A..A.A.A.A...,...,.......X----
--------------------------------------------------------------------X.................................,.K.,.......X----
--------------------------------------------------------------------X.........A.A...A..A..AA..A..A....,...,.......X----
--------------------------------------------------------------------X.................................,,,,,.......X----
--------------------------------------------------------------------X.............................................X----
--------------------------------------------------------------------X.............................................X----
--------------------------------------------------------------------X.............................................X----
--------------------------------------------------------------------X.....................,,,,,...................X----
--------------------------------------------------------------------X....................,.....,..................X----
--------------------------------------------------------------------X...,,,,,,,.........,.......,.................X----
--------------------------------------------------------------------X...AAAAAA,........,.........,................X----
--------------------------------------------------------------------X...,....A,.......,...........,...............X----
--------------------------------------------------------------------XH..AAAAA.,.......,...........,...............X----
--------------------------------------------------------------------X...,AAAAA,.......,.....E.....,...............X----
--------------------------------------------------------------------X...,A....,.......,...........,...............X----
--------------------------------------------------------------------X...,,,,,,,.......,...........,...............X----
--------------------------------------------------------------------X..................,.........,................X----
--------------------------------------------------------------------X...................,.......,.................X----
--------------------------------------------------------------------X....................,.....,..................X----
--------------------------------------------------------------------X.....................,,,,,...................X----
--------------------------------------------------------------------X.............................................X----
--------------------------------------------------------------------X.............................................X----
--------------------------------------------------------------------X.......................H.....................X----
--------------------------------------------------------------------X.............................................X----
--------------------------------------------------------------------X.............................................X----
--------------------------------------------------------------------X.............................................X----
--------------------------------------------------------------------X.............................................X----
--------------------------------------------------------------------X.............................................X----
--------------------------------------------------------------------X.............................................X----
--------------------------------------------------------------------X.............................................X----
--------------------------------------------------------------------X.............................................X----
--------------------------------------------------------------------X.............................................X----
--------------------------------------------------------------------X.............................................X----
--------------------------------------------------------------------X.............................................X----
--------------------------------------------------------------------X.H.........................................H.X----
--------------------------------------------------------------------X.............................................X----
--------------------------------------------------------------------X.............................................X----
--------------------------------------------------------------------XXXXXXXXXXXXXXXXXXXXXXXLLLXXXXXXXXXXXXXXXXXXXXX----
------------------------------------------------------------------------------------------X...X------------------------
------------------------------------------------------------------------------------------X...X------------------------
------------------------------------------------------------------------------------------X...X------------------------
------------------------------------------------------------------------------------------X,,,X------------------------
------------------------------------------------------------------------------------------X...X------------------------
------------------------------------------------------------------------------------------X,,,X------------------------
------------------------------------------------------------------------------------------X...X------------------------
------------------------------------------------------------------------------------------X...X------------------------
------------------------------------------------------------------------------------------X...X------------------------
------------------------------------------------------------------------------------------X>>>X------------------------
------------------------------------------------------------------------------------------X...X------------------------
------------------------------------------------------------------------------------------X...X------------------------
------------------------------------------------------------------------------------------X...X------------------------
------------------------------------------------------------------------------------------X...X------------------------
------------------------------------------------------------------------------------------X...X------------------------
------------------------------------------------------------------------------------------X...X------------------------
------------------------------------------------------------------------------------------X...X------------------------
------------------------------------------------------------------------------------------XXXXX------------------------
