----------------------------------------------------XXXXXXXXX------------------------------------------------------------------
----------------------------------------------------X.......X------------------------------------------------------------------
----------------------------------------------------X.......X------------------------------------------------------------------
----------------------------------------------------X..,,,..X------------------------------------------------------------------
--------------------------------XXXXX---------------X..,H,..X------------------------------------------------------------------
--------------------------------X...X---------------X..,,,..X------------------------------------------------------------------
--------------------------------X.W.X---------------X,,,,,,,X------------------------------------------------------------------
--------------------------------X...X---------------X.......X------------------------------------------------------------------
------------HHHHX-----------XXXXX,,,XXXXX-----------X.......X------------------------------------------------------------------
------------HHHHX-----------X...........X-----------X.......X------------------------------------------------------------------
------------HHHHX-----------X...........X-----------X.......X------------------------------------------------------------------
------------HHHHX-----------X...........X-----------X.......X------------------------------------------------------------------
------------HHHHX-----------X...,,,,,...X-----------X.......X------------------------------------------------------------------
------------HHHHX-----------X...,...,...X-----------X.......X------------------------------------------------------------------
------------HHHHX-----------X...,.E.,...X-----------X.......X------------------------------------------------------------------
------------HHHHX-----------X...,...,...X-----------X.......X------------------------------------------------------------------
--------XXXXX,,,XXXXX-------X...,,,,,...X-----------X.......X------------------------------------------------------------------
--------X...........X-------X...........X-----------X.......X------------------------------------------------------------------
--------X...........X-------X...........X-----------X.......X------------------------------------------------------------------
--------X...........X-------X...........X-----------X.......X------------------------------------------------------------------
--------X...,,,,,...X-------X...........X-----------X.......X------------------------------------------------------------------
--------X...,A.A,...X-------X...........X-----------X.......X------------------------------------------------------------------
--------X...,.E.,...X-------X...........X-----------X.......X------------------------------------------------------------------
--------X...,A.A,...X-------X...........X-----------X.......X------------------------------------------------------------------
--------X...,,,,,...X-------X...........X-----------X.......X------------------------------------------------------------------
--------X...........X-------X...........X-----------X.......X------------------------------------------------------------------
--------X...........X-------X...........X-----------X.......X------------------------------------------------------------------
--------X...........X-------X...........X-----------X.......X------------------------------------------------------------------
--------X...........X-------X...........X-----------X.......X------------------------------------------------------------------
--------X...........X-------X...........X-----------X.......X------------------------------------------------------------------
--------X...........X-------X...........X-----------X.......X------------------------------------------------------------------
--------X...........X-------X...........X-----------X.......X------------------------------------------------------------------
--------X...........X-------X...........XXXXXXXXXXXXX.......X------------------------------------------------------------------
--------X...........X-------X...............................X------------------------------------------------------------------
--------X...........X-------X...............................X------------------------------------------------------------------
--------X...........X-------X...............................X------------------------------------------------------------------
XXXXXXXXX...........XXXXXXXXX...............................X------------------------------------------------------------------
X...........................................................X------------------------------------------------------------------
X...........................................................X------------------------------------------------------------------
X...........................................................X------------------------------------------------------------------
X.......................,,,,,,,,XXXXXXXXXXXXXXXXXXXXXXXXXXXXX------------------------------------------------------------------
X......................,........X----------------------------------------------------------------------------------------------
X.....................,.........X----------------------------------------------------------------------------------------------
X....................,..........X----------------------------------------------------------------------------------------------
XXXXXXXXXXXXXXXXXXXXX......,,,,,XXXXXXXXXXXX-----------------------------------------------------------------------------------
---------------------X....,................X-----------------------------------------------------------------------------------
---------------------X...,.................X-----------------------------------------------------------------------------------
----------------------X.,..................X-----------------------------------------------------------------------------------
-----------------------X...................X-----------------------------------------------------------------------------------
----------------------X.....................X----------------------------------------------------------------------------------
---------------------X......................X----------------------------------------------------------------------------------
--------------------X.......................X----------------------------------------------------------------------------------
--------------------X...........XXXXXX,,,,XXX----------------------------------------------------------------------------------
--------------------X...........X----X....X------------------------------------------------------------------------------------
--------------------X..........X------X+H+X------------------------------------------------------------------------------------
--------------------X..........X---XXXX,,,XXXX---------------------------------------------------------------------------------
--------------------X..........X--X...........XX-----X-------------------------------------------------------------------------
--------------------X.........X--X............,.XX--X.X------------------------------------------------------------------------
--------------------X.........X--X..H..H..H.H.,...XX...X-XXXXXXXXX-------------------------------------------------------------
--------------------X.........X--X............,..,,.....XX......:X-------------------------------------------------------------
--------------------X........X---X....,,,,XXXXXXX,......,,.......X-------------------------------------------------------------
--------------------X........X---X..H.,.....XX--X.......,,......,.X------------------------------XXX---------------------------
--------------------X........X---X....,....,..XX......XXXX.....,...XXXXXXXXXXXXXXXXXX---XXXXXXXXXX<XXXXXXXXXX------------------
--------------------X.......X----X....,....,..X-X....X---X.:..XX.,,...,.,.,.,.,.,...X---X.....,.......,.....X------------------
--------------------X.......X----X..H.,...,...X-X..E..X--XH..X--X.....,.,.,.,.,.,.E.X---X.....,.<...<.,.....X------------------
--------------------X.......X----X....X..,..XX-XH....X---X.XX---X.....,.,.,.,.,.,...XX--X.....,.......,.....X------------------
--------------------X.......X----X....X.,..X-XXHE.E..X---XX----XX.....XXXXXXXXXXX...,X--X..H..,.......,...A.X------------------
--------------------X.......X----X..H.XX.XXXXH......X----------H,E...AX---------X...,X--X.....,.......,.....X------------------
--------------------X.......X-----X,,,X-XXX.H....E.X----XXXXX--X,.....XXXXXXXXXXX...,X--X.....,.......,.....X------------------
--------------------X.......X-----X...X-X.H.......X----X.,.HX--XX..E.EXX....,...,...XX--X.....,.......,.....X------------------
--------------------X.......X------X...X.H........X---X.H,E.X---XX....,,....,...,K..X---X.....,,,,,,,,,.....X------------------
--------------------X.......X------X.,,.......E..X---XE...,.X--XXXXX..XX....,...,...X---X.....,E,...,E,.....X------------------
--------------------X.......X-------X,..........,.X-X.,...,.X-X...X-XXXXX,,,XXXXXXXXX---X,,,,,XXX,,,XXX,,,,,X------------------
--------------------X........X------X.....XXX.,,.,.X..,..E,.XX.....X----X...X-----------X.....X-X...X-X.....X------------------
--------------------X.........X----X....XXXX-X.,,..,..,.E.,.X.,.....X---H,,,X-----------X,,,,,X-X.H.X-X,,,,,X------------------
--------------------X..........X---X..XXX.:.X-X...E,..,...,..,.,....X---X...X-----------X.....X-X,,XX-X.....X------------------
--------------------X...........XXX+.X--X....XXX...,..,...,...,.X....X--H...X-----------X,,,,,XXX,<XXXX,,,,,X------------------
--------------------X...........,.XXX--X....E.X.,.,..,....,....XX.....X-H..EX-----------X.....,.......,.....X------------------
---------------------X..........,.,.X--X.......,,.,..,...,.....:XX..E.X-H...X-----------X.....,.......,.....X------------------
---------------------X..........,,.,.XX..........X,..,...,....XX-X....HXH...X-----------X.....,...W...,.....X------------------
----------------------X.........X.,.,A.....E..E..XXX.,...,...,.X-X....X-H...X-----------X.....,...A...,.....X------------------
----------------------X.........XX.,H.E....X....X-XH.,...,...,,.X..E.X--X...X----XXXXXXXX.....,.......,.....X-----X------------
-----------------------X........X-X:.......XXX.X-X...,...,..X,....E..X--H...X----XEEE.EXXXXXXXXXX,,,XXXXXXXXX---XX.X-----------
-----------------------X........X-X....E..X---:-X.....,..,.XX.......X---HX,,,X---X,,,,,X--------X+++X---------XXE..X-----------
------------------------XXXXXXXXXX........X----X.H....,...X--X.....X---XXX,,,X--XX,,,,,XXXXXX---X+++X---------X,.E..X----------
----------------------------------X.E.....XX--X........,.X--X....,,.XXXX,....XXX.............XXXX,,,XXXXX----X.,,....X---------
-----------------------------------X...E..X.XXH.........X--X....X..,.,E,,....,,+...,,,,,,,,,,,,,,,,....,.XX-X..E.,.E.X---------
------------------------------------X...,,.E.XX........X--X....XX.,.E,.,,....,L+...,HH.HH.HH.HH.H.,....,.H.XX,,..,...EX--------
-------------------------------------X.X,.....XX......XXXX....X--XXXXXXXX....,L+...,..............,...,....H.,,,..,.E.X--------
--------------------------------------XX.......,,...XX-X,.,...X-XXXXXXX-X,...XXX...,,,,,,,,,,,,,,,,...,....,...,.E,.EEX--------
------------------------------------X--+X.E...E.,,.X--X.,E.,.X--X.....XA..XXXX-XX:,,,,,,,,,,,,,,,:XXXXX...,....,,..,..X--------
-----------------------------------X.XX-+H.......XX--XE..,,.X---X.....X.:.AXXXXXXXXXXXXXXXXXXXXXXXX----XX.,.....,.E,EEX--------
---------------------------------XX..,,X-+A.....X---X....EXX----X.....XXXXXX.....XXXXXXXXXXXXXXXXXXXX----X......,,,,.EX--------
--------------------------------X...,..X--+H..,,XXXX.....BX-XXX-X.....XXXXXX.......................,.X----X......XX,EXX--------
-------------------------------X...,..,.X--XX,.,H:........XX..:-X.........,........................,..X----X...,,X-XX----------
-----------------------------XX...,..,..X----XXA........,,.B..HXX.........,.......................,....X----XH,..X-------------
----------------------------X...,,..,..X-------X.....:.,.......X..........,......................,......X---X.....X------------
---------------------------X...,...,....X-----X......,,.......H,..........,......................,.......X--XH....X------------
---------------------------X..,...,....,.A---X.,...XX..........,..........,.......,,,,,,,,,,,,,,X.........X-X,,,,,X------------
---------------------------X.,...,,....,..XXX.,.,XX-X.........H...........,.......,............X-X......,,XXX.....X------------
---------------------------X.,..,..,,.,.HXXH,,.,.X---X........,...........,.......,...........X---X....,..,,.B.....X-----------
--------------------------X.,..,....XXXHXA...,,.X----X.......HX...........,.......,.........,,.X---X.,,...,.B...:..X-----------
--------------------------X.,..,....X--XX...E.,X------X,EXXXHXX...........,.......,........,....X---X....,,.......B.XXXXXXX----
--------------------------X.,..,....X--X:......X------X..X-X.XX.......XXXXX.......,.......,......X-X,....,H.........XX.E..X----
--------------------------X.,..,.....X--XH....,.X----X....X-XX........X----X......,.....,,.....E..X.,....,..........,,E..EX----
--------------------------X,...,.E...X--X.XH.,.,XX--X-XEH.X-X.......XXX----XXX,,XXXX,,XXX...XXX..,..,....,..........,,....X----
--------------------------X,...,...E..X--XX.E.,,,X-XX-X.XXXX........XXXXXXXXXX,,XXXX,,XXX,,,X-A.,...,....,A+++++++++,,E..EX----
-------------------------X.,...,.....E.X---X.,,,..X.:X-X-X..........,H,HHHX.......,HH.HXX...X-X,....,....,..........,,..E.X----
-------------------------X.,...,,E.....EX---XX,.....,.X-X...........XXXXXHX.:.....,....XX,,,XXH.....,....,..........,,...EX----
-------------------------X,..E.,.,...E...XXX-X.....,...X............XXXXXHX.......,....,,....XX.....,....,H...:..B..XXE...X----
-------------------------X,....,..,.........XX....,....................XXHX....:..,....,,....XX.....,....,..........XXXXXXX----
-------------------------X,.....,..,.......,,....,.....................XXH,.....,,.....XXXXXX-A.....,.....,.........X----------
--------------------------X.....,...,....,,.....,......................XX.X....,.,.....XXXXXXXX.....,.....,........XXXXXXXX----
--------------------------X,....,....,:,,......,.......................XXHX...,...,....X,,..........,......X.......X......X----
--------------------------X,....,.....,,,,....,........................XXHX...,,..,....X............,.....X-X,,,,,XX......XXX--
--------------------------X,..E.,.........,,,,........................X-XHX..,..,..,.XXX............,.....X-B.....XX......,:X--
---------------------------X....,.....................................XXH.XH,...,...X--X............,.....XHX.B...XX,,,,,,,,X--
---------------------------X,...,....................................XX.,.XXE.E..,.X---X............,.....X+XB....XX,.....,.X--
---------------------------X,....,...................................XX.,XX,......X----XXXX...B.....,,,,,,X,X.....XX,.....,.X--
---------------------------X,....,..........................XXXXXXXXXX..XX..,....X--------X.........,.....,.,.....XX,.....,.X--
----------------------------X....,.........................,X-XXXXXXX...X.,.X.EXX--XXXXXXXX.........,.....,.,.....XX,,,,,,,,X--
----------------------------X,...,,.......................,.X-X...,....X.,.XXHX----XH,H,.:,.........,.....,.,.....XX......,:X--
----------------------------X,.....,,....................,..X-X...XXXXX...X--X--XXXX.,.,.,,.........,.....,.,....:XX......XXX--
-----------------------------X.......,,.................,...X-X...XXXXX...X-----XHH.HXXXXXX.........X,,,,,XXXXXXXXXXX.....X----
-----------------------------X.........,,..............,....X-X...,...,...X-----XHXXXX----XXX,,,XXXXX,,,,,X---XXXXXXX,,,,XX----
-----------------------------X,..........,,...........,.....XXX...,...,...X-----X.X---------X...X---XE..E.X---X..........X-----
-----------------------------X,............,,........,....,,,,,...XXXXX...X-----X,X---------XLLLX---XXXXXXX---X..........X-----
------------------------------X,.............,,.....,...,,,.,,,...X---XA..X---XXX+XXXXXXXXX-XLLLX-------------X,,XXXXXXXXX-----
------------------------------XXX,,,...........,,..,....,K.XXXX...X---XXXXX---X.........:.X-X,,,X-----XXXXXXX-X..X-------------
---------------------------------XXXX,,,.........,,,.....XX---X...X-----------X....E...E..X-X.A.X-----X.....X-X,,X-XXXX:XXXXXXX
-------------------------------------XXXX,,,........,,...XXXXXXXXXX-----------XE..........X-X...X-----X:....XXX,,XXX..,.....E.X
-----------------------------------------XXXXX,.......,,,.....XX--------------X..,,,,,,,,XX-X...X-----X.....XXX,,XXX..,.......X
----------------------------------------------XXXX,.....XX......X-------------X..,,,+,,,,AXHX...XEXEEXX,,.............,..E....X
--------------------------------------------------XXXX,.X-XX....X-------------X..,,.+...........,.....,.,.............,.......X
------------------------------------------------------XXXXX-X....X------------XE.,,.W...........,E.EE.,.,.............,E....E.X
------------------------------------------------------------X....X------------X..,,.+...........,E.EE.,.,.............,.......X
-------------------------------------------------------------X...X------------X..,,,,,,,,XXXXXXXXXXXXXX,,.............,.......X
-------------------------------------------------------------X....X-----------X...........X-----------X..............H.,.E..E.X
-------------------------------------------------------------X....X-----------X........E..XXXXXXXXXXX-X:.............,H,......X
--------------------------------------------------------------X.,,.X----------XE...E......XX........X-X.............,...,.....X
--------------------------------------------------------------X,..,.XX--------X...........XX..XXXXX.X-X.............,..A,.....X
--------------------------------------------------------------X.,,....XXX-----XXXXXXXXX+XXXX..X---X,X-X,,,,,,,,,,,,,....H,..E.X
---------------------------------------------------------------X.........XX-----------X+XXXX..X---X,X-X...........,,.....,...X-
---------------------------------------------------------------X...........XX---------X.......X---X,X-X............,,....H,..X-
--------------------------------------------------------------XXX.....X......X--------XXXXXXXXX--XX,XXX............,,.....A.X--
----------------------------------------------------------XXXX.......X-X......XX-----------------X...XX.............,,.....X---
-------------------------------------------------------XXX..........X---X.......XXX--------------X...XX.............,,....,X---
------------------------------------------------------X............X-----X........X--------------X.,,,,..............,,..,..X--
----------------------------------------------------XX............X-------X.......X--------------X.,H,,..............,,.,..,X--
---------------------------------------------------X...............X-------X.......X-------------X...,,...............,XX.,.X--
--------------------------------------------------X.................X-------X......X-------------X:..XX...............X--X...X-
-------------------------------------------------X...................X-----X.......X-------------XXXXXX...............X--X...X-
-----------------------------------------------XX.............X.......X---X........X------------------X..............X---X...X-
----------------------------------------------X..............X-X.......X-X..........X-----------------XXXXXXXXX,H,XXXX--X.,,X--
---------------------------------------------X.............XX---X.......X...........X---XXXXXXXXXXX-----------X..,X-----X...X--
---------------------------------------------X............X------X..................X---X.........X-----------X,,..X---X....X--
---------------------------------------------X...........X--------X................X----X.........X-----------X....X--XX....X--
---------------------------------------------X.........XX---------X................X----X.........X------------X....XX..,,..X--
---------------------------------------------X........X-----------X.......XXXXXXXXX-----X....E....X------------X....,.....XX---
---------------------------------------------X........X-----------X.......X-------------X.........X-------------X...,....X-----
---------------------------------------------X........X-----------X.......X-------------X.........X-------------X...,...X------
---------------------------------------------X.......X------------X.......X-------------X.........X--------------XXXXXXX-------
---------------------------------------------X.......X------------X.......X-------------X.........X----------------------------
---------------------------------------------X.......X------------X.......X-------------X.........X----------------------------
---------------------------------------------X.......X--X---------X.......X-------XXXXXXX.........X----------------------------
---------------------------------------------X...E...X-X.XX------X........X-------X........E......X----------------------------
----------------------------------------------X.....X-X....X----X.........X------X................X----------------------------
----------------------------------------------X.....XX......XX-X..........X------X................X----------------------------
----------------------------------------------X.....X.........X...E.......X----XX.................X----------------------------
----------------------------------------------X...........................X-XXX...................X----------------------------
------------------------------------------XXX-X...........................XX......................X----------------------------
------------------------------------------X..XX...................................................X----------------------------
------------------------------------------X.......................................................X----------------------------
-----------------------------------------X........................................................X----------------------------
------------------------------------X----X.............................................XXXXXXXXXXXX----------------------------
-----------------------------------X.X---X...........................................XX----------------------------------------
----------------------------------X...X--X....X................,XX.................XX------------------------------------------
---------------------------------X.....XX.....XX...........,,,,X--XXXX...........XX--------------------------------------------
--------------------------------X.......X.....X-X.......,,,...X-------XXX....XXXX----------------------------------------------
--------------------------------X............X---X..,,,,.....,.X---------XXXX--------------------------------------------------
--------------------------------X.........E..X----XX........,...X--------------------------------------------------------------
---------------------------------X...........X------X......,.....X-------------------------------------------------------------
---------------------------------X...........X------X,,...X...H...XXXXXXXXXXXXXHXXXXX------------------------------------------
---------------------------------X..........X------X...,.X-X.....,..............,...X------------------------------------------
---------------------------------X..........X------X....X---X...,..............H,...X------------------------------------------
---------------------------------X..........,X-----X....X----X.,...............H,.H.X------------------------------------------
----------------------------------X........,..X----X...X------X.................,...X------------------------------------------
----------------------------------X........,..,X--X....X------X................H,...X------------------------------------------
----------------------------------XXXXXXXXX..,..XXX,,,X-------X....HXXXXXXXXX,XXX,,,X------------------------------------------
-------------------------------------------X.,..,.,...X-------X.....X-------XWX-X...X------------------------------------------
--------------------------------------------X..,..,...X-------X....HX-----XXX,XXX..AX------------------------------------------
---------------------------------------------X.,..,...X-------X....HX-----XB....,...X------------------------------------------
----------------------------------------------XX..,...X-------X.....X-----X.E...,...X------------------------------------------
------------------------------------------------XX,.XX--------X....HX-----X.....,...X------------------------------------------
--------------------------------------------------XX----------X.....X-----X...E.,H..X------------------------------------------
--------------------------------------------------------------X.....X-----X.....,...X------------------------------------------
--------------------------------------------------------------X.....X-----X.E..B,...X------------------------------------------
--------------------------------------------------------------X..E..X-----X.....,...X------------------------------------------
--------------------------------------------------------------X.....XXXAXXX,,,,H,...X------------------------------------------
--------------------------------------------------------------XE..E.,...............X------------------------------------------
--------------------------------------------------------------X.....,...............X------------------------------------------
--------------------------------------------------------------X.....,H.....H.......:X------------------------------------------
--------------------------------------------------------------XXXXXXXXXXXXXXXXXXXXXXX------------------------------------------
