-XXXXXXXXXXXXXXXXXXXXXXXXXXXXXXXXXXXXXXXXXXXXXXXXXXXXXXXXXXXXXXXXXXXXXXXXXXXXXXXXXXXXXXXXXXXXXXXXXXXXXXX-XXXXXXXXXXXXXXXXX---
-X.............E.....XX,.................XX......................XX.......................XX,,,,,,,,,,,XXX,,,,,,,,,,,,,,,X:X-
-X..E................XXXX+++XXXX.....,,,,XX,,,,,,,,,,,,,,,,,,,,,,XX.......................XX...........,,..................X-
-X..................X-XXX...XXXX.....,...,.:,..,..,..,..,..,..,.EXX...A.A.....W.....A.A...XX,,.........,,..................X-
-XXXXX.............X-X........XX.....,,,,XX,,,,,,,,,,,,,,,,,,,,,,XX.......................XXW,.........,,.XXXXXXXXXXXXXXX,XX-
-XXXXX..............X.......W.XX.....,...XX...................,..XX...A.....,,,,,,....A...XX...........,,.XXXXXXXXXXXXXXX,XX-
-X...,...............,........L+.....,,,,XX...................,,,XX.......X,,,,,,XX.......XX,,.........,,.XX...............X-
-XA.A,................,.......L+.....,...XX...................,..XX.......,.,,,,,.,.......XXW,.........,,.XX,XXXXXXXXXXXXXXX-
-X.A.,.................,.....EL+.....,,,,XX...................,,,XX......,,,,,,,,,,,......XX...........,,.XX,XXXXXXXXXXXXXXX-
-XH.A,......:...........,.....XX.....,...XX...................,..XX......,,,,,,,,,,,......XX,,........E,,.XX............,.,X-
-X.A.,...................,....XX.....,,,,XX.........XXX.......,,,XX......,,,,,W,,,,,......XXW,......E..,,.XXXXXXXXXXXX.XX.,X-
-X...,....................,.E.XXXXX..,...XX.........XXX.......,..XX......,,,,,,,,,,,......XX...........,,.X----------X.XX.,X-
-XA.A,.....................,.XX..XX..,,,,XX.........tHt.......,,,XX......,,,,,,,,,,,......XX,,.........,,.XXXXXXXXXXXX.A,.,X-
-XXXXX......................X-X..XX..,...XX.........ttt.......,..XX......,X.,,,,,XX,......XXW,...E.....,,......XX...XXXXX.,X-
-XXXXX...........:...........X...XX..,,,,XX..........,........,,,XX.......X,,,,,,XX.......XX...E....E..,,....:.,,...XXXXX.,X-
-X...............................XX..,...XX..........,........,..XX.....E...,,,,,,..E.....XX...........,,:.....A,.......,.,X-
-X...............................XX..,,,,XX..........,........,,,XX.......................XXXXXXXXXXXXXXXXXXX++XXXXXXXXXX.XX-
-X.....E.........................XX..,...XX........,,,,.......,..XX...........E...........XXXXXXXXXXXXXXXXXXXXXXXXXXXX-XX.XX-
-X...............................XX..,,,,XX.......,....,,,,,,,,,,XX.......................XX.......XX...XX...XX.,....XXX...X-
-XXXXXXXXXXXXX...................XX..,...XX.E.....,....,E.,....E.XX...........:...........XX..,,,..XX...XX...XX.,.....,,...X-
-XXX,,,,,,,XXX..............:....XXXXXXXXXX......XXXXXXXXXX......XXXXXXXXXX,,,,,,XXXXXXXXXXX..,H,..,,.W.,,.A.,,.,.....,,...X-
-X,.....,....,...................XXXXXXXXXX.ttt..XXXXXXXXXX......XXXXXXXXXX......XXXXXXXXXXX..,,,..,,...,,...,,.XXXX.XXX.XXX-
XX.,....,....,.................H.XXE......X.tWt..XXE......X......XXE......X......XXE......XX.......XX...XX...XX.XXXX.XXX.XXX-
X,..,....,...,...................XX.......X.ttt..XX.......XA..W.EXX.......X.tttttXX.......XX.......XX...XX...XX.X+H........X-
X,...,....,..XXXXXXXXXXXXXXXXXXXXXX.......XXXXXXXXX.......XXXXXXXXX.......XXXXTXXXX.......XXXXXXXXXXXXXXXXXXXX++++XXXXXXXX.X-
X,....,...,.X-:XXXXXXXXXXXXXXXXXXXX,,,,,,,XXXXXXXXX,,,,,,,XXXXXXXXX,,,,,,,XXXXXXXXX,,,,,,,XXXXXXXXXXXXXXXXXXX:X-XXXXXXXXXX,X-
X,.....,...X-X...............,................,...............,...............,................,...............XXX.........X-
X,,,....,.X-X...............,.................,...............,...............,.................,...............XXX........X-
X,..,....X-X...............,..................,...............,...............,..................,...............XXX.......X-
X,...,,.X-X...............,...................,...............,...............,...................,...............XXX......X-
XX.....X-X...............,....................,...............,...............,....................,...............XXX.....X-
-X....X-X...............,.....................,...............,...............,.....................,...............XXX....X-
-X,,,X-X...............,......................,...............,...............,......................,...............XXXX,XX-
-X.<.X:...............,.......................,...............,...............,.......................,..............:XXX+XX-
-X...,,...............,.......................,...............,...............,.......................,...............,,...X-
-X...,,...............,.......................,...............,...............,.......................,.....E.........,,...X-
-X...,,...............,.......................,...............,...............,.......................,...............,,...X-
XX...,,...............,.......................,...............,...............,.......................,...............,,...XX
X,...,,...............,.......................,...............,...............,.......................,.............,X,,...,X
X,...XX...............,.......................,...............,...............,.......................,.....E.......,XXX...,X
X,..,,,,..............,.......................,...............,...............,.......................,..............,L,,..XX
XT.<,,,W..............,,,,,,,,,,,,,,,,,,,,,,,,,,,,,,,,,,,,,,,,,,,,,,,,,,,,,,,,,,,,,,,,,,,,,,,,,,,,,,,,,..............,L,,.,XX
X,..,,,,..............,,,,,,,,,,,,,,,,,,,,,,,,,,,,,,,,,,,,,,,,,,,,,,,,,,,,,,,,,,,,,,,,,,,,,,,,,,,,,,,,,..............,L,,.,XX
X,...XX...............,.......................,...............,...............,.......................,...E.........,XXX...,X
X,...XX...............,.......................,...............,...............,.......................,.............,XXX...,X
XX...,,...............,.......................,...............,...............,.......................,...............,,...XX
-X...,,...............,.......................,...............,...............,.......................,...............,,...X-
-X...,,...............,.......................,...............,...............,.......................,.E.............,,...X-
-X...,,...............,.......................,...............,...............,.......................,...............,,...X-
-X.<.X:...............,.......................,...............,...............,.......................,..............:XX...X-
-X,,,XX...............,.......................,...............,...............,.......................,...............XXX+XX-
-X....XX...............,......................,...............,...............,......................,...............XXXX,XX-
XX.....XX...............,.....................,...............,...............,.....................,...............XXX....X-
X,...,,.XX...............,....................,...............,...............,....................,...............XXX.....X-
X,..,....XX...............,...................,...............,...............,...................,...............XXX......X-
X,,,....,.XX...............,..................,...............,...............,..................,...............XXX.......X-
X,.....,...XX...............,.................,...............,...............,.................,...............XXX........X-
X,....,...,.XX:..............,................,...............,...............,................,.............:.XXX.........X-
X,...,....,..XXXXXXXXXXXXXXXXXXXXXX,,,,,,,XXXXXXXXX,,,,,,,XXXXXXXXX,,,,,,,XXXXXXXXX,,,,,,,XXXXXXXXXXXXXXXXXXXXX-XX,XXXXXXXXX-
X,..,....,...,..........ttt.....X-X.......XH.H.H.HX.......XH.H.H.HX.......X.tttttXX.......XXXXXXXXXXXXXXXXXXXXXXXX.XXXXXXXXX-
XX.,....,..T.,..........t:t.....X-X.......X.H.H.HXX.......X.H.H.HXX.......X.t.T.tXX.......XXH.H,...................,,A....AX-
-X,.....,....,,,........ttt......XXE......XH.H.H.HXE......XH.H.H.HXE......X.tttttXXE......XX.H.,......XXXXXXXXXXXX.,,......XX
-XXX,,,,,,,XXX.,,,...............XXXXXXXXXX,H,H,HXXXXXXXXXX,H,H,HXXXXXXXXXX,,,,,,XXXXXXXXXXXH.H,......X----------X.,,..A...,X
---X+++++++X-X...,,,,........,,..X,,,.......................,,.,,XX.E.........:...........XX.H.,......XXXXXXXXXXXX.,,......,X
-XXX,,,,,,,X-X.....,,,,....,,,,,.XXXX.E............E........,,.,,XX.......................XXH.H,...................,,A....A,X
-X......XXXXXX.H.....,,,,.,.,..,,XXXXXXXXXXXX,,,,...........,,.,,XX...........E...........XX.H.,......XXXXXXXXXXXX.,,......,X
-X......XXX..,,,,,....,,,+,,....,,..XXXXXXXXX,,,,...........X,,,,XX.......................XXH.H,......XXXXXXX+XXXX.,,..A...,X
-X......,.,.E,,,,,,,,,,,E,.......,.E,.+,...,E..:,...........X....XX...E...................XX.H.,.............+X.XX.,,......,X
-X.E....XXX..,.....,,,.+,,.......,..XXXX...,....,...........,....XX.........,,,,,,........XXXXXXXXXXXXX.XXXXXXX....,,A....A,X
-X.........XXX.........,....ttt..XXX---X...,....,..........,.....XX.......X,,,,,,XX..E....XXXXXXXXXXXXX.XXXXXXX.XX.,,......,X
-X..........WX........,,....tAt..X-----X,,,XX...X..........,.....XX.......,.,,,,,.,.......XX............XX......XX.,,..A...,X
-X..E........X..ttt...,,....ttt..XEXXXXX...XX,,,X.........,......XX......,,,,,,,,,,,......XX.XXXXXX,,,XXXX....,,XX.,,......,X
-XX.........XX..tAt....,.........XX...,.....,...X........,..E....XX......,,,,,,,,,,,......XX.XXXX-X...XXXX....A,...,,A....A,X
-XX,,,,,,,,,XX..ttt....,,........XX...,.....,...XE......,........XX......,,,,,K,,,,,....E.XX...HX-X...XX......XXXX.,,......,X
-X............XX.......,,.......X-X...,.....,...X.....,,.........XX......,,,,,,,,,,,......XX.XXXX-X...XX,,,,,,XXXX.,,..A...,X
-X..........E..XXXXXXX,,,XXXXXXX--X,,,XX...XX,,,XXXXX,...E.......XX......,,,,,,,,,,,......XX.XXXX-X...XX........XX.,,......,X
-X.............,....:X..EXXXXXEXXXX...XX,,,XX...X............E...XX......,X.,,,,,XX,......XX...HX-X...XX........A,.,,A....A,X
-X.............,..E..X...XX.,....,.....,E.H,....X,,..............XX.......X,,,,,,XX.......XX.XXXX-X...XX........XX.,,......XX
-X.............,......X,X-XE,....,.....,...,....X.,..............XX.........,,,,,,........XX.XXXX-X...XX:.......XX.,,..A...X-
-X.......E.....,......XWX-X.,....,.....,...,....X.,..............XX.......................XX...HX-X...XXXXXXXXXXXXXXXXX,,,,X-
-X,,,..........,......X+X-X.XX..EXXXXXXX,,,XX,,,X.,W.............XX.......................XX.XXXX-X...XXXXXXXXXXXXXXXXX....X-
-X,K,..........,......X,XXX.XX,,,XXXXXXX...XX...Xt,,,,,,,,,,,,,,,XX.......................XX.XXXXXX......XX....XX...AXX,,,,X-
-X,,,.........XX.E.......XX.E....,...H+XE..,....X.t.,.,.,.,.,.,.,XX.......................XX....H,,...XX....XX....XX.......X-
-XXXXXXXXXXXXXXXXXXXXXXXXXXXXXXXXXXXXXXXXXXXXXXXXXXXXXXXXXXXXXXXXXXXXXXXXXXXXXXXXXXXXXXXXXXXXXXXXXXXXXXXXXXXXXXXXXXXXXXXXXXX-
