-------------------------------------------------XXXXXX----------------------------------------------
---------XXXXXXXXXXXXXXXXXX---------------------X---,--X---------------------------------------------
-------XX..................XX------------------X.XXXXXX.X--------------------------------------------
------X......................XX----------------X.X----X.X--------------------------------------------
-----X....,,,,,,,,,,,,,,,,,,,,,X---------------X,X--XXX.XX--XX--XX-----------------------------------
---XX...,,....................AXXHXXXXXXAX-----X,X--X.,,,XXXXXXXXAX----------------------------------
--X...,,.......................XX.E....E.X-----X,X--XA..,,..,,.....X---------------------------------
--X..,...E........E............XXH.......X-----X,X--XWA.,,..,,E.....X--------------------------------
--X..,.........................XXX,XXXX..X-----X,X--X...,E..,,....E..X-------------------------------
--X.,...............................H.X..X-----X,X--XAXXX,XX,,XX.....X-------------------------------
--X.,...........E....E................X..X-----X,X--XXX-XX--XX--X,,XXX-------------------------------
--X.,.................................X..X----X,,X-----XXXXXXXXXX++XXXX------------------------------
--X.,...XXXXXXXXXXXXXXXXX.............X..X----X,,X----XA...............X-----------------------------
--X,....XXXXXXXXXXX,,,XXXX............X..X----X,,X---X..,,,,,.,,,,,,,...X----------------------------
--X,...X.A....E.,.....H..XX...........XE.X---XX,,,X-X.A,..E.,.,..E...,...X---------------------------
--X,...,.......,..,,,.....,,.....E....X..XXXXX.E.EX-X..,....,.,......,,,..X--------------------------
--X,..X........,..,.,......,..........X....AXX,,,,XXX.,.....,.,.....,.,.,..X-------------------------
--X..X..,,,,,,,...,E,.......,.........XH....XX,,,,,XX,...,,,,.,,....,,...,..X------------------------
--XXX...,,,,,,,...,.,........X........XXX...XX,,A,,XX.,.,,,,,,..,,,,.,....,..X-----------------------
----X...,,,,,,,...,.,.,,,....XX.A.....XXX,,,XX....,XX..,,....XX.....,....E.,..X----------------------
----X........A,...,.,.,.,.....X........:X,..XX..E.,XX.E.XE..E.XXXX,,.,.....,.HX----------------------
----X..E.......,..,,,.,.,.E...XXX,,XXXXXX,..XX....,XX..,X.....X--X..,.E....,.HX----------------------
----X.........E,......,.,.....XXH...,,A,,,..XX,,,,,XX,,.XX..EXX--X...,.,.,,...X----------------------
----XH..........,.....,.,.,,,.XX....,,.,,,..XX,XXX,XX..,,XX.XXXX-XE...,.,....HX----------------------
----XXXXX,,,XXXXXX..E.,.,.,.,.XX....,,.,,,E.XX,X-X,XX,,..,XXX,,X-X.....,......X----------------------
----XXXXX,,,XXXXX-X...,,,.,.,.XX.E..XX,XX,..XX,XX.,XX.,,,.,XX,HX-X.E....,.ttt.X----------------------
---X.............XX.......,.,.XX....XX.XX,..XX,,,,,XX,.E,,AXX,,X-X......,.t.t.X----------------------
---X............HX-X....:.,.,.XX....XX,XX,..XX....,XX.,,...XXX+X-XA.E...,.ttt.X----------------------
--X...E.......E...X-X.....,.,.XX....,,.HX,..XX..W.,XX,....EXXX+XXXH.....,.....X----------------------
--X...XX.....XXX.HX-XA....,,,HXX....,,E.X,..XX....,XX.H....XX.H.XXXXXXXXXXXXXXX----------------------
--X..X--X...X--X..X-XXXX...XXXXX....,,..X,:.XX,,,,,X-X.....XX...XXXXXXXXXXXXXXXX---------------------
--XH.X--X...X--X..XXXX-X+++X---X....,,E.X,..XX,,,,,X-X.H...XX...X,,,,,,,,,,,,,,.X--------------------
--X...XX.....XXX..,,EXXX...XXXXX...H,,..X,..XX,,,,XX--XH...XX.E.X............H.,.X-------------------
--X...............,EHXX.........,..H,,..X,E.XXA..AX---X....XX...X.T.............,.X------------------
XXX...............,,EXXA.....E...,,.,,E.X,..XXX,,,X----X...XX...X................,.X-----------------
XEX...............XXXXX............HXX..X,..X-X,,X-XXXXX+++XX,,XX,,,,,,,,,,,.E....,X-----------------
X,X,,,,,,,,,,,,,,,X---XXXXXXXXXXXXXXXX..X,..X-X,,X-XA..,,,,,................,.....,X-----------------
X.,...............XXXXX..A.A....,.......X,E.X-X,,X-X......................H..,..:.,X-----------------
XH,...............,K+.,.........,E......X,..X--X,X-X........................H.,...,X-----------------
X.,.....,,,,,.....XXXXX.........,..B..B.X,..X--X.X-X.........................H.,..,X-----------------
XH,..E..,,,,,....HX---XXXXXXXXXXXXXXX+XXX,,,X--X,X-X..................E........,..,X-----------------
X.,............XXXX-XXXXXXXXXXXXXXXXX,X-X...X--XEX-X...........................,..,X-----------------
XH,............X----+H.H.H.H.H.H.H.H.HX-X.EHX--X,X-X....E......................,..,X-----------------
X.,...........X-----XXXXXXXXXXXXXXXXXXX-X+++X--X+X-X...........................,..,X-----------------
X.,...........XXXXXXXXXXXXXXXXXXXXXXXXXXXXXXX-XX,XXX...........................,..,X-----------------
X.,...........,.,,,,,.......A.XE,.HXXH.....:X-A...XX.....................E.....,.A,X-----------------
XE,...........,.,,E,,........AX,,..XX.......XXX...XX...........................,..,X-----------------
X.,...........,.,,,,,.........X.....+.......,....HXX...........................,..,X-----------------
X.,....,,,....XXXXXXXXXXXX..E.X....XX.......,.....XX.......H.XX+++XXX..........,E.,X-----------------
X.,...,...,...X-XE,.:....XX...X....XX..E....,.....XX........XXX,,,XXX..........,..,X-----------------
X.,..,....,...X-XXX,,,,,HXX...X....XX.......,.....XX.......XX.A.B.,E.X.........,..,X-----------------
XH,..,.....,...XXXX,,,,,.XX...X....XX.XX,,XX,.....XX.......XX,.,,,,..X.........,..,X-----------------
X.,..,.....,..........H,.XX...X....XX.XX,,XX,.....XX........+.,,.,,,,,.........,..,X-----------------
X.,..,..H..,..........H,.XX...XH...XX.....A.XXX...XX........+B,.K,E,B,.........,..,X-----------------
X.,..,......,..........,.XX...XH..EXX.......X-XE..XX........+.,,,.,,,,.........,..,X-----------------
X.,...,.....,......E...,.XX...X....XX.XX,,XXXXX...XX.......XX,,,.,,..X.........,..,X-----------------
X.,...,.....,..........,.XXE..XH...XX.XX,,XX,....AXX.......XX.H,,,.E.X.........,..,X-----------------
X.,...,....,...........,.XX...X....XX.......,.....XX.......XXXX,B,XXXX.........,..,X-----------------
X.,....,,,,............,.XX...XE...XX...E...,.....XX...E.....XX,,,XXX..........,..,X-----------------
X.,..E.................,.XX...X....XX.XX,,XX,..H..XX...........................,..,X-----------------
X.,....................,EXX...X....XXAXX,,XX,.....XX...........................,..,X-----------------
X.,.A..........E.......,.XX...X....XX.......,.....XX...........................,..,X-----------------
X.,,..................A,.XX...X..E.XX...E...XXX...XX...........................,..,X-----------------
-XA,,,,,,,,,,,,,,,,,,,,,.XX...X....XX.XX,,XXX-XE..XX..................E........,E.,X-----------------
--X........E.............XX...XH..AXX.XX,,XXXXX...XX...........................,..,X-----------------
---XXXXXXXXXXXX,XXXXAXXXX-X...X,,,,XX.......,.....XX...........E...............,..,X-----------------
--------------X+X--XXXXXXX..E.X.,:,XX.......,.....XX.........................A.,..,X-----------------
--------------X,X-X.H.........X.,,,XX.......,.....XX..........................,...,X-----------------
--------------X.X-XH..........X....XX......H,..H..XX.........................,....,X-----------------
------XXXXXXXXX.X-X...........XXXXXXX.......,.....XXH.............H.H.......,.....,X-----------------
------X..E....,.X-X.........:.XX,..........H,.....XXXXXX....X,,XX,,,,,,,,,,,......,X-----------------
------X.XXXXXXX.X-X....XXXXXXXX..,.........HXXX...X-----X,,XX,,XX.................,X-----------------
------X.X-----X.X-X...XX....XX..E.,.........X-XE..X---XXX..XX...+...............A,.X-----------------
------X.XXXXX-XEX-XE..XB....,+.....,........XXX...XXXX.....XX...+...E...........,.X------------------
------XA....X-X,X-X...X.E...XXXXXXXXX.......,....AXX.......XX.E.+..............,XX-------------------
------XXXXX.X-X,X-X...X..XXXX-------X....E..,.....XX.....XAXX...XXXXXXXXXXXXXXXX---------------------
----------XEX-X,X-X...X..XXXXXXXXXXXX.......,.....XX..XXX---X...X------------------------------------
----XXXXXXX.X-X,X-X...X.,XXA................,.....XH..XXXXX-X.H.X----------XXXXXXXXXXXXXX------------
----X.......X-X.X-X...X.,XX.................,.....XX..,,..,XXXXXX---------X..............X-----------
----X.XX,,,XX-X.X-X.E.X.,XX:.E..............,.....XH..,,E.,,X--XHXXX-----X.T..............X----------
----X.XX,,,XHXX.X-X...XE,XX........E........XXX...XXXXXXXXX,,XX,,...X---X..................X---------
----X.X.E..E.XX.X-X...X..XXH...............:X-B.BBX--------X,,,,,...X--X,,,,,,,,,,,,,,,.....X--------
----X.XA.....:X.X-X...X..XXXXXXXXXXXXXXX+XXXX-XX,XX---------X,,,X..E.X-X.............A.,.....XX------
----X.XXXXXXXXX,X-X..AX.........AX.,,,,,,,,AXX-X.X-XXXXXXXX--XXX-X..:X-X................,..E...X-----
----X.X-X.,E...HX-X...X..E.......,E,,..H..,.,XXX.XA...,,..,X-----X...X-XA................,......X----
----X.X-X.XXXXXXX-X...X..........X.,,,,,,,,.,+..AX..E.,,..,,X--XX....X-X..................,......X---
----XEX-X.X-------X...XAXXXXX...XXH.A......E,XXXXX.,,,XXX.,,,XX,,...X--XA...E..............,......X--
----X.X-X,XXXXXXXXX,,,XXXXXXX+++XXXXXXXXXXXXXXX,,,,...X--XX,,,,,,E..X--X........,,,.........,......X-
----X.X-X...,..XXH....,...........H.HH.,.,.XXX:........X---XXH,,XXXX---X........,H,..........,......X
----X+X-XXXXXX.XX.....,E,,,,,,,,,,,,,..,,..,.XX,,......X-----XXX--------X.......,,,...........,...H.X
----X.XXXXXXXXE,,....................,.,,.E,..XX.,,,,,..X----------------X....................,.....X
----H....XXHXX.,,....................,.,,.,..,.X..E...,,XAXXXHX-XXXXXXXXXX....................,.....X
----XXXXXXX,XXE,,AE...,,,,,,,,,,,,E,,..,,,.,,,,XX.......XX....X-X.......XX....................,.....X
--------XXX+XX.XXAA...,................,.,,,,..,X....E.A-XEEE.X-X.E..E..XXH...................,.....X
--------X...,.HXXXXXXXXXXXXXXXXXXXXXXXXXXX,.,,,.X......X-X....X-X.......XXXXXXXXX.............,.....X
--------X.XXXXXXXXXXXXXXXXXXXXXXXXXXXXXXXXX,,,,,XX+++XXXXXX,,XXXXX,,,,,XXXXXXXXXX........E....,.....X
--------XEX-----H.H,,,,,,,,,,,,,,,,,,,,.........XX...XXH................:..:..:XX.............,.E...X
--------X.X-XXXXX...............................XX,,,XX........................XX.............,.....X
--------X.X-A..+,..............E......E.........XX,.,XXH.......................XX.............,.....X
--------X.X-X,XXX......H.........B..A...........XXH.,XXH......................:XX.............,.....X
--------X.X-X.X-X.....XXXXXXXXXXXXXXXXXXXXX...,,XX,.,XX........................XXH............,.....X
--------X.X-X.X-X.E..X,,,,,,,,,,,,,,,,,,,XX...,,XX,.,XX...E...XXX.......XXX....XXXXXX.........,.....X
--------X.X-X.X-X,...X,...............E.,XH...,,XX,E,XX.......X-X.......X-X...:XXXXXX.........,.....X
--------X,XXX.X-X,..X,..................,HH...,,XX,.,XX.......XXX,,,,,,,XXX....X...XX.........,.....X
--------A...E.X-X,..X,,W..E.........,,,.,HX...,,XX,.,XX.........,H,,,,H,,......,.E.,,.........,.....X
--------XXXXXXX-X,..X,,,,,,,,,,,,,,,,.,,,HH...,,XX,.,,,.........,.++,++,,......,...,,.........,.....X
----------------X,..XXXXXXXXXXXXXXXXX,XXXXX...,,XX,.,,,.........,.+,,,+,,......,...,,.........,.....X
--------XXXXXX--X...XXXXXXXXXXXXXXXXX+XXXXX...,,XX,.,,,.........,.,,:,+,,......,...,,.........,.....X
--------HH..HX--X.E.,..............B..B..+,...,,XX,.,XX.........,.+,,,+,,......,.E.,,.........,.....X
--------X.,,,X--X...,....................+,..E,,XX,.,XX.........,.+++++,,......X...XX.........,.....X
--------X.,.,XXXX...,.............E......+,...,,XX,.,XX.........,H....H,,......XXXXXX.........,.....X
-------X<.,,,.+.,...,...................XXX...,,XX,.,XX.......XXX,,,,,,,XXX....XXXXXX.........,..W..X
-------X<.<T..+.,...,...................X-X...,,XX,.,XX.....E.X-X.......X-X....XXH............,.....X
-------XX.,,,.+.,...,...,,,,,,,,,,,,,,,.X-X...,,XX,.,XX,,,,,,,XXX.......XXX....XX.............,.....X
--------<.,.,XXXX...,...,.............,.X-X...,,XX,.,XX.,.,...,..........A.....XX.............,.....X
--------X.,,,X--X...,...,.,,,,,,,,,,,.,.X-X,..,,XX,.,XXXX+XXX.,................XX.............,.....X
--------A...AX--X..B,...,.E.........,.,.X-X,..,,XX,.,XXXX,XXX.,................XX.............,.....X
--------XXXXXX--X...XX..,.,.,,,,,,,.,.,.X-X,..,,XX,.,X..,,,.X.,....:...........XX.............,.....X
----------------X...XX..,.,.,..:..,.,.,.X-X,..,,XX,.,X..,H,.X.,................XX.............,.....X
----------------X...XX..,.,.,.,,,.,.,.,.X-X,..,,XX,,HX..,,,.X.,................XX.............,.....X
----------------X...XX..,.,.,.,.,.,.,.,.X-X,..,,XX...X......X.,........E.......XX.............,.....X
----------------X..EXX..,.,.,.,W,.,.,.,.X-X,..,,XX,,,XXXXXXXX.,................XX......E......,.....X
----------------X...XX..,.,.,.,.,.,.,.,.X-X,..,,XX...,,..A.AX.,...E............XX.............,.....X
----------------X...XX..,.,.,.,,,.,.,.,.X-X,..,,XX...,,.XXX.X.,............E...XX.............,.....X
----------------XE..XX..,.,.,..:..,.,.,.X-X,....XX.E.,,.X-XEX.,................XX.............,.....X
----------------X...XX..,.,.,,,,,,,.,.,.X-X,..E.XX...,,.XXX.X.,................XX............H,.....X
----------------X,,,XX..,.,.........,.,.X-X,....XX...,,.....X.A................XX.............,.....X
----------------X...XX..,.,,,,,,,,,,,.,.X-X,....XX...,,,,,,,XXXXXXXXXXX,,,XXXXXXX,,,,,,,,,,,,,,.E...X
----------------X..XXX..,.............,.X-X,....,,...,,,,,,,XXXXXXXXXXX+++XXXXXX,,,,,,,,,,,,,,,.....X
----------------X..XXX..E,,,,,,,,,,,,,,.X-X,E...,,..........,..H.H............XX..............,.....X
----------------X...XX..............E..HX-X,....,,......E...,.........E...E...AX..............,.....X
----------------X,,,XX..................X-X,....XXXXXXXXXXXXX.XXXXXXX,,,,,,,,XXX..............,.....X
----------------X..AXXH...............HAX-XH,,A,XXXXXXXXXXXXX,XX-XXXX,,,,,,,,XXX..............,.....X
----------------X,,AXXXXX,XXXXXXXXXXXXXXX-XXXXXXXX,,,A,,,,,....X-XH..H........................,.....X
----------------X...XXXXX,XXXXXXXXXXXXXXXX-XXXXXXX,...........,X-X............................,.....X
----------------X...XX..,.,.........,.,..X-X,,,,,,,...........,X-X............,,,.............,.....X
----------------X...XX..,.,.........,.,..X-XA......,,,,,,,,,..,X-X..........,,...,,...........,.....X
----------------X,,,XX..,.,.........,.,..XXX.......,+++++++,..,X-X...E....,,.......,..........,.....X
----------------XH..XX..,.,.........,.,..,,..E.....,+:...:+,..,X-X.......,..........,,........,.....X
----------------X.,,XX..,.,,,,,,,,,,,.,..,,........,+.....+,..,X-X.....,,......,,.....,.......,.....X
----------------X,..XX..,E..A....H..E.,..,,........,+..W..+,..,X-X....,......,,..,,....,......,.....X
---------------:,.E.XX..,,,,,,,,,,,,,.,..,,........,+.....+,..HX-X....,....,,......,,..,......,.....X
---------------XX,..XX..............,.,..XXX.......,+:...:+,..,X-X...,...,,.A.....E..,..,.....,...A.X
----------------XE,,XX...........,,,,.,,.X-X,...E..,+++++++,E.,X-X...,..,............,..,.....,.....X
----------------X...XXA.....E....H.H.H.,.X-X,......,,,,,,,,,..,X-X...,..,.............,.,.....,.....X
----------------X+++XXXXXXXXXXXXXX,,,,,XXX-X,A................,X-X...,..,.............,..,....,....X-
----------------X...X------------X.....X---X,,,A,,,......,,,,,,X-X..,..,...............,.,...,.....X-
----------------XA..XXXXXXXXXXXXXX,,,,,XX--XXXXXXXXX,,,,XXXXXXXX-X..,..,...............,.,...,.....X-
----------------X..,.........B...........XXXXXXXXXXX,,,,XXXXXXX--X..,..,...............,.,...,.....X-
----------------X.,.,,,,,.......,,,,,.......H.H.H.........A.A.XXX...,..,.,,,,,,,,,,,...,.,...,.....X-
----------------X,..,...,..B....,...,.........................X.....,..,.,,,,,,,,,,,...,.,...,.....X-
----------------X...,.E.,,,,,,,,,...,.........................X....,...,.,,B.B.B.B,,...,..,..,.....X-
----------------X...,...............,................E........,....,..,..,,.......,,...,..,..,.....X-
----------------X...,.....B......E..,.........................,....,..,..,,B.....B,,...,..,.,.....X--
----------------X...,...............,.........................,....,..,..,,...E...,,...,..,.,.....X--
----------------X...,...,,,,,,,,,...,.......XXX,,,,,XXXXX.....,....,..,..,,B.....B,,...,..,.,..E..X--
----------------X...,...,..B....,...,......X-XX,,,,,XXXX-X....,....,..,..,,.......,,...,..,.,.....X--
----------------X...,,,,,.......,,,,,.....X-X.,.E.E..,..X-X...,....,..,..,,B.B.B.B,,...,..,.,.....X--
----------------X...E........B.........A.X-X,.,......,,,XXX...,....,...,.,,,,,,,,,,,...,..,.,.....X--
----------------X.........XXX,,,,,,,,,XXX-XH.,XXXXXXXX,,XX,...X.....,..,.,,,,,,,,,,,...,.,..,.....X--
----------------X........X-XX,,,,,,,,,XXXXH.,XXXXXXXXX,,XXX...X.....,..,...............,.,.,.....X---
----------------X.......X-X.,.E..........,.,XXA....TXX,,X-X,,,X.....,..,...............,.,.,.....X---
-----------------X......XX,,,....E..E...H,,XX.......XXE,X-X...X.....,..,......,,.......,.,.,.....X---
------------------X,,,,,XX,,XXXXXXXXXXXXXXX-XA,,,,,HXX,,X-X,,,X.....,...,.E...,,......,..,.,.....X---
------------------XH....XXA.X--------------XX.,.W.,.XX,HX-X...X......,..,.....,,......,.,..,.....X---
------------------X.....XX,,X-XXXXXXXXXXXXXX,.,,,,,HXX,,X-X...X......,..,............,..,..,.....X---
------------------XH....XX..X-X.t.....E.,..X,.......XX,HX-X...X......,...,.........A.,..,..,.....X---
------------------X...E.XX,,X-XttW.E....,,,X,.ttt..XXX,,XXX.E.X.......,..,..........,...,.,......X---
------------------XH....XX..X-XXXX,,,,XXX.HXX.t.t..XX.,,,,,...X.......,...,,.......,...,..,.....X----
------------------X.....XX,,XXXXXX,,,,XXX,,XX.ttt.AXXE.,,,,,..X........,....,,...,,....,..,.....X----
------------------X,,,,,XXE,,...........,,,XXXXXXXXX-X.,,,,,.XX.........,.....,,,.....,...,.....X----
-----------------X......XX..,......:..E.,..XXXXXXXXX--XXXXXXXX...........,..........,,...,....A.X----
----------------X.......X-X.,.A.A.......,.XX..W.....X-------X.A...........,,,.....,,.....,.....X-----
----------------XA,,,,,,,X-XXXXXXXXXXXXXXXX.,,,,,E,,,XXXXXXXX................,,,,,......,......X-----
----------------X.,.....,.XXXXXXXXXXXXXXXX..,.......,.....AXX...........................,.....X------
----------------X.,.....,,,,,,,.........,,,,,.......,,,,,..XX..........................,..:..X-------
----------------X.,...........,.........,...............,..,,.........................,......X-------
----------------X.,...........,.....E...,...............,..XX.........................,.....X--------
----------------X.E....E......,.........,...............,..XX........................,......X--------
----------------X.,,,,,,,,,,,,,.........,,,,,,,,E,,,,,,,,.AXX........................,.....X---------
----------------X:.........................................XX.......................,.....X----------
----------------X...........H.H.H.H.H....................AAXX......................,......X----------
----------------XXXXXXXXXXXXXXXXXXXXXXXXXXX+XXXXXXXXX++XXXXXX......................,.....X-----------
--------------------------XXXXXXXXXXXXX---X,X--XXXXXX..XXXXXX............E........,...E.X------------
--------------------------H.....E....HX---X.X-XH..........A.X....................,......X------------
--------------------------X.XXX,,,XXX.X---X.XX..............,....................,.....X-------------
--------------------------X.XXX,,,XXX.X---X.XX..............,...................,......X-------------
--------------------------X.,......,,.X---X.XX..E........E..,...................,.....X--------------
--------------------------XE,..,,,.,,EX---X.XX..............,..................,.....X---------------
--------------------------X.,..,K,.,,.XXXXX.XX......E.......,.................,......X---------------
--------------------------X.X..,,,.XX......AXX..............X.................,.....X----------------
--------------------------XtX......XXXXXXXXXXX............H.X.H..............,.....X-----------------
--------------------------X.X......XXXXXXXXXXX.............XX................,.....X-----------------
--------------------------XXX.......,.....................X-X,,,,,,,,,,,,,,,,.....X------------------
----------------------------X.......,,.....K.............X---X....................X------------------
----------------------------X.......:,,,,,,,,...........X-X>>>XX.................X-------------------
----------------------------X..E.....,,,,,,,,..........X--X...X-X.............H.X--------------------
----------------------------X.......,,,,,,,,,.E.......X-XXX...XXXX..............X--------------------
----------------------------XA......:,.....K.........X--H..E....X-XXXXXXX,XXXXXX---------------------
----------------------------XXX.....,.............A.X---X.......XXXXXXXXX+X--------------------------
-------------------------------XXXXXXXXXXXXXXXXXXXXX----X..,,.............X--------------------------
--------------------------------------------------------XXXXXXXXXXXXXXXXXXX--------------------------
