-----------------------------------------------------XXXXXXXXXXX-------------
-----------------------------------------------------XE.tEtE,E.X-------------
-----------------------------------------------------X..XXXX,..X-------------
-----------------------------------------------------XE.X--X.E.X-------------
-----------------------------------------------------XttX--XtttX-------------
-----------------------------------------------------X..X--Xt..X-------------
-----------------------------------------------------XXXX--XXXXX-------------
-----------------------------------------------------------------------------
----------------------------------------------------XXXXXXXXXXXXXXX----------
----------------------------------------------------X....,E.E,....X----------
----------------------------------------------------X.:..,,,,,..T.X----------
----------------------------------------------------X.............X----------
--------------------------------------------------XXX,,,,,,,,,,,,,XXX--------
--------------------------------------------------X.,.H..W......H.,.X--------
--------------------------------------------------XXX,,,,,,,,,,,,,XXX--------
----------------------------------------------------X.............X----------
----------------------------------------------------X.A....T....A.X----------
----------------------------------------------------X.............X----------
--------------------------------------------------XXX,,,,,,,,,,,,,XXX--------
--------------------------------------------------X.,.H.........H.,.X--------
--------------------------------------------------XXX,,,,,,,,,,,,,XXX--------
----------------------------------------------------X.............X----------
----------------------------------------------------X.T.E.....E...X----------
----------------------------------------------------X.............X----------
----------------------------------------------------XXXXXXX+XXXXXXX----------
----------------------------------------------------------X+X----------------
----------------------------------------------------------X,X----------------
----------------------------------------------------------XEX----------------
--------------------------------------------------XXX-----X.X----------------
--------------------------------------------------X<X-----X.X----------------
--------------------------------------------------X.X-----X.X----------------
--------------------------------------------------X<X-----X.X----------------
--------------------------------------------------X.X-----XHXXXXXXX----------
--------------------------------------------------X<X-----X......WX----------
--------------------------------------------------X.X-----XXXXXXX.X----------
--------------------------------------------------X<X-----------X.X----------
------------------------------------------XXXXXXXXX,XXXXXXXXX---X.XXXXXXX----
------------------------------------------X:....A.....A.....X---X...:...X----
XXXXXXXXXXXXXXXXXXXXXXXXXXXXXXXXXXX-------X.................XXXXX.XXXXX.X----
X.................................X-------X,,W.....,,.....,,XA.E..X---X.X----
X..................,,,,,,,,,,,,,,,X-------X..,...,,..,...,..XXXXX.X---X.X----
X................,,...............X-------X..,...,...,...,..X---X.X---XHX----
X..............,,.................X-------X.E.,.,..:..,.,.E.X---X.XXX-X.XXX--
X...........,,,...................X-------X...,.,.....,.,...X---X...X-X..EX--
X.........,,.......,,,,,,,,,,,,,,,X-------X,,,...,,..,...,,,X---XXX.X-XXXXX--
X.......,,.......,,...............X-------X........,,.......X-----XAX--------
X.....,,.......,,.................X-------X.................X-----X.XXXXX----
X.....,......,,...................X-------X.................X-----X.....X----
X.....,....,,.....................X-------XXXXXXXX...XXXXXXXX-----XXXXX.X----
X....,...,,.......................X--------------X+++X--------XXXXX---X.X----
X....,...,........................X--------------X+++X--------X.E.X---X.X----
X....,..,.........................X--------------X...X--------X,,,X---XHX----
X....,..,.........................X--------------X...X--------X...X---X.XXXXX
X...,...,.........................X-------------X.....X------X.....X--XW...:X
X...,...,.........................X------------XH....A.XX:X-X.H...H.X-X.XXX.X
X...,..,..........................X------------X.......XX,XXX.......X-X.X-X.X
X...,..,..........................X---XXXXXXXXXX,......X....X.......XXX.X-X.X
X..,...,.............XXXX,,,,,XXXXX---XH.H.H.,,,,..W...,..:.,...H...,...X-XEX
X..,..,..............X:XX,,,,,X:X-----X.XXXXXXXX.......X....X.......XXXXX-XXX
X..,..,..............XX.........X-----XHX------X.......XX:XXX.......X--------
X..,..,..............XX.........X-----X.X------XH....H.XXXX-X.A...H.X--------
X.,...,..............,,.........X-----XHX-------X.....X------X.....X---------
X.,..,...............,,...,>,...XXXXXXX.X--------XX,XX--------X,,,X----------
X.,..,...............,,...>>,E...H.H.H.HX---------X+X---------X.E.X----------
X.,..,...............,,...,,,...XXXXXXXXX-XXXXXXXXX,XXXXXXXXX-XXXXX----------
X.,...,..............,,.........X---------X.................X----------------
X..,..,..............XX.........X---------X.............,,,,X----------------
X..,..,..............X:........:X---------X.............,..AX----------------
X..,..,..............XXXX,,,,,XXX---------X.,,,,+.......W.E.X----------------
X..,...,.............XXXX,,,,,XXXXX-------X.,...+.......,..HX----------------
X...,..,..........................X-------X.,,,.+.,,,,,.,,,,X----------------
X...,..,..........................X-------X..E,.+.,...,...,HX----------------
X...,...,.........................X-------X...,H+.,,,,,...,,X----------------
X...,...,.........................X-------X..H,.+..........HX----------------
X....,..,.........................X-------X.,,,.+..........HX----------------
X....,..,.........................X-------X.,.:.+...........X----------------
X....,...,........................X-------X.,,,,+.....,,,...X----------------
X....,...,,.......................X-------X..W........,.,...X----------------
X.....,....,,.....................X-------X...........,,,...X----------------
X.....,......,,...................X-------X..............W..X----------------
X.....,,.......,,.................X-------X.................X----------------
X.......,,.......,,...............X-------X......A...A.....:X----------------
X.........,,.......,,,,,,,,,,,,,,,X-------XXXXXXXXX,XXXXXXXXX----------------
X...........,,,...................X---------------X,X------------------------
X..............,,.................X-----------XXXXX.XXXXX--------------------
X................,,...............X-----------X.........X--------------------
X..................,,,,,,,,,,,,,,,X-----------X.........X--------------------
X.................................X-----------X.E.....E.X--------------------
XXXXXXXXXXXXXXXXXXXXXXXXXXXXXXXXXXX-----------X.........X--------------------
----------------------------------------------X.........X--------------------
----------------------------------------------XXXXX++XXXX--------------------
