XXXXXXXXXXXXXXXXXXXXXXXXXXXXXXXXXXXXXXXXXXXXXXXXX----------------------------------------XXXXXXXX---------------
X,,,,,,,,,,,,,,,,,,,,,,,,,,,,,,,,,,,,,,,,,,,,,,XXXXXXXXXXXXXXXXXXXXXXXXXXXXXXXXXXXXXXXXXXXXXXXXXXXXXXX----------
X,.............,...............................XXH.HH.HH..E..A.AA.AA.AA.AA.AA.AA.AA.AA..H..X..t,.....X----------
X,.............,..:............................XXH.HH.HH.....A.AA.AA.AA.AA.AA.AA.AA.AA.....X..t,.E.E.X----------
X,.............,...............................L+.......................................H..X..t,.....X----------
X,.............,...........E...................L+H.HH.HH.....A.AA.AA.AA.AA.AA.AA.AA.AA.....X..t,.E.E.X----------
X,.............,......E........................L+H.HH.HH....,,,,,,,,,,,,,,,,,,,,,,,,,,,.H..X..t,.....X----------
X,......H......,.................E.............L+...........,.........................,....X..t,.E.E.X----------
X,.............,...............................L+H.HH.HH....,,,,,,,,,,,,,,,,,,,,,,,,,,,....X..t,.....X----------
X,.............,...............................XX...................A...........A......,,..X..t,.E.E.X----------
X,.............,..............................:XX.........E...A..A......E.....H...A....T,..X..t,.....X----------
X,.............,...............................XX...................A...........A..........X..t,.E.E.X----------
X,......E......,...............................L+...,,,.....,,,,,,,,,,,,,,,,,,,,,,,,,,,.E..X..t,.....X----------
X,.............,...............................XX...,.,.....,.............K,..........,....X..t,.E.E.X----------
X,.............,...............................XX...,H,.....,,,,,,,,,,,,,,,,,,,,,,,,,,,....X..t,.....X----------
X,.............,...............................XX...,.,....................................X..t,.E.E.X----------
X,.............,...............................XX...H.,......A.A.A.A.A.A.A.A.A.A.A.A.A.,,..X..t,.....X----------
X,.............,...............................XX...,.,................................T,..X..t,.E.E.X----------
X,.............,...............................XX...,.,.....,,,,,,,,,,,,,,,,,,,,,,,,,,,....X..t,.....X----------
X,.............,...............................XX...,H,.....,.........................,.A..X..t,.E.E.X----------
X,.........E...,................XXXX...........XX...,.,.....,,,,,,,,,,,,,,,,,,,,,,,,,,,....X..t,.....X----------
X,.............,...............X----X..........XX...H.,.................................A..X..t,.E.E.X----------
X,.............,...............X----X..........XX...,.,.E...H.H.H.H.H.H.H.H.H..H.H.H,,.....X..t,.....X----------
X,.............,..............X------X.........XX...,.,.............................T,..A..X..t,.E.E.X----------
X,.............,..............X------X.........XX...,H,.....,,,,,,,,,,,,,,,,,,,,,,,,,,,....X..t,.....X----------
X,.............,.............X--------X........XX...,.,.....,.........................,.A..X..t,.E.E.X----------
X,.............,.............X--XXXX--X...E....XX...H.,.....,,,,,,,,,,,,,,,,,,,,,,,,,,+....X..t,.....X----------
X,.............,.............X-X....X-X.....E..XX...,.,.....,.........................+.A..X..t,.E.E.X----------
X,.............,.............X-X..E.X-X........XX...,.,.....,H.H.H.H.H.H.H.H.H.H.H.H.H+H...X..t,.....X----------
X,.............,.............XX......XX.E.E....XX...,H,.....,.........................+....X..t,.E.E.X----------
X,.............,.............XX......XXE.......XX...,.,.....,,,,,,,,,,,,,,,,,,,,,,,,,,+....X..t,.....X----------
X,.............,.........E...X..E..E.XX...EE...XX...H.,.....,.........................,....X..t,.E.E.X----------
X,.............,.............X.......XX......E.XX...,,,.....,,,,,,,,,,,,,,,,,,,,,,,,,,,.H..X..t,.....X----------
X,.............,..........A..X.......XX.E......XX..........................................X..t,.E.E.X----------
X,.............,.............X.A.E...XX........XX.......E....H.H.H.H.H.H.H.H.H.H.H.H.H..H..X..t,.....X----------
X,.............,.............X.......XX.E.XXXXXXX..........................................X..t,.E.E.X----------
X,......A......,.............X.E....EXX...X.....X...........,,,,,,,,,,,,,,,,,,,,,,,,,,,....X..t,.....X----------
X,.............,.............X.......XXA.AX.....X...........,.........................,W...X..t,.E.E.X----------
X,......A......,.............XXX,,,,,XX...X.....X...........,,,,,,,,,,,,,,,,,,,,,,,,,,,....X..t,.....X----------
X,.............,...............X.....XXXXXX..H..X......................................W...X..t,.E.E.X----------
X,......A...E..,...............+....:XX...X.....XXXXXXX.........W...W...E..................X..t,.....X----------
X,.............,....:..........+.....XX...>.....XA..A.X.....................,,.W.W.W.W.W...X..t,.E.E.X----------
X,......A......,...............+.A...XX.E.>.....X.....X.....................T,.............X..t,.....X----------
X,.............,...............X.....L+...X.....X.....+...........W...W....................X..t,.E.E.X----------
X,.............,...............XXX...XX...X.....XW..A.X....................................X..t,.....X----------
X,.............XXXXXXXXXXXXXXXXXXX+++XXXXXXXX+XXXXXXXXX,,,XXXXXXXXXXXXXXXXXXXXXXXXXXXXXXXXXX..t,.E.E.X----------
X,.............X..........+...E..X...XX.........X.........XX.....,,,.,,....,....,....,....,X..t,.....X----------
X,.............X.E......A.X.....HX...XX.........+.........+L.....,,,.,,,,,,,,,,,,,,,,,,,,,,X..t,.E.E.X----------
X,.............X..XX..X...XE.....X...++...:.....+.......A.+L.........,,,.,.,,.,.,.,.,,.,.,,X..t,.....X----------
X,.............X.,XXH.X...X......X...++.E.......+.........+L.........,,,.,,,,.,,,,,.,,,,.,,X..t,.E.E.X----------
X,.............X,AXX,,X,,,X,,,,..X...++.........X.........XX...............................X..t,.....X----------
X,.............X,,XX,,X,,,X...,..+..EXX.........XXXXXXXXXXXX...............................X..t,.E.E.X----------
X,.............XXXXXXXXXXXXXXXXXXX...XX.........X........,XX,,,,...........................X..t,.....X----------
X,.............XXXXXXXXXXXXXXXXXXX...,,.....E...X.A..E...,XX,,,,...........E...............X..t,.E.E.X----------
X,.............X,,XX..X,,,X......X...XX.........X........,XX.,,,......E.........E...E....A.X..t,.....X----------
X,.............X,AXXE.X,,,X,,,,,,X..XXXXXXXXXXXXX........,XX.,.....A.......................X..t,.E...X----------
X,.............X.,XX..X...XH.....X..XX,,,....:X:...E..H..,XX.,,,.........,,,...W...........X..t,.....X----------
X,.............X..XX..X...X......X..XXHE,.....X.A........,XXXXXX.........,,,...............XXXXXXXXXXX----------
X,.............X....E.....X...E..X..XX,.,...A.X...........XXXXXX.........,,,......,,,......X--------------------
X,.............X.H....:...+......+..XXH.,.....X....A.A....XXEH.X..................,,,...W..X--------------------
X,......E......XXXXXXXXXXXXXXXXXXX..XX,,,.....XA.A......H.XX...X..................,,,......X--------------------
X,.............XXXXXXXXXXXXXXXXXXX..XXH..K....X...........XX.E.X.......A...................X--------------------
X,.H...........X..A..A..,.A...A..X..XXXXXXXX+XX:XXXXXXXXX+XX+XXX+++XX......................X--------------------
X,.............X........,........X..XXXXXXXX+XXXXXXXXXXXX+XX+XXX+++XX.,,.,,,,,.,,,,.,,,,.,,X--------------------
X,.............X....E...,..A...E.X.E...E......,.....................X.,,.,.,.,.,,.,E,,H,E,.X--------------------
X,.............X.A......,....H...X............,.....................X.,,,,,,,,,,,,,,,,,,,,,X--------------------
X,.............X........,........X.............,....................X.,....,....,....,,....XXXXXXXXXXXXXXXXXXXXX
XXXXXXXX,,,XXXXX,,,,,,+XXX+,,,,,,XX+++XXXXXXX...XXXXXXXXXXXXXXXLXXXXXXXXXXXXXXXXXXXXXXXXXXXX,,,,,,,,,,,,,,,,,,,X
XXXXXXXX,,,XXXXX.......................,,,.XX...X..E..A...:X.HX....,,,,,,,,,X..,..............................,X
XX.............X,,,,.....................,.XX...+..........XH.X....,,,,,,,,,,..,..............................,X
XXH............X.,.,................E..,,,.XX...XX....,,A,.X..X.............,..,........:.....................,X
-X............HX.,,,..........,,,E.....,.,.XX...WX....,..,.X.HXH..........H.X..,...:.....................E....,X
-X..E.E.E.E.E..X.,,,..........,.,,,,,,,,,,,XX...+X.E..,..,.XH.X,...E.......XXX.,..............................,X
-X.............X.,.,.H........,.,.....E....XX...WX....,..,AX.AX............X-X.,..............................,X
-X........E.E..X,,,,.....E....,.,..........XX...+X....,,,,.X..X.......E....X-X.,..............................,X
-X.............X.,.,..........,,,,,,,,,,,,,XX...XXX+XXXXXXXX+XX.............X..,..............................,X
-X..E.....E.E..X.,,,.H....................XXX...X.E.........E.X............:X:.,,,,,,,,,,,,,,,,,,,,,,,,,,,,,,,,X
-X.............X.,........................X-X...X.............,.............X..,..............................,X
-X....E...E.E..X.,,,......H...............X-X...X.............,....E........+..,..W.....W....W..........<.....,X
-X.............X,,,,......................X-X...X......,,,....,...........E.+..,.....W.....W....W.........<...,X
-X......E.E.E..X.,.,.H......,,,.,,,,.,,,,.XXX,,,X.....E,.,....X.............+..,.......................<.<....,X
-X.............X.,,,........,.,.,,.,.,,,,E,XX...X.E....,.,...:X.............X..,,,,,,,,,...,,,,,,,,,,,,,,,,,,,,X
-X........E.E..X.,..........,,,,,,,,,,,,,,,XX...X....,,,.,....+............:X:.,.......,...,..................,X
-X.............X.,,,........,....,....,,...XX...XXXX,XXXXXXXXXXXXX.........XXX.,.......,...,..................,X
-X.............XXXXXXX+++XXXXXXXXXXXXXXXXXXXX...X:XX,:XXXXXXXXXXXX.........X-X.,.......,...,..................,X
-X.............XXXXXXX,,,XXXXXXXX...............X.....X.,,,......X.........X-X.,...:...,.W.,..................,X
-X..........E..,....:......:....X...............X.....X.XX,X.XX..X..........X..,.......,...,..................,X
-X.............,................X...............X..E..+.XX:X,XX+XX..E..E....X..,.......,...,..................,X
-X..........E..,................+...............X.....X.XX,X,XX+XX..........,.H,.......,.W.,..................,X
-X.............,................+..........E....X.....XXXXXXXXX..,..........X..,.......,...,..................,X
-X.A........E..,......,,,,,,....+...............X.....+.XXKX,XX+XX,,,XXXXXXXXXXXXXXX...,...,..................,X
-X.............,......,....,....X...............X..E..X.XX.X.XX+XX...XXXXXXXXXXXXXXXX..,.W.,..................,X
-X..........E..,......,....,..E.X...............X.....X.XXEXAXX..X......E.E.E.E...H.XX.,...,..................,X
-X.A...........,......,H...,....X.A.............X.....X.XX+X.....X.H............E....XX,...,..................,X
-X..........E..,......,,,,,,....X...............X...E.X..........X......E.E.E.E....H.XX,.W.,..................,X
-X.............,......,....,....X...............X.....X..........X...............E...XX,...,..................,X
-X.A........E..,......,....,....X........E......XXXXX,XXXXXXXXXXXX......E.E.E.E.....XX.,...,..................,X
-X.............,......,....,....X................XX,...,.........XXLXXXXXXXXXXXXXXXXX..,.W.,..................,X
-X.............,......,,,,,,....X..............A.XX,...,.........XBBXXXXXXXXXXXXXXXX...,...,..........E.......,X
-X.............,......,HB.B,....X................XX,...,.........XBBXX.................,...,..................,X
-X.A........E..,......,..B.,....X..............A.XX,...,....E....XBBXX..:..............,.W.,..................,X
-X.............,......,.H.B,....X................XX,...,.........XXXXX.................,...,..................,X
-X..........E..,......,....,....X................XX,...,...............................,...,..................,X
-X.A...........,......,...E,....X......E.........XX,...,,,,,,,,,,,,,,,,,,,,,,,,,,,,,,,,,.W.,..................,X
-X.............,......,.H..,....X................XX,.......................................,...............:..,X
-X.............,.H....,,,,,,....X................XX..................W..W..W..W..W..W..W...,..................,X
-X.A........E..,................X................+,........................................,..................,X
-X.............,................X................XX....,,,,,,,,,,,,,,,,,,,,,,,,,,,,,,,,,,,,,..................,X
-X......E......XXX+XXX,,,,,,X+++XXXX,,,,,,,X+++XXXX....,....,,,,,,,,,,,,,,,,,,,,,,,,,,,,,,,,,,,,,,,,,,,,,,,,,,,X
-X.............XXX+XXX,,,,,,XXXXXXXX,,,,,,,XXXXXXXX....,....,..........................XXXXXXXXXXXXXXXXXXXXXXXXX
-X.A...........XX................................X.....,....,.XXXXXXXXXXXXXXXXXXXXXXXXX-------------------------
-X.............XX................................,.W...,....,.X-------------------------------------------------
-X.............XX................................,...H.,....,.X-------------------------------------------------
-X.A...........XX................................,,,,,,,..:.,.X-------------------------------------------------
-X.............XX.H..............................,..........,.X-------------------------------------------------
-X.............XX................................,..........,.X-------------------------------------------------
XX.............XX................................,..........,.X-------------------------------------------------
XXXXXXXX,,,XX+++X................................,,,,,,,,,,,,.X-------------------------------------------------
XXXXXXXX,,,XXXXXX...................H............,XXXXXXXXXXXXX-------------------------------------------------
X,.BBBB..........................................,X-------------------------------------------------------------
X,.B.............................................,X-------------------------------------------------------------
X,.BW............................................,X-------------------------------------------------------------
X,.B....................E........................,X-------------------------------------------------------------
X,BB.............................................,X-------------------------------------------------------------
X,B.W............................................,X-------------------------------------------------------------
X,......E........................................,X-------------------------------------------------------------
X,..W............................................,X-------------------------------------------------------------
X,...............................................,X-------------------------------------------------------------
X,.........................................E.....,X-------------------------------------------------------------
X,..W............................................,X-------------------------------------------------------------
X,...............................................,X-------------------------------------------------------------
X,...............................................,X-------------------------------------------------------------
X,...............................................,X-------------------------------------------------------------
X,...............................................,X-------------------------------------------------------------
X,...............................................,X-------------------------------------------------------------
X,...............................................,X-------------------------------------------------------------
X,...............................................,X-------------------------------------------------------------
X,...............................................,X-------------------------------------------------------------
X,....................E...............E..........,X-------------------------------------------------------------
X,...............................................,X-------------------------------------------------------------
X,........E......................................,X-------------------------------------------------------------
X,............................................BBB,X-------------------------------------------------------------
X,BBB.........................................B..,X-------------------------------------------------------------
X,..B.........................................BA.,X-------------------------------------------------------------
X,.HB.......................H.................B..,X-------------------------------------------------------------
X,..B.........................................BA.,X-------------------------------------------------------------
X,..BBBBB.........K........BB.......BBBBBBBBBBBBB,X-------------------------------------------------------------
X,.H....B..................BB.......B....B.......,X-------------------------------------------------------------
X,...H..B...........................BA.A.B.A.A.A.,X-------------------------------------------------------------
X,,,,,,,,,,,,,,,,,,,,,,,,,,,,,,,,,,,,,,,,,,,,,,,,,X-------------------------------------------------------------
X.................................................X-------------------------------------------------------------
X.................................................X-------------------------------------------------------------
X.................................................X-------------------------------------------------------------
X.................................................X-------------------------------------------------------------
X.................................................X-------------------------------------------------------------
X.................................................X-------------------------------------------------------------
X.................................................X-------------------------------------------------------------
X.................................................X-------------------------------------------------------------
X.....................................XXXXXXXXXXXXX-------------------------------------------------------------
X............XXXXXXXXXXXXXXXXXXXXXXXXX--------------------------------------------------------------------------
XXXXXXXXXXXXX---------------------------------------------------------------------------------------------------
