XXXXXXXXXXXXXXXXXXXXXXXXXXXXXXXXXXXXXXXXXXXXXXXXXXXXXXXXXXXXXXXXXXXXXXXXXXXXXXXXXXXXXXXXXXXXXXXXXXXXXXXXXXXXXXXXX
X,.............................................................................................................,X
X.,...........................................................................................................,.X
X..,.........................................................................................................,..X
X...,.......................................................................................................,...X
X....,.....................................................................................................,....X
X.....,...................................................................................................,.....X
X......,...............................................E.............................E...................,......X
X......,............................E...................................................................,.......X
X.......,..............................................................................................,........X
X........,............................................................................................,.........X
X.........,..........................................................................................,..........X
X..........,........................................................................................,...........X
X...........,......................................................................................,............X
X............,....................................................................................,.............X
X.............XXXXX,XX,XXXXXXXXXXXXXXXXXXX,XXXXXXXXXXXXXXXXXXXXXXXXXXXXXXXXXXXXXXXXXXXXXXXXXXXXXXX..............X
X.............XXE..E.X..HX.H,....,E,..,,,..,.....,,............................................EXX..............X
X.............XX.....X...X..,....,.,..H,,E.,.....,,.......H........................E............XX..............X
X.............XX.....X..EX..,....,.,....,..,.....,,...E..,,,,,,,,,,..........H............HH.H..XX..............X
X.............,,.H...X...X..,....,.,....,..,.....,,......,........,.........,,,,,,,,,,,..,,,,,..XX........E.....X
X.............XX,,,,.XXXXX..,....,.,....,..,.....,,......,........,......E..,........E,..,...,K.XX..............X
X.............,,,,,,.XXXXX..,....,.,....,..,.....,,......,........,.........,.........,..,...,H.XX..............X
X.............XX....AX.E....,....,.,....,..,.....,,......,...E....,.........,.........,..,.E.,..XX..............X
X.............XXXXXXXX.,,,,.,....,.,....,..,,,,..,,......,........,.........,.........,.E,...,..XX..............X
X.............XX.,,H.X.,..,.,.,,,,.,....,..,,H,..,,......,......E.,.........,.........,..,...,.EXX..............X
X.............,,.,,..X.,E.,.,.,H...,..E.,..,.....,,....E.,........,..E......,.........,..,...,..XX..............X
X.............XX.,,..X.,..,.,.,H...,....,..,.....,,......,,,,,,,,,,.........,.........,..,...,..XX..............X
X.............XX.....,.,..,.,,,,,,.,,,,,,..,,,,,,,,.........................,,,,,,,,,,,..,,,,,..XX..............X
X.............XXXXXXXX.,..,..................E....,................................E............XX..............X
X.............XXXXXXXX.,..,................E......,.............................................XX..............X
X.............XXE.,,.,.,,,,............XXXXXXX,XXXX,,,,,,,XXXXXXXX......XXXXXXXXX,,,,,,,,,,...E.XX..............X
X.............XX..,,.X................,XXXXXHX,XBXX......XXXXXXXXX......XXXXXXXXX,........,.....XX..............X
X.............,,..,,.X............E..XX....X...X..,X....X.+HX...EX......X.A..XE.,.XE......,.....XX..............X
X.............XX,,,A.X.E.............X-XE..X...X...XX,,,XX..X....X......X....X...XX...E...,.....XX..............X
X.............XXXXXXXX...............XXX...XH..X...XX...X.A.X....X.E....X.E..X..E.X.......,.....XX..............X
X.............XXHXH..X..XXXXXXXXXXXX.,,....X...X..XXX...X...XH.HHXE....EX...HXE...X.,,,,,.,.A...XX..............X
X.............XX.....,..X...X.HX..AX.,,...HX...X...HX...XAXXXXXXXXXX,XXXXXXXXXXXXXX.,...,.,.....XX..............X
X.............XXE....X..X...X.HX...XXXXXXXXXXXXX...XXE..XXXXXXXXXXXE.:X..XX..XX..XX.,...,.,,,,,.XX..............X
X.............,,....EX..X...X..X..AX......EXH.....,XX...X.<....E.:X...XE.XX..XX..XX.,...,.,,E.,.XX..............X
X.............XXXXXXXX.EXA.EX..X...X.......X......,XX...X....E....X..HX..XXE.XX..XX.,...,.,,..,.XX..........A...X
X.............XXEXXXXX..XXXXXXXXXXXXX..HH.HX..E...,XX...X.:,,,,,E.X..HXE.XX..XX..XXE,...,E,,..,.XX..............X
X.............,,.....X..XXXXXXXXXXHXXXXXXXXX,XXXXXXXX...+..,...,..X...X..XX..XXE.XX.,...,.,,..,EXX..............X
X.............XX...E.X..X..HX.HXE..XX........X.....XX...+..,...,..XE.HX..XXE.XX..XX.,...,.,,..,.XX..............X
X.............XX.E...X..X..HX..X..HXX.....E..,....HXX...X..,,,,,E.X...XE.XX..XX..XX.,...,.,,..,.XX..............X
X.............,,E..E.X..X..XX..X...XX........,..E..XX...X..E......X.E.XH.HXEEXX.EXX.,...,.,,..,.XX..............X
X.............XX.....X..XA.XX..X..HXX........X.....XX...X.B..E..E.XXXXXXXXXXXXXXXXX.,...,.,,,,,.XX..............X
X.............XX,,,..X,,XXXXXXXXXXXXXX,XXXXXXX,,XXXXX...XXXXXXXXXXX---------XHXXXXX.,...,.,.....XX..............X
X.............XX,,,..X....E.....XX.E.B..XH.HH....HHXX,,,XA.....HX---XXXXXXXXX...EXX.,,,,,.,....HXX..............X
X.............XX.E...X.........EXX...X..X..........XX...XX......X---XHH.H...XH...XX.......XXXXXXXX..............X
X.............XX....AX..,,,,,,..XX...X..X.........HXX...XX.....HX---XH....E.X....,,E....E.XHH...XX..............X
X.............XXXXXXXX..,..,....XXXXAX..X.........HXX...XX......XXXXX...E...XXXXXXXXXXXX+XX.....XX..............X
X.............XXXXXXXX..,..,H...XXXXXX..X..........XX...XX.....HXE..........XXXXXXXXXXXX+XXH....XX..............X
X.............,,..H.EX..,..,,,.EXX..EXE.X...E.....HXX...XX+XXXXXX...........X.E.EXX.......X.....XX..............X
X.............XX.....X..,....,..XX...X..XE.........XX,,,,X+XXXXXX........E..X....XX.E...E.X....EXX..............X
X.............XX.....X..,....,..XXA.AX..X..........XX....+.+.+AXX...E.......XH..EXX.......XXXXXXXX..............X
X.............,,.....X..,....,..XXXXXX..X..........XX,,,,X,XBXXXXXXXXXXXX...XXXXXXX.......XXXXXXXX..............X
X.............XXXXXXXX..,....,..XX..HX..X.........HXX,,,XX,XXXXXXXXXXXXXX.E.XH.H.XX......<X....HXX..............X
X.............XX.E..EX..,,,,.,..XX..HX..XE.........XX...XX...E...H.H.H.HX...X....XX.......X...E.XX..............X
X.............,,.,,..X..H.H,.,..XX...X..X..EE.E.E.HXX,,,XXX............EXE..XH...XX......:X.....,,..............X
X.............XXE,,..X....H,.,..XXH.HX..XXXXXXXXXXXX.....X-XXXXXXXXXXXXXX..XX..X,,,.......XXXXXXXX..............X
X.............XX.,,..X..,,,,,,...XXXXX,XXXXXXXXXXXX.......XXXXXXXXXXXXXXXX+XXXXXX.,.......X.....XX..............X
X.............,,,.H.EX............,.....,.........,...<...,............XX...,..,..,.......XE....XX..............X
X.............XXXXXXXX....E.......,.....,.........,.,..:..,........E...++...,..,.E,.......X.....XX..............X
X.............XX..E..X.E..........,.....,.........,A.,....,............++...,..,..,.......XA....XX..............X
X.............,,,,,,EX............,.E...,.........,,,W,...,............XXX+XXXXXX.,,,,,,,,XXXXXXXX..............X
X.............XXK,,,.X.,,,,XXXX,,XXXXX,XXXXXXXXXXXX.H,,...XXXXXXXXXXXXXXXX+XXXXX,.,,,,,,..XA...HXX..............X
X.............XX.....X.,..,X,B......HB..X----------X.,,..X-XXXXXXXXXXXXXX...XA...XX,,..H..X.....XX..............X
X.............XXHE.E.X.,..,X,..,,,..,X..X-----------X,,,XXX..........HHXX...X....XX.,.....X.....XX..............X
X.............XXXXXXXX.,..,X,..,,,..,X..X-----------X...XX...E.........XX...X,,,,XX.,.,...X.....XX..............X
X.............XX,,,.AX.,,,,X,..H,.E.,X..X----XXXXXXXX,,,XXE.....XXXXXXXXX..EX,H,,XXE,,,,..XXXXXXXX..............X
X.............XXH,,..X...H,X,..H,...,X..X----XE+H+.+....XX......,,W......E..X,,..XX.,A....,.E...,,..............X
X.............,,.A,..X.,,,,XA..H,...,X..X----X.+.+.+....XX......,,..........XXXXXHX.,.....X.....XX..............X
X.............XX.....X.,,,,X,..,,...,X..X---XXXXXB+XX,,,XX.E....,,...E.....EX,,A,XXE,.....X..A.EXX..............X
X.............XXXXXXXX..H,,X,..H,...,XE.X---XH.H..EXX...XX......,,..........X..,,XX.,,,,..XXXXXXXX..............X
X.............XX,,,.:X.,,,,X,..,,...,X..X---X......XX...XX......,,E.........X..,,XX.,,,,..XXXXXHXX..............X
X....E........,,.,,..X.,..,X,........,..X---XH..E.EXX...XX..E...,,........E.X...E,,.......X.....XX..............X
X.............XX.,,..X.,..,X,B...XXXXXXXX---X......XX...XXE....EXXXXXXXXXXXXXXXXXXX,,,,,,,X.....XX..............X
X.............XXE....X.,,,,XXXXXXXXXXXXXX---A.E.E..XX...XXXXXXXXX---X.......X....XX.......X..E..XX..............X
X.............XXXXXXXX......E..E.XE..E..X---X.....EXX...XXXXXXXXXXXXXE,,,..EX....XX.,,.,..XXXXXXXX..............X
X.............XX.....X..XXXX,,,,XX...XXXXXXXXXXXXXXXX,,,XXH...E.E...X.,K,...X,H,HXX.,,,,..X....EXX..............X
X.............XX.....X..XXXX,,,,XXH..X.....H+......BX...XX..........,.....E.XXXXXXX..H,,E.X.....XX..............X
X.............,,.E...X..,.XX..,.HX...X.E....+.E..E.XX...XX..E.....E.X,,.....XXXXXXXE...,..X....AXX..............X
X.............XX..H.HX..,EXX..,.,X...X.....E+,,....XX...XXH.........XW,.XXXXX,,,,XX.,,,,..XXXXXXXX..............X
X.............XXXXXXXX..X.BXA.,H,XE..X...E..+.,....XX...XXXXXXXXXXXXX,,EX..EX,,,,XXE,,H,..X..H.HXX..............X
X.............XXH...AX,,XXXX,,,,,X...X.E....+.A.A.EXX...X,E.XH.EXA..XA..X...XH...,,....,..X.....XX..............X
X.............,,.....X..XXXXXXXXXX...X....E.+.,....++...X,..X...X...X...X...XXXXXXX....,..X.....XX..............X
X.............XX....HX..,...XE.E.E.E.X.E....+.H....XX...X,H.XH.AX...X..EX...XA...XX.,,,,E.XH....XX..............X
X.............XX.....X..X,,.X........X...E.E+.,....XX...X,..X...X.E.XA..XE..X....XX....,..XXXXXXXX..............X
X.............,,.....,..X,,.XA..E....XE.....+,,...EXX...XH.BX..EX...X...X...XH...XX..A,,..XHXXXXXX..............X
X.............XXH....X..X,,HX.......HX..H.HH+......XX...BX..X...X...XA..X..HX....XX.,,,,..X....EXX..............X
X.............XXXXXXXX..XXXXXXXXXXXXXXXXXXXXXXXXXXXX,,,,,XXXXXX+XXXXXXXLXXXXXXXXXXX,,,,,..X.....,,..............X
X.............XXXXXXXX................E.........E...................,.............,...E.,.X.....XX..............X
X.............XX.E...XE.............................................,..........E..,.....,.X.....XX.......E......X
X.............XX.....X.,,,,,,A,,,,,,...,,,,,,..,,,,,,..,,,,,,,..XXXXX,,,,.........,.,,,,.,X.....XX..............X
X.............XXH....+.,....,.,....,....H,,....,....,....H,.A...X..EX,A...XXXXXXXXX.,H...,,.....XX..............X
X.............XXXXXXXX.,....,.,....,.....,,....,....,.....,.....X...X,....XE.HX..XX.,.....XXXXXXXX..............X
X.............XXXXXXXX.,....,E,....,.....,,H...,....,....H,.....XH.HX,A...X..,X..XX.,,,,..XXXXXXXX..............X
X.............XXE....,.,....,.,....,...,,,,,,..,,,..,..,,,,,,,..XXXXX,,,,.X..,X..XX.,A....X.....XX..............X
X.............XX.....X.,....,.,....,...HH,A.....H,..,....E,.H...X.HHX,H...,..,XHHXX.,.,...X.....,,..............X
X.............,,.....X.,....,.,,,..,.....,,......,..,.....,,....X...X,....X..,XXXXX.,,,,..X....AXX..............X
X.............XXXHXHHX.,,,,,,.E.,,,,....H,,H.....,..,....H,,H...X..EX,....X..AXHEXX.,,,...X.....XX..............X
X.............XX.....X......E..........,,,,,,..,,,..,..,,,,,,,..XXXXX,,,,.XE.,X..XX.......XXXXXXXX..............X
X.............XX.....,E............B...,....,..,....,..,,,,..,..XXXXX,....X..,X..XX.....E.,.....XX..............X
X.............XX.....XXXXXXXXXXX.XXXX..,....,..,....,....H,..,..X..AX,E...XH.,XAXXXXXXXXXXX.....XX..............X
X...E.........XX.E...XXXXXXHXXXX....X..,....,..,....,.....,..,..X...X,,,,.XXXXXXXXHXXXXXXXX....AXX..............X
X.............XX.....XE...X....X...EX..,....,..,....,....A,..,..X..AX,,,,.X.....EX...X...HX.....XX..............X
X.............XXE....X....XA...X.,,.X..,....,..,....,..,,,,,,,..XXXXX,...EX......X...X....X....AXX..............X
X.............XX,,A,.X....L...HX.,,.X..,....,E.,....,...AH,H....X..AX,....XH....EX...X...HX.....XX..............X
X.............XX,,,,.X....XA...X.,,.X.E,....,..,....,.....,...E.X...X,E...X......X...X....X..<.:XX..............X
X.............XXH....X..E.X....X.,,HX.A,....,.H,....,.E..E,H....X..EX,,,,.XH.....X...X...HX.....XX..............X
X.............XX.....XH...X..H.X.,,.X..,,,,,,..,,,,,,..,,,,,,,..X...X.A..EXH.A..HXH..X....XH....XX..............X
X.............XXX,XXXXXXXXXXXXXXXXXXXXXXXXXXXXXXXXXXXXXXXXXXXXXXXXX,XXXXXXXXXX,XXXXXXXXXXXXXXXXXXX..............X
X.............XXX,XXXXXXXXXXXXXXXXXXXXXXXXXXXXXXXXXXXXXXXXXXXXXXXXX,XXXXXXXXXX,XXXXXXXXXXXXXXXXXXX..............X
X............,....................................................................................,.............X
X...........,...................................................................................E..,...E........X
X..........,............................................E..........................E..............E.,...........X
X.........,..........................................................................................,..........X
X........,.................................E...................................E......E...E..........E,.........X
X.......,..............E...............................................................................>>.......X
X.....,,......................................................................................E..........,...E..X
X....,................................................................................................E...,.....X
X...,..............................................E....................................................E..,,...X
X..,..........................E...........................................................................E..,..X
X.,..................................................................E.....................E....E.............,.X
X,.......................................................................................................E..E..,X
XXXXXXXXXXXXXXXXXXXXXXXXXXXXXXXXXXXXXXXXXXXXXXXXXXXXXXXXXXXXXXXXXXXXXXXXXXXXXXXXXXXXXXXXXXXXXXXXXXXXXXXXXXXXXXXXX
-----------------------------------------------------------------------------------------------------------------
