----------------------------------------------------------------------XXXXXXX--------
----------------------------------------------------------------------X.....X--------
----------------------------------------------------------------XXXXXXX.,,,.X--------
----------------------------------------------------------------X.,<t.,.,.,.X--------
----------------------------------------------------------------Xt,ttt,.,.,.X--------
----------------------------------------------------------------X<t.,<t.,.,.X--------
----------------------------------------------------------------Xt,tttt.,,,.XXXXXXXWX
----------------------------------------------------------------X.,<t.,.....+..W.W..X
----------------------------------------------------------------XXXXXXX.....+.......X
----------------------------------------------------------------------X.....+......WX
----------------------------------------------XXX---------------------XXXXXXXXXXX,,,X
----------------------------------------------XTX-------------------------------X..WX
------------------------------------------XXXXXtttttttt-------------------------X...X
------------------------------------------X...........X-------------------------X..WX
--------------------------------------X>X-X,,...E...,,X-------------------------X...X
--------------------------------------X.X-X.,.......,.X-------------------------X..WX
--------------------------------------X.X-X.,.......,.X-------------------------X...X
--------------------------------------X+X-X.,.......,.X-------------------------X..:X
-------------------------------------XX,XXX,,.......,,X-------------------------X...X
-------------------------------------X,...,...........X-------------------------X..AX
----------------------------------XXXX,,,,,,,,,,,,,,,,XXXXXXXXXXXX--------------X...X
----------------------------------X...........................,...X-------------X..AX
----------------------------XXXXXXX.T.,,,,,,,,,...,,,,,,,,,...,....XX-----------X...X
----------------------------X...,.,...,...XX..,...,...XX..,...,......X----------X..AX
----------------------------X,,,,.,...,.XX--X.,...,.XX--X.,...,,,,,...XXXXXXXXXXX..AX
----------------------------X.....,...,.X---X.,.E.,.X---X.,...,...,...,.......++...AX
----------------------------X.....,...,X-----X,...,X-----X,...,.E.,...,.......++....X
----------------------------X..E..,.E.,X-----X,...,X-----X,E..,...,...,.......++...HX
----------------------------X.....,...,.XX--XE,...,.XX--X.,...,,,,,...XXXXXXXXXXXXXXX
----------------------------X.....,...,...XX..,...,E..XX..,...,......X---------------
----------------------------XXXXXXX...,,,,,,,,,...,,,,,,,,,...,.....X----------------
----------------------------------X.................E.........,....X-----------------
----------------------------------X,,,,,,,,,,,,,H,,,,,,,,,,,,,XXXXX------------------
----------------------------------X.......E...................X----------------------
----------------------------XXXXXXX...,,,,,,,,,...,,,,,,,,,...XXXXXXX----------------
----------------------------X...,.,...,...XX..,...,...XX..,...,.....X----------------
----------------------------X,,,,.,...,.XX--X.,...,.XX--X.,...,.....X----------------
----------------------------X.....,...,.X---X.,...,.X---X.,...,.E...X----------------
----------------------------X.....,.E.,X-----X,...,X-----X,E..,.....X----------------
----------------------------X..E..,...,X-----X,...,X-----X,...,.....X----------------
----------------------------X.....,...,.XX--X.,...,EXX--X.,...,,,,,.X----------------
----------------------------X.....,...,...XX.E,...,...XX..,...,...,.X----------------
----------------------------XXXXXXX...,,,,,,,,,...,,,,,,,,,...XXXXXXX----------------
----------------------------------X.............H......E......X----------------------
----------------------------------X,,,,,,,,,,,,,,,,,,,,,,,,,,,X----------------------
----------------------------------X.....E.....................X----------------------
----------------------------XXXXXXX...,,,,,,,,,...,,,,,,,,,...XXXXXXX----------------
----------------------------X...,.,...,...XX..,...,...XX..,...,.....X----------------
----------------------------X,,,,.,...,.XX--X.,...,.XX--X.,...,.....X----------------
----------------------------X.....,...,.X---X.,...,.X---X.,...,.....X----------------
----------------------------X.....,...,X-----X,...,X-----X,E..,..E..X----------------
----------------------------X.E...,.E.,X-----X,...,X-----X,...,.....X----------------
XXXXXXXXXXXXX---------------X.....,...,.XX--X.,...,EXX--X.,...,,,,,.X----------------
X:.W.W.W.:t.X---------------X.....,...,...XX.E,...,...XX..,.T.,...,.X----------------
X........,,tX---------------XXXXXXX...,,,,,,,,,...,,,,,,,,,...XXXXXXX----------------
XHA..AAA...HX---------------------X.............H.....E.......X----------------------
XXXXXXXXXXXXX---------------------X,,,,,,,,,,,,,,,,,,,,,,,,,,,X----------------------
----------------------------------X.....E.....................X----------------------
XXXXXXXXXXXXX---------------XXXXXXX...,,,,,,,,,...,,,,,,,,,...XXXXXXX----------------
X:.W.W.W.:t.X---------------X...,.,...,...XX..,...,...XX..,...,.....X----------------
XH.....A.,,tX---------------X,,,,.,...,.XX--X.,...,.XX--X.,...,.....X----------------
X.A..A...A.HX---------------X.....,...,.X---X.,...,.X---X.,E..,..E..X----------------
XXXXXXXXXXXXX---------------X.....,...,X-----X,...,X-----X,...,.....X----------------
----------------------------X..E..,.E.,X-----X,...,X-----X,...,.....X----------------
XXXXXXXXXXXXX---------------X.....,...,.XX--X.,...,.XX--X.,...,,,,,.X----------------
X:.W.W.W.:t.X---------------X.....,...,...XX.E,...,E..XX..,...,...,.X----------------
X.A......,,tX---------------XXXXXXX...,,,,,,,,,...,,,,,,,,,...XXXXXXX----------------
XH...A.A.A.HX---------------------X...........................X----------------------
XXXXXXXXXXXXX---------------------X,,,,,,,,,,,,,H,,,,,,,,,,,,,X----------------------
----------------------------------X......E............E.......X----------------------
XXXXXXXXXXXXX---------------XXXXXXX...,,,,,,,,,...,,,,,,,,,...XXXXXXX----------------
X:.W.W.W.:t.X---------------X...,.,...,...XX..,...,...XX..,...,.....X----------------
X..A.....,,tX---------------X,,,,.,...,.XX--X.,...,.XX--X.,...,.....X----------------
H....A..AA.HX---------------X.....,...,.X---X.,...,.X---X.,E..,.E...X----------------
XXXXXXXXXXXXX---------------X..E..,.E.,X-----X,...,X-----X,...,.....X----------------
----------------------------X.....,...,X-----X,...,X-----X,...,.....X----------------
----------------------------X.....,...,.XX--X.,...,EXX--X.,...,,,,,.X----------------
----------------------------X.....,...,...XX.E,...,...XX..,...,...,.X----------------
----------------------------XXXXXXX...,,,,,,,,,...,,,,,,,,,...XXXXXXX----------------
----------------------------------X.............H.....E.......X----------------------
----------------------------------X,,,,,,,,,,,,,,,,,,,,,,,,,,,X----------------------
----------------------------------X.....E.....................X----------------------
----------------------------XXXXXXX...,,,,,,,,,...,,,,,,,,,...XXXXXXX----------------
----------------------------X...,.,...,...XX..,...,...XX..,...,.....X----------------
----------------------------X,,,,.,...,.XX--X.,...,.XX--X.,...,.....X----------------
----------------------------X.....,...,.X---X.,...,.X---X.,.E.,..E..X----------------
----------------------------X..E..,...,X-----X,...,X-----X,...,.....X----------------
----------------------------X.....,E..,X-----X,...,X-----X,...,.....X----------------
----------------------------X.....,...,.XX--XE,...,.XX--X.,...,,,,,.X----------------
----------------------------X.....,...,...XX..,...E...XX..,...,...,.X----------------
----------------------------XXXXXXX...,,,,,,,,,...,,,,,,,,,...XXXXXXX----------------
----------------------------------X.......T...................X----------------------
----------------------------------X,,,,,,,,,,,,,H,,,,,,,,,,,,,X----------------------
----------------------------------X...........................X----------------------
----------------------------XXXXXXX...,,,,,,,,,...,,,,,,,,,...XXXXXXX----------------
----------------------------X...,.,...,...XX..,...,...XX..,...,.....X----------------
----------------------------X,,,,.,...,.XX--X.,...,.XX--X.,...,.....X----------------
----------------------------X.....,...,.X---X.,...,.X---X.,...,.E...X----------------
----------------------------X.....,...,X-----X,...,X-----X,...,.....X----------------
----------------------------X..E..,...,X-----X,...,X-----X,...,.....X----------------
----------------------------X.....,...,.XX--X.,...,.XX--X.,...,,,,,.X----------------
----------------------------X.....,...,...XX.E,...,E..XX..,...,...,.X----------------
----------------------------XXXXXXX...,,,,,,,,,...,,,,,,,,,...XXXXXXX----------------
----------------------------------X...........................X----------------------
----------------------------------X,,,,,,,,,,,,,H,,,,,,,,,,,,,X----------------------
----------------------------------X...........................X----------------------
----------------------------XXXXXXX...,,,,,,,,,...,,,,,,,,,...XXXXXXX----------------
----------------------------X...,.,...,...XX..,...,...XX..,...,.....X----------------
----------------------------X,,,,.,...,.XX--X.,...,.XX--X.,...,.....X----------------
----------------------------X.....,...,.X---X.,...,.X---X.,...,.E...X----------------
----------------------------X..E..,...,X-----X,...,X-----X,...,.....X----------------
----------------------------X.....,...,X-----X,...,X-----X,...,.....X----------------
----------------------------X.....,...,.XX--E.,...,.XX--X.,...,,,,,.X----------------
----------------------------X.....,...,...XX..,...,E..XX..,...,...,.X----------------
----------------------------XXXXXXX...,,,,,,,,,...,,,,,,,,,...XXXXXXX----------------
----------------------------------X.............H.............X----------------------
----------------------------------X,,,,,,,,,,,,,,,,,,,,,,,,,,,X----------------------
----------------------------------X...........................X----------------------
----------------------------XXXXXXX...,,,,,,,,,...,,,,,,,,,...XXXXXXX----------------
----------------------------X...,.,...,...XX..,...,...XX..,...,.....X----------------
----------------------------X,,,,.,...,.XX--X.,...,.XX--X.,...,.....X----------------
----------------------------X.....,...,.X---X.,...,.X---X.,...,.E...X----------------
----------------------------X.....,...,X-----X,...,X-----X,...,.....X----------------
----------------------------X.E...,...,X-----X,...,X-----X,...,.....X----------------
----------------------------X.....,...,.XX--X.,...,EXX--X.,...,,,,,.X----------------
----------------------------X.....,...,...XX.E,...,...XX..,...,...,.X----------------
----------------------------XXXXXXX...,,,,,,,,,...,,,,,,,,,...XXXXXXX----------------
----------------------------------X............H......T.......X----------------------
----------------------------------X,,,,,,,,,,,,,,,,,,,,,,,,,,,X----------------------
----------------------------------X...........................X----------------------
----------------------------XXXXXXX...,,,,,,,,,...,,,,,,,,,...XXXXXXX----------------
----------------------------X...,.,...,...XX..,...,...XX..,...,.....X----------------
----------------------------X,,,,.,...,.XX--X.,...,.XX--X.,...,.....X----------------
----------------------------X.....,...,.X---X.,...,.X---X.,...,.E...X----------------
----------------------------X..E..,...,X-----X,...,X-----X,...,.....X----------------
----------------------------X.....,...,X-----X,...,X-----X,...,.....X----------------
----------------------------X.....,...,.XX--E.,...E.XX--X.,...,,,,,.X----------------
----------------------------X.....,...,...XX..,...,...XX..,...,...,.X----------------
----------------------------XXXXXXX...,,,,,,,,,...,,,,,,,,,...XXXXXXX----------------
----------------------------------X...........................X----------------------
----------------------------------XXXXXXXXX,,,,,,,,,,,XXXXXXXXX----------------------
------------------------------------------X...,...,...X------------------------------
------------------------------------------X...,...,...X------------------------------
------------------------------------------X...,...,...X------------------------------
------------------------------------------X,,.,,,,,.,,X------------------------------
------------------------------------------X.,.......,.X------------------------------
------------------------------------------X.,.......,.X------------------------------
------------------------------------------X.,....E..,.X------------------------------
------------------------------------------X,,.......,,X------------------------------
------------------------------------------XH.H.......KX------------------------------
------------------------------------------X.........ttX------------------------------
------------------------------------------X.........tTX------------------------------
------------------------------------------XXXXXXXXXXXXX------------------------------
