XXXXXXX-XXXXXXXXX-XXXXXXXXX-XXXXXXXXX-XXXXXXXXXX-XXXXXXXXXXXXXXXXXXX-XXXXXXXXXX-XXXXXXXXXX--
X.....X-X:.....:X-X:.....:X-X:.....:X-X:......:X-X:......:XX:.....:X-X:......:X-X:......:X--
X.<.<.XXX..,,,..X-X..,,,..X-X..,,,..X-X..,,,...X-X..,,,...XX..,E,..X-X...,,,..XXX..,,,...X--
X.....,....,E,..X-X..E.,..X-X..,E,..X-X:.E.,...X-X..,E,...XX..,.,..X-X..E,E,..,....,E,E..X--
XAAAW.,H...,.,..X-X..,.,..XXX..,.,E.X-X..,E,E..X-X..,.,E..XX..,.,E.X-X.,,,.,..,H...,.,,,.X--
XAAA..,....,.,..X-X..,.,..,...,,.,,.X-X..,.,,,.X-X..,.,,,.XX..,.,,.X-X.,...,E.,....,E..,.X--
X,,,,,XXX..,E,..X-X..,.,..,H..,...,.XXX.,,...,.XXX..,...,.,..,,..,.X-X.,,,E,,.XXX.,,.,,,.X--
XAAA..X-X.,,.,..X-X..,.,..,...,,.,,.,...,..,,,.,H..,,E,,,.H..,.E,,.X-X...,..,.X-X.,..,E..X--
XAAAW.X-X.,..,..X-X..E.,..XXX.E,E,E.,H..,,.,E..,...,..,E..,..,,.,E.X-X...,.,,.X-X.,,.,...X--
X.....X-X.,,.,..X-X..,.,..X-X..,.,..,....,E,...,...,,E,...XX..,E,..X-X...,E,..X-X.E,E,...X--
X.<.<.X-X..,.,..X-X.,,.,..X-X..,,,..XXX..,,,...XXX..,,,...XX..,,,..X-X...,,,..X-X..,,,...X--
X.....X-X..,E,E.X-X.,.E,..X-X:.....:X-X:......:X-X:......:XX:.....:X-X:......:X-X:......:X--
XXXXXXX-X..,.,,.X-X.,,.,..X-XXXXXXXXX-XXXXXXXXXX-XXXXXXXXXXXXX,,,XXX-XX...XXXXX-XXXX,,,XXX--
--------X..,..,.X-X.E,.,..X----------------------------------X.H.X----X.H.X--------X.H.X----
XXXXXXXXX..,.,,.X-X..,.,..X-XXXXXXXXXXXXXXXXXXXXXXX-XXXXXXXXXX...XXX-XX,,,XXXX-XXXXX...XXX--
X:.........,E,E.X-X..,.,..X-X:...................:X-X:............:X-X:.....:X-X:.......:X--
X....,,,...,.,..X-X..,E,E.X-X.:..........,,,......X-X......,,,.....X-X..,,,..X-X...,,,...X--
X.,,,,.,,,,,.,..X-X..,.,,.X-X...........E,.,......XXX.....E,.,.....X-X..,E,..X-X...,E,...X--
X.,..E....E..,..X-X..,..,.X-X...,,,,,,,,,,.,,,,,,..H,.,,,,,,.,,,,,.X-X..,.,..X-X...,.,,,.X--
X.,,,,.,E,,,,,..X-X..,.,E.X-X...,E...E..E.....E.,...,.,.E...E...E,.X-X.E,.,..X-X.,,,...,.X--
X...E,,,........X-X..,E,..X-X...,.,,,,E,.,,,,,,,,...,.,,,E,.,,,,,,.X-X.,,.,..X-X.,...,,,.X--
X:.............:X-X:.,.,..X-X...,.,....,.,E.......XXX.....,.,E..:..X-X.,.E,..X-X.,,,E,E..X--
XXXXX,,,XXXXXXXXX-X..,.,..X-X...,.,....,,,........X-X.....,,,......X-X.,,.,..X-X..E,,,...X--
----X.H.X---------X..,.,..X-X...,E,..............:X-X:............:X-X..,.,..X-X:.......:X--
XXXXX...XXXXX-XXXXX..,E,..X-X...,.,...XXXXXXXXXXXXX-XXXXXXXXXXXXXXXX-X..,E,E.X-XXXX,,,XXXX--
X:.........:X-X:.....,.,..X-X...,.,...X-XXXXXXX----------------------X..,.,,.X----X.H.X-----
X....,,,....XXX..,,,.,.,..X-X...,.,...X-X:...:XXXXXXXXXXXXXXXXXXX-XXXX..,..,.X-XXXX...XXXX--
X.,,,,.,,,,.,...,,.,,,.,..X-X...,E,...X-X.A.A.XX:..............:X-X:...E,.,,.X-X:.......:X--
X.,E.E.E.E,.,H..,E...E.,..X-X...,.,...X-A..A.AXX........,,,E....XXX.E,,,,.,E.X-X...,,,...X--
X.,,,,.,,,,.,...,,,.,,,,..X-X...,.,...X-X.A.A.XX..,,,,,,,.,,,,..,...,,.,,E,..X-X...,E,...X--
X..E.,,,E...XXX..E,,,E....X-X..E,.,...X-XA.AA.XX..,.E...E...E,..,H..,E....,..X-X.,,,.,...X--
X:.........:X-X:.........:X-X.,,,E,...X-X.A.A.XX.E,.,,,,,.,,,,..,...,,,.,,,..X-X.,...,...X--
XXXX+++XXXXXX-XXXXXXXXXXXXX-X.,...,...X-A..AA.XX.,,.,...,,,E...:XXX:..,,,...:X-X.,E,.,...X--
---X...X--------------------X.,,,.,...X-X.W.W.XX.,..,.XXXXXXXXXXX-XXXXXXXXXXXX-X...,E,,,.X--
XXXX.:.XXXXXXXXXXXXXXXXXXXX-X..E,.,...X-XA.A.AXX.,,E,,XXXXXXXXXXXXXXX-XXXXXXXXXX...,...,.X--
X:A.A.A.A.A.A.A.A.H.H.H.H:X-X...,E,...XXXA.A.AXX.E,..,XX:..........:X-X:...........,.,,,.X--
X..A.A.A.A.A.A.AAH.H.H.H.HX-X...,.,E..+..AAAA.XX..,.,,XX.,,,,,,,,,,.XXX......E,,,..,.,E..X--
XKA.A.A.A.A.A.A...H.H.H.H.X-X...,.,,,.+.....A.XX..,.,EXX.,........,...,.,,,,,,,.,,,,E,...X--
X..A.A.AAA.A.A.A.H.H.H.H.HX-X...,E..,.+..A.A..XX..,,,.XX.,........,..H,.,.E...E...E..,...X--
X:A.A.A...A.A.A.A.H.H.H.H:X-X...,.,,,.XXXA..A.XX......XX.,........,...,.,,,,,,,,,,.,,,...X--
XXXXXXXXXXXXXXXXXXXXXXXXXXX-X...,.,E..X-XAA.A.XX:....:XX.,.,,,,,,,,.XXX.........E,,,E....X--
----------------------------X...,.,...X-X.A.A.XXXX...XXX.,.,.......:X-X:................:X--
XXXXXXXXXXXX-XXXXXXXXX-XXXXXX...,.,...X-A.A.A.X--X.H.X-X.,.,.XXXXXXXX-XXXXXXXXXXXXXXXXXXXX--
X:........:X-X:.....:X-X:.......,E,...X-X.W.W.XXXX,,,XXX.,.,.X------------->>X--------------
X.,,,,,,,,.X-X.,,,,,.XXX...,,,..,.,...X-XA.AA.XX:....:XX.,.,.X-------------X.X--------------
XE,.,,,,.,.X-X.,,E,,...,..E,.,E.,.,...X-XA.A..XX......XX.,.,.X------------X...X-------------
X.,.,E.,.,.XXXE,,E,,..H,.,,,.,,,,.,...X-A.A.A.XX..,,,.XX.,.,.X---XX:XX:XX:X,,,:XX:XX:XXXX---
XE,.,..,.,...,.,,.,,...,.,...E...E,...X-XA.A..XX.E,.,.XX.,.,.X---XE,,.,,.,,...,,.,,.,,..X---
X.,.,,,,.,.H.,E,,,,,.XXX.,,,.,,,,,,...X-XA.AA.XX..,E,.XX.,.,.X---X.,,.,,E,,.E.,,E,,E,,..X---
X.,,,,,,,,...,.,,,,,.X-X..E,,,E.......X-X.KWA.XX.,,.,.XX.,.,.X---X.,,.,,.,,...,,.,,.,,..X---
X:........:XXX:.....:X-X:............:X-X:.W.:XX.,..,.XX.,.,.X---X.,,.,,.,,...,,.,,.,,..X---
XX,,,XXXXXXX-XXXXXXXXX-XXXXXXXXXXXXXXXX-XXXXXXXX.,,.,.XX.,.,.X---X.,,E,,.,,...,,.,,.,,.EX---
-X.H.X-----------------------------------------X.E,E,EXX.,.,.X---X.,,.,,E,,,,,,,E,,.,,..XX--
XX...XXXXXXX-XXXXXXXXXXXXXXXXXXXXXXX-XXXXXXXXXXX..,.,,XX.,.,.X---XE,,.,,.,,,,,,,.,,.,,..,.XX
X:........:X-X:...E.....E.....E...:XXX:...........,..,XX.,.,.X---X.,,.,,E...E...E,,E,,..,..X
X.,,,,,,,,.X-X.,,,,,,,,,,,,,,,,,,,.,........E,,,E.,.,,XX.,.,.X---X.,,.,,,,,,,,,,,,,.,,..,.XX
X.,......,.X-X.,............,E,..,.,H...,,,,,E.,,,,E,.XX.,.,.X---X.,,.,,,,,,,,,,,,,.,,.EXX--
X.,.,,,,.,.X-X.,.,,,,,,.....,.,..,.,....,E.....E....,.XX.,.,.X---X.,,E.....E.....E..,,..X---
X.,.,E.,.,.X-X.,.,E.E.,.....,,,..,.XXX..,,,,,,,.,,,,,.XX.,.,.X---X.,,,,,,,,,,,,,,,,,,,..X---
X.,.,..,.,.X-X.,.,....,.,,,,,,,,,,:X-X:......E,,,....:XX.,.,.X---X.,,,,,,,,,,,,,,,,,,,..X---
X.,.,E.,.,.X-X.,.,,,,,,.,.XXXXXXXXXX-XXXXXXXXXXXXXXXXXXX.,.,.X---XE.....E.....E.....E...X---
X.,.,,,,.,.X-X.,........,.XXXXXXXXXXXXX-XXXXXXXXXXX-XXXX.,.,.X--X:,,,,,,,,,,,,,,,,,,,,,:X---
X.,......,.X-X.,,,,,,,,,,.XX:........:X-X:.......:X-X:...,.,.XXX.,,,,,,,,,,,,,,,,,,,,,,,X---
X.,,,,,,,,.X-X:..........:XX..........XXX...E,,,..XXX.,,,,.,.XX..,......................X---
X:..E..E..:X-XXXXXX...XXXXXX..,,,,,,,...,.,,,,.,,...,.,....,.XXX.,...E.....E.....E.....EX---
XXXXXX,,,XXX------X.H.X----X..,E...E,..H,.,E.EE.,..H,.,....,.X--XX......................X---
-----X.H.X---XXXXXX,,,XXXXXX..,.,,,,,...,.,E,.,,,...,.,....,.X---:,,,,,,,,,,,,,,,,,,,,,:X---
XXXXXX...XXX-X:.E......E.:XX.E,.,.....XXX...,,,...XXX.,,,,,,.X---X,,,,,,,,,,,,,,,,,,,,,,X---
X:........:X-X.,,,,,,,,,,.XX.,,.,....:X-X:.......:X-X:......:X---X.........E............X---
X.,,,,,,,,.X-X.,........,.XX.,.E,..XXXX-XXXXXXXXXXX-XXXXXXXXXX---X...E...........E.....EX---
X.,......,.X-X.,.,,,,,,.,.XX.,,.,,.X-----------------------------X......................X---
X.,.,,,,.,.X-X.,.,E.EE,.,.XX.E,..,.XXXXXXXXXX-XXXXXXXXXXXXXX:X---X......................X---
X.,.,E.,.,.X-X.,.,,,,,,.,.XX..,.,,.XX:.....:X-X:.............X---:,,,,,,,,,,,,,,,,,,,,,:X---
X.,.,..,.,.X-X.,........,.XX..,E,E.XX..,,,..XXX.,,,,,,,,,,,,.X---X,,,,,,,,,,,,,,,,,,,,,,X---
X.,.,,,,.,.X-X.,,,,,,,,,,.XX..,.,..XX..,E,..,...,..........,.X---X,,,,,,,,,,,,,,,,,,,,,,X---
X.,......,.X-X:..........:XX..,,,..XX.E,.,..,H..,.......E..,.X---X,,,,,,,,,,,,,,,,,,,,,,XX--
X.,,,,,,,,.X-XXXXXX...XXXXXX:.....:XX..,.,..,...,..........,.X---X,,,,,,,,,,,,,,,,,,,,,,,.XX
X:.E...E..:X------X.H.X----XX,,,XXXXX.,,.,..XXX.,..........,.X---X,,,,,,,,,,,,,,,,,,,,,,,..X
XXXXX,,,XXXX-XXXXXX,,,XXXXX-X.H.X---X.,.E,..X-X.,..E.......,.X---X,,,,..............,,,,,.XX
----XH..X----X:.E.....E..:XXX...XXXXX.,,.,E.X-X.,..........,.X---X,,,,.,,,,,,,,,,,,.,,,,XX--
XXXXX...XXXX-X.,,,,,,,,,,.XX:.....:XX..,.,..X-X.,,,,,,,,,,,,.X---X,,,,.,..,,,,,...,.,,,,X---
X:........:X-X.,........,.XX..,,,..XX..,.,,.X-X:............:X---X,,,,.,..,...,...,.,,,,X---
X.,,,,,,,,.X-X.,.,,,,,,.,.XX..,E,..XX..,E.,.X-XXXXXXXX,,,,XXXX---X,,,,.,..,...,...,.,,,,X---
X.,......,.X-X.,.,E.E.,.,.XX..,.,,.XX..,.,,.X--------X..H.X------X,,,,.,..,...,...,.,,,,X---
X.,.,,,,.,.X-X.,.,....,.,.XX..,..,.XX..,.,..X-XXXXXXXX....XXXX--XX,,,,.,..,,,,,...,.,,,,X---
X.,.,E.,.,.X-X.,.,..E.,.,.XX.,,.,,.XX..,.,..X-X:............:XXX.,,,,,.,..........,.,,,,X---
X.,.,..,.,.X-X.,.,....,.,.XX.,.E,E.XX..,,,..X-X.,,,,,,,,,,,,.XX..,,,,,.,..........,.,,,,X---
X.,.,,,,.,.X-X.,.,,,,,,.,.XX.,,.,..XX:.....:X-X.,..........,.XXX.,,,,,.,..........,.,,,,X---
X.,......,.X-X.,........,.XX.E,E,..XXX...XXXX-X.,E......E..,.X--XX,,,,.,..........,.,,,,X---
X.,,,,,,,,.X-X.,,,,,,,,,,.XX..,,,..X-X.H.X----X.,..........,.X---X,,,,.,..........,.,,,,X---
X:.E..E...:X-X:..........:XX:.....:XXX,,,XXXX-X.,..........,.X---X,,,,.,..........,.,,,,X---
XX,,,XXXXXXX-XXXXXXXX...XXXXXX,,,XXXX:.....:X-X.,,,,,,,,,,,,.X---X,,,,.,..........,.,,,,X---
-X.H.X--XXXXXXX-----X.H.X----X.H.X--X..,,,..X-X:............:X---X,,,,.,..........,.,,,,X---
XX...XXXX:.K.:XXXXXXX,,,XXXXXX...XXXX..,.,..X-XXXXX,,,XXXXXXXX---X,,,,.,..........,.,,,,X---
X:....:XX.A.A.XX:.E...E..:XX:.....:XX..,E,..X-----X.H.X----------X,,,,.,..........,.,,,,X---
X.,,,,,XXA.A.AXX.,,,,,,,,.XX..,E,..XX.E,.,..X-XXXXX...XXXXXXXX---X,,,,.,..........,.,,,,X---
X.,...,XX.A.A.XX.,......,.XX..,.,..XX.,,.,E.X-X:............:X---X,,,,.,..........,.,,,,X---
X.,,,,,XXA.A.AXX.,.,,,,.,.XX..,.,..XX.,..,..X-X.,,,,,,,,,,,,.X---X,,,,.,..........,.,,,,X---
X.,,E,,XX.A.A.XX.,.,E.,.,.XX.,,.,,.XX.,,.,,.X-X.,..........,.X---X,,,,.,..........,.,,,,X---
X.,,E,,XXA.A.AXX.,.,..,.,.XX.,.E.,.XX..,E.,.X-X.,.E........,.X---X,,,,.,..........,.,,,,XX--
X.,,,,,XX.A.A.XX.,.,,,,.,.XX.,,.,,.XX..,.,,.X-X.,.......E..,.X---X,,,,.,..........,.,,,,,.XX
X.,...,XXA.A.AXX.,......,.XX.E,.,E.XX..,.,..X-X.,..........,.X---X,,,,.,..........,.,,,,,..X
X.,,,,,XX.A.A.XX.,,,,,,,,.XX..,,,..XX..,,,..X-X.,..........,.X---X,,,,.,..........,.,,,,,.XX
X:.EE.:XX:.A.:XX:........:XX:.....:XX:.....:X-X.,,,,,,,,,,,,.X---X,,,,.,..........,.,,,,XX--
XXX,,,XXXXA.AXXXXXX...XXXXXXX,,,XXXXXXX...XXX-X:............:X---X,,,,.,..........,.,,,,X---
--X.H.X--X+++X----X.H.X-----X.H.X-----X.H.X---XXXXXXX,,,XXXXXX---X,,,,.,..........,.,,,,X---
XXX...XXXX+++XXXXXX,,,XXXXXXX...XXXXXXX,,,XXX-------X.H.X--------X,,,,.,..........,.,,,,X---
X:,,,,,,,,,,,,,,,,,,,,,,,:XX:.....:XX:.....:X-XXXXXXX...XXXXXX--XX,,,,.,..........,.,,,,X---
X.,.,E,.....,,,.....,,,.,.XX..,,,..XX.......X-X:............:XXX.,,,,,.,..........,.,,,,X---
X.,.,.,.....,E,.....,E,.,.XX..,E,..XX.......X-X.,,,,,,,,,,,,.XX..,,,,,.,..........,.,,,,X---
X.,.,,,.....,,,.....,,,.,.XX..,.,..XX.......X-X.,..........,.XXX.,,,,,.,..........,.,,,,X---
X.,,,,,,,,,,,,,,,,,,,,,,,.XX..,.,,.XX.......X-X.,..........,.X--XX,,,,.,..........,.,,,,X---
X:....E.....E......E.....:XX.,,..,.XX.......X-X.,.......E..,.X---X,,,,.,,,,,,,,,,,,.,,,,X---
XXXXXXXXXXXXXXXXXXXXXXXXXXXX.,.E,,.XX.......X-X.,.E........,.X---X,,,,..............,,,,X---
XXXXXXXXXXXXXXXXXXXXX-XXXXXX.,,.,E.XX.......X-X.,..........,.X---X,,,,,,,,,,,,,,,,,,,,,,X---
X:.................:XXX:.....E,.,..XX.......X-X.,..........,.X---X,,,,,,,,,,,,,,,,,,,,,,X---
X.....................,.,,,,,,,.,..XX.......X-X.,,,,,,,,,,,,.X---X,,,,,,,,,,,,,,,,,,,,,,X---
X...................H.,.,..E...E,..XX.......X-X:............:X---X,,,,,,,,,,,,,,,,,,,,,,X---
X.....................,.,,,,,.,,,..XX.......X-XXXXXXXLLLXXXXXX---XXXXXXXXXXX...XXXXXXXXXX---
X...................XXX...E.,,,E...XX.......X-------X.H.X------------------X.H.X------------
X..................:X-X:..........:XX.......X-XXXXXXX...XXXXXX-XXXXXXXXXXXXX,,,XXXXXXXXXXXX-
X.......XXXXXXXXXXXXX-XXXXXXXXXXXXXXX.......X-X:............:X-X:........................:X-
X......:X---------------------------X.......X-X............E.X-X.,,,,,,,,,,,,,,,,,,,,,,,,.X-
X.......XXXXXXXXXXXXXXXXXXXXXXXXXXXXX.......X-X..............X-X.,,,,,,,,,,,,,,,,,,,,,,,,.X-
X...........................................X-X..E...........X-X.,,,,,,,,,,,,,,,,,,,,,,,,.X-
X.,,,,,,,,,,,,,,,,,,,,,,,,,,,,,,,,,,,,,,,,,.X-X.......E......X-X.,,,,,,,,,,,,,,,,,,,,,,,,.X-
X.,.......................................,.X-X..............X-X.,,,,,,,,,,,,,,,,,,,,,,,,.X-
X.,.......................................,.X-X..............X-X.,,,,,,,,,,,,,,,,,,,,,,,,.X-
X.,.......................................,.X-X:............:X-X.,,,,,,,,,,,,,,,,,,,,,,,,.X-
X.,.,,,,,,,,,.....,,,,,,,,,.....,,,,,,,,,.,.X-XXXXLLLXXXXXXXXX-X.,,,,,,,..........,,,,,,,.X-
X.,.,:.....:,.....,:.....:,.....,:.....:,.,.X-XXXX.H.XXXXXXXXX-X.,,,,,,,,,,,..,,,,,,,,,,,.X-
X.,.,.,,,,,.,.....,.,,,,,.,.....,.,,,,,.,.,.X-X:............:X-X.,,,,,,,,..,..,..,,,,,,,,.X-
X.,.,.,...,.,.....,.,...,.,.....,.,...,.,.,.X-X..............X-X.,,,,,,,,..,..,..,,,,,,,,.X-
X.,.,.,.E.,.,.....,.,E..,.,.....,.,.E.,.,.,.X-X..........E...XXX.,,,,,,,,,,,..,,,,,,,,,,,.X-
X.,.,.,...,.,.....,.,...,.,.....,.,...,.,.,.X-X..............,...,,,,,,,..........,,,,,,,.X-
X.,.,:,,,,,.,.....,.,,,,,.,.....,.,,,,,.,.,.X-X.E...E........,.H.,,,,,,,,,,,,,,,,,,,,,,,,.X-
X.,.,......:,.....,:.....:,.....,:.....:,.,.X-X..............,...,,,,,,,,,,,,,,,,,,,,,,,,.X-
X.,.,,,,,,,,,.....,,,,,,,,,.....,,,,,,,,,.,.X-X..............XXX.,,,,,,,,,,,,,,,,,,,,,,,,.X-
X.,.......................................,.X-X..............X-X.,,,,,,,,,,,,,,,,,,,,,,,,.X-
X.,.......................................,.X-X:............:X-X.,,,,,,,,,,,,,,,,,,,,,,,,.X-
X.,.......................................,.X-XXXXXLLLXXXXXXXX-X.,,,,,,,,,,,,,,,,,,,,,,,,.X-
X.,,,,,,,,,,,,,,,,,,,,,,,,,,,,,,,,,,,,,,,,,.X----X.....X-------X.,,,,,,,,,,,,,,,,,,,,,,,,.X-
X:.........................................:X---X.:.E.:.X------X:........................:X-
XXXXXXXXXXXXXXXXXXXXXXXXXXXXXXXXXXXXXXXXXXXXX----X.....X-------XXXXXXXXXXXXXXXXXXXXXXXXXXXX-
--------------------------------------------------XX,XX-------------------------------------
---------------------------------------------------+++--------------------------------------
