------------------XXXXXXXXXXX-----------------------------------------------------------------------------------
------------------X.........X-----------------------------------------------------------------------------------
------------------X.ttt.E.W.X-----------------------------------------------------------------------------------
------------------X.t.t.....X-----------------------------------------------------------------------------------
------------------X.ttt.....X-----------------------------------------------------------------------------------
------------------X.........X-----------------------------------------------------------------------------------
------------------X.......H.X-----------------------------------------------------------------------------------
------------------X.........X-----------------------------------------------------------------------------------
------------------X.........X-----------------------------------------------------------------------------------
------------------X.........X-----------------------------------------------------------------------------------
------------------X.......,,XXXXXXXXXXXXXXXXXXXXXXXXX-----------------------------------------------------------
------------------X..,,,,,............,.............,X----------------------------------------------------------
XXXXXXXXXXXXXXXXXXX,,...........W...E.,...H.........,.XX--------------------------------------------------------
X....,,,,,,,,,,,,,,,..................,.............,...X-------------------------------------------------------
X.E.,...............,.............XXXXX.............,....X------------------------------------------------------
X..,.,,,,,,,,,,,,,,,....XXXXXXXXXX----X.............,.....X-----------------------------------------------------
X.,.,.XXXXXXXXXXXXXXXXXX--------------X,,,,,XXXXXXXXX......XX---------------------------------------------------
X.,.,.X-------------------------------X,,,,,X--------XX......X--------------------------------------------------
X.,.E.X-XXXXXXXXXXXXXXXXXXXXX---------X,,,,,X-XXXXXXX--X......X-------------------------------------------------
X..,..X-XK..................X---------X,,,,,X-X......X--X......X------------------------------------------------
X.....X-X.............E...W.X---------X,,,,,X-X.ttt...X--XX.....X-----------------------------------------------
X.....X-X...................X---------X,,,,,X-X.t.t....X---X.....XX---------------------------------------------
X.....X-X...,,,,,,,,,,,,,,,,XXXXXXXX--X,,,,,X-X.ttt.....X---X......X--------------------------------------------
X.....X-X...,.......................XXX,,,,,X-X..........X---XX.....XXXXXXXXXXXXXXXXXXXXXXXXXXXXXXXXXXXXXXXXX---
X.....X-X...,.........................X,,,,,X-X.....H.....XXX--X....,...................:..................,X---
X..,..X-X...,................................X-X............X---X...,.....................................,..X--
X.,.,.X-X...,.................................X-X...K.,,,...X----XX.,...................W...............,,...X--
X.,.,.X-X...,.................................X-X.....,T,...X------X,..................................,.....X--
X.,.,.X-X.E.,..................................X-X....,,,...X-------XXXXXXXXXXXXXXXXXXXXXXXXXXXXXXXXXXX......X--
X..,..X-X...,..................................X-X..........X---------X,,,,,,,,,,,,,,,,,,,,,,X--------X.......X-
X.....X-X...,.,,,..............................X--XXXXXXXXXXX----XXXXXX,,,,,,,,,,,,,,,,,,,,,,XXXXXXXXXX.......X-
X.....X-X...,.,.,...............................X-----XXXXXXXXXXX......,.....................,,,,,,,.,,.......X-
X.....X-X.A.,.,..,..............................XXXXXX.................,.....................,,,,,,,.,,.......X-
X.....X-X...,.,..,..............................,.......................,....................,,,,,,,.,,........X
X.....X-XXXXX.,...,,,,,,,.......................,.......................,....................,,XXXXXXXX........X
X.....X-----X.,.........,.......................,........................,,,,,,,,,,,,,,,,,,,,XX-------X,.......X
X...,,XXXXXXX.,.....:..,........................,........................,,,,,,,,,,,,,,,,,,,X---XXXXXXX,.,.....X
X.,,........,.,........,........................,........................,,............,,,..X---X.....,,,,,....X
X,..........,.,.......,.........................,........................,,H..E...E.W..T.,H.X---X.:.....,..,..X-
X,,,,,,,,,,.,.,.......,.........................,........................,,............,,,..X---X.........,.XX--
X,.........,,.,...W...,...E.....................,........................,,,,,,,,,,,,,,,,,,,X---XXXXXXXXXXXX----
X,,,,,,,,,,.,.,.......,.........................,........................,,,,,,,,,,,,,,,,,,,,XXXXXXXX-----------
X.,,........,.,.E.....,.........................,.......................,....................,,,,,,,.XXXXXXXXXX-
X...,,......,.,.......,..............,,,,,,.....,.......................,....................,,,,,,,.,,.......X-
X.....XXXXXXX.,........,............,..,...,....XXXXXX.................,.....................,,,,,,,.,,.......X-
X.....X-----X.,........,............,..,.,,,....X-----XXXXXXXXXXX......,.....................,,,,,,,.,,.......X-
X.....X-----X.,,,,,,,,,,,...........,,,,,..,...X-----------------XXXXXX,,,,,,,,,,,,,,,,,,,,,,XXXXXXXXXXXXXX,,,X-
X.....X-----X......................,>...,..,...X----------------------XXXXXXXXXXXXXXXXXXXXXXXX------------X...X-
X.....X-----X........................,,,,,.,...X--XXXXXXXXX-----------------------------------------------X...X-
X.....X-XXXXX.............................,...X---X.......X-----------------------------------------------X...X-
X.....X-X...,.................................X---X...ttt.X---------------XXXXXXXXXXXXXXXXXXXXXXXXXXXXXXX-X...X-
X..,..X-X...,................................X----X.K.t.t.X---------------XXX,,,,,,,,,,,,,,,,,,,,,,,,,XXX-X...X-
X.,.,.X-X...,.W......,,,,,,,...............+XX----X...ttt.XXXXXXXXXXX-----XXX,,,,,,,,,,,,,,,,,,,,,,,,,XXX-X...X-
X.,.,.X-X...,........,.....,............+++...XX--X.................X-----X.,.........................,.X-X...X-
X.,.,.X-X...,,,,,,XXX,,,,,,,XXXXXXXXXXX+........XXX.................X-----X..,..................E....,..X-X...X-
X..,..X-X.........X-X.......X---------X.............................X-----X..,.......................,..X-X...X-
X.....X-X.........X-X...A...X---------X.........................A...X-----X..,............:.........,...X-X...X-
X.....X-X.........X-X.......X---------X.............................X-----X..,......................,...X-X...X-
X.....X-X.....,,,.X-X...A...X---------X...:.........................X-----X...,.....................,...XXX...X-
X.....X-X.....,T,.X-X.......X---------X.............................X-----X...,....................,....,..,..X-
X.....X-X.....,,,.X-X...A...X---------XXXXXXXXXXXXXXXXXXXXXXXXXXXXXXX-----X...,.....E.....W........,....,...,.X-
X..,..X-X.........X-X.......X---------------------------------------------X....,..................,.....,....,X-
X.,.,.X-XXXXXXXXXXX-X.......XXXXXXXXXXXXXXXXXXXXXXXXXXXXXXXXXXXXXXXXXXXXXXX....,..................,.....,.....X-
X.,.,.X-------------X.....................................................,....,...................,,,..,.....X-
X.,.,.XXXXXXXXXXXXXXX.....................................................,,,,,.......................,,,....X--
X..,..,............++.....................................................,..................................X--
X.....,.W...:......++...W...........................A.....................,..................................X--
X.....,............++.....................................................,.................................X---
X.....XXXXXXXXXXXXXX+.....................................................,.............E...................X---
X.....X-------------X.....................................................,.................................X---
X.....X-------------XXXXXXXXXXX,,,XXXXXXXXXXXXXXXXX,,,XXXXXXXXXXXXXXXXXXXXX................................X----
X..,..X-----------------------X...XXXXXX----------X...X--------------------XX..............................X----
X.,.,.X-----------------------X...XXA.WX----------X...X----------------------X.......................,.....X----
X.,T,.X-----------------------X...XX,XXX----------X...X-----------------------X....................,,,....X-----
X.,.,.X-----------------XXXXXXX,,,XX,XXXX---------X...X------------------------XX...E............,,...,..XX-----
X..,..X-----------------X...............X---------X...X--------------------------X...............,...,XXX-------
XXXXXXX-XXXXXXXXXXXXXXXXX.H.......A.A.A.X---------X...X---------------------------XXX.......H....XX,,..X--------
--------X...............,...............X---------X...X-XXXXXXXXXXXXXXXXXXXXX:XXX----XXXXX....XXX-X....X--------
--------X...............,...H...........X---------X...X-X..................,....X---------XXXX-----X....XXXXXXX-
--------X...............,...............X---------X...X-X......W....:..:...,....X------------------X......,,,,X-
--------X...,,,.........,...............X---------X...X-X.ttt.............,:..:.X-------------------X.....,...X-
--------X...,T,.........,.W.............X---------X...X-X.t.t.XXXXXXXXXXXXX.....X---XXXXXXXXXX-------X....,,,,X-
--------X...,,,.........,...............X---------X...XXX.ttt.X-----------X.....X---X........X--------XXXXX,,,X-
--------X...............,...............X---------X...,XX.....X-----------X.....X---X.E....E.X------------X...X-
--------X...............,...H...........X---------X...XXXXXXXXX----------XX,,,,,XXX-X...E....XXXXXXXXXXXX-X,,,X-
--------X...............,.......<.......X---------X...XX-------------XXXX..........XX,,......,..........X-X,,,X-
--------XXXXXXXXXXXXXXXXX.H.............X---------X...,XXXXXXXXX--XXX..................,,,.E.,..........X-X...X-
------------------------X...............X---------X...XXX,,,...X--X......................,...,..........X-X,,,X-
------------------------XX,,,XX,,,XXXXXXX---------X...,XX,T,..AXXXX......................,...XXXXXXXX...X-X,,,X-
-------------------------X,,,XX...X---------------X...XXX,,,E..,..,......................,.E.X------X...X-X...X-
-------------------------X.E.XX...X---------------X,,,X-XXXX..AXXXX.,,,,,.........,,,,,..,...X--XXXXX...X-X,,,X-
-------------------------X...XX,,,X---------------X,..X----X,,,X--X.,E..,.........,..E,..XXXXX--X.......X-X...X-
-------------------------X.E.XX...X--------------X,.,,X----X,,,X--X.,.H.,.........,W..,..X------X.ttt...X-X.H.X-
--------------------------XEX-X...X--------------X,,,,,X--X....X-X..,...,.........,...,..X------X.t.t...X-X...X-
--------------------------X.X-X...X-------------X,,,.,,X--X.....XX..,,,,,.........,,,,,..X------X.ttt...X-X.H.X-
--------------------------XXX-X...X-------------X,,,.,,X-X......XX.......................X------X....XXXX-X...X-
------------------------------X>>>>-------------X,,.,.,X-XA.....,........................XXXX---XXXXX-----X.H.X-
------------------------------------------------X,,...,X-X......,........................,..XXXXXXXXXXXXXXX...X-
------------------------------------------------X,,.H.,X-X..H...,........................,..+.............,.H.X-
------------------------------------------------X,,...,X-X......,............:...........,..+.............,...X-
------------------------------------------------X,,.H.,X-XA.....,........................,..+.............,.H.X-
------------------------------------------------X,,...,X-X......X........................,..XXXXXXXXXXXXXXX...X-
------------------------------------------------X,,.H.,X-X......X........................XXXX-------------X.H.X-
------------------------------------------------X,,...,X--X....XX........................X----------------X...X-
------------------------------------------------X,,.H.,X--X++++XX...,,,,,.........,,,,,..X----------------X.H.X-
------------------------------------------------X,,...,X--X++++XX...,,,,,.........,A..,..X----------------X...X-
------------------------------------------------X,,.H.,X--X....XX...,,H,,.........,...,..X----------------X.H.X-
------------------------------------------------X,,...,X--X....XX...,,,,,.........,..E,..X----------------X...X-
------------------------------------------------X,,.H.,X--X....XX...,,,,,.........,,,,,..X----------------X.H.X-
------------------------------------------------X,,...,X--X....XX............:...........X----------------X...X-
------------------------------------------------X,,.H.,X--X....XXXX....................XXX----------------X.H.X-
------------------------------------------------X,,...,X--X....X---XXXXX...........XXXX-------------------X...X-
-----------------------------------XXXXXXXX-----X,,.H.,X--X.E..XXXXXXX--XXX,,,,,XXX-----------------------X.H.X-
----------------------------------X,-------X----X,,...,X--X....XX....X----X.....X-------------------------X...X-
---------------------------------X-,XXXXXXX-X---X,,.H.,X--X....XX.tttXXXXXX,,,,,X-------------------------X.H.X-
---------------------------------X,XXXXXXXXX-X--X,,...,X--XH...XX.t.t..E..,,,,,.X-------------------------X...X-
--------------------------------X,X..H.....XX.X-X,,.H.,X--XXXXXXX.ttt.....,,,,,.X-------------------------X.H.X-
--------------------------------X,X........XX.X-X,,...,X--------X....XXXXXXXXXXXX--XX---------------------X...X-
-------------------------------XX.X.,,,....XX.X-X,,.H.,XXXXXXXXXXXXXXXXXXXXXXXXXXXXXXXXXXXXXXXXXXX--------X.H.X-
-------------------------------X..X.,T,....XX.X-X,,...,,,,,,,,,,,,,,,,,,,,,,,,,,,,,++..........,..XXXXXX--X...X-
--------------------------------X,XXXXXXX,,XX,XXX,,.H.,,,,,,,,,,,,,,,:,,,,,,,,,,,,++,,.........,.....:..XXX.H.X-
--------------------------------X,XXXXXXX.....XHX,,............:..........,,,,,,,,,.+.,,,,,,,..,..:.......,...X-
--------------------------------X,XX,,,.X,,,,,X.X,,.H.H.H.H.H.H.H.H.H.,,,.,.,.,:,.+.+.,.,.,.,..,......H.H.,.H.X-
--------------------------------X.XX,.,,......,.X,,..............:....,.,.,,,,,,,,,.+.,,,,,,,..,...:......,...X-
--------------------------------X.XX,...,,,,,,,.X,,.H.,,,,,,,,,,,,,,,,,,,,,,,,,,,,,+,,.........,.....XXXXXXXXXX-
--------------------------------X.XX,........,,.X,,...,XXXXXXXXXXXXXXXX,XXXXXXXXXXXXXXXXXXXXXXXXXXXXX-----------
--------------------------------X,XX,........,,.X,,.H.,X--------------X.X----------XX---------------------------
--------------------------------X,XX.,.......,,.X,,...,X--------------X:X---------------------------------------
--------------------------------X,XX.,.......,,.X,,.H.,X--------------X,X---------------------------------------
-------------------------------X..XX.,.......,,.X,,...,X--------------X.X---------------------------------------
-------------------------------XX,XX.,.......,,.X,,.H.,X--------------X.X---------------------------------------
--------------------------------X.XX.,....,,,.,.X,,...,X--------------X.X---------------------------------------
--------------------------------X,XX.,...,....,.X,,.H.,X--------------X.X---------------------------------------
--------------------------------X.XX.,..,....:,.X,,...,X--------------X.X---------------------------------------
--------------------------------X.XX.,..,,,,,,,.X,,.H.,X--------------X.XXXXX-----------------------------------
--------------------------------X+XX:.,.,,.....EX,,...,X--------------X.....X-----------------------------------
--------------------------------X+XX...,,,...E..X,,.H.,X--------------XXXXX.X-----------------------------------
------------------------------XXX.XXXX.,,,.E....X,,...,X------------------X.X-----------------------------------
------------------------------X:.....X.,,,,,,,,,X,,.H.,X------------------X.X-----------------------------------
------------------------------X......X.,,,,,,,,XX,,...,X------------------X.X-----------------------------------
------------------------------X......X.,....E..,X,,.H.,X------------------X,X-----------------------------------
------------------------------X......XtXXXXXXXXXX,,...,X------------------X.X-----------------------------------
------------------------------X......XXXXXXXXXXXX,,.H.,X------------------X.X-----------------------------------
------------------------------X......XXXX,,,,,,,,,,...,X------------------X.X-----------------------------------
------------------------------X.......,.,..,,.......H.,X------------------X.X-----------------------------------
------------------------------X.......,.,.:,,.........,X------------------X.X-----------------------------------
------------------------------X...:...,.,..,,:........,X------------------X.X-----------------------------------
------------------------------X.......XXX,,,,,,,,,,,,,,X------------------X.X-----------------------------------
------------------------------X.......X-X,,,,,,,,,,,,,,X--XXXXXXXXXXXXXXXXX.X-----------------------------------
------------------------------X.......X-XXXXXXXXXXXXXXXX--X......,..........X-----------------------------------
--------------------XXXXXXXXX-X..:....X-------------------X,XXXXXXXXXXXXXXXXX-----------------------------------
--------------------X.......X-X:.....:X-------------------X.X---------------------------------------------------
--------------------X...H...X-XXX.XXXXX-------------------X.X---------------------------------------------------
--------------------X.......X---X+X-----------------------X.X---------------------------------------------------
--------------------X.......X---X.X-----------------------X.X---------------------------------------------------
--------------------X.......X---X.X-----------------------X.X---------------------------------------------------
--------------------X.......X-XXX.XXXXX--------XXX--------X,X---------------------------------------------------
--------------------X.......X-X.......XXXXXXXXXX,X--------X,X---------------------------------------------------
--------------------X.......X-X.........+.,,,,,.XX--------X.X---------------------------------------------------
--------------------X.......X-X,,,,,,,XXXXXXXXX.X---------X.X---------------------------------------------------
--------------------X.....E.XXX,,,,,,,XXXXXXXXX.X---------X,X---------------------------------------------------
--------------------X.................XX..,,.XX.X---------X,X---------------------------------------------------
--------------------X...........E...E.++...,.XX,X---------X.X---------------------------------------------------
--------------------X.................XX...,.XX.X---------X.X---------------------------------------------------
--------------------X.......E......,XX-X...,.XX,X---------X.X---------------------------------------------------
--------------------X...........,,,.XXXX,.,,.XX.XXXXXXXXXXX.X---------------------------------------------------
--------------------XXXXXXXXXXX,...XX..,.,,.,XX.,..,,.,.....X---------------------------------------------------
------------------------------X....XX...,...,XX,XXXXXXXXXXXXX---------------------------------------------------
-------------------------------X...XX,..,,,,,XX,X---------------------------------------------------------------
-------------------------------X..X-X.,,....,XX.X---------------------------------------------------------------
--------------------------------X+XX..,,,...,XX.X---------------------------------------------------------------
--------------------------------X.XX..,E.,,,,XX,X---------------------------------------------------------------
--------------------------------X.X-X,..E.,H,XX.X---------------------------------------------------------------
--------------------------------XWX-XXXXXXXXXXX.X---------------------------------------------------------------
--------------------------------X.XXXXXXXXXXXXX.X---------------------------------------------------------------
--------------------------------X........,,..,,.XX--------------------------------------------------------------
--------------------------------XXXXXXXXXXXXXXXXXX--------------------------------------------------------------
