------------------------------------------------X>>>X--------------------------------------------------------------------------
------------------------------------------------X,,,X--------------------------------------------------------------------------
----------------------------------------------XXX,,,XXX------------------------------------------------------------------------
----------------------------------------------X:.....:X------------------------------------------------------------------------
----------------------------------------------X.......X------------------------------------------------------------------------
----------------------------------------------X.......X------------------------------------------------------------------------
----------------------------------------------X.......X------------------------------------------------------------------------
----------------------------------------------X...E...X------------------------------------------------------------------------
----------------------------------------------X.......X------------------------------------------------------------------------
----------------------------------------------X.......X------------------------------------------------------------------------
----------------------------------------------X.......X------------------------------------------------------------------------
----------------------------------------------X.......X------------------------------------------------------------------------
----------------------------------------------X.......X---------------------------XXXXXXXXXXXXXXXXXXXXXXXXXXXXXXXXXXXXXXXXXXXXX
----------------------------------------------X.......X---------------------------XE,...............,.........................X
----------------------------------------------X.......X---------------------------XXX.A.............,.......................A.X
----------------------------------------------X.......X-----------------------------X...............,.........................X
----------------------------------------------X,,,,,,,X-------------------------XXXXX...............,..................:......X
----------------------------------------------X..,,,..X-------------------------X...,...............,.:...........:...........X
--------------------------------------------XXX,,,,,,,XXX-----------------------XXXXXW..........W.XXX.................XXX.....X
--------------------------------------------:..........:X---------------------------X.............X-X.................X-X.....X
XXXXXXXXXXXXXXXXXXXXXXXXXXXXXXXXXXXXXXXXXXXXX,,,,,,,,,,,XXXXXXXXXXXXXXXXXXXXXXXXXXXXX,,,,,,,,,,,,,XXX,,,,,,,,,,,,,,,,,XXX,,,,,X
X.................................................................,.....,.....,.....,...............................,.,.......X
X.A.........................,,,,,,,...............................,.....,.....,.....,...............................,.,.......X
X...........................,...E,,...............................,.....,.....,.....,...............................,.,.......X
X...........................,..E.,,.......................E.......,.....,.....,.....,...............................,.,.......X
X...........................,.EX.,,...............................,.....,.....,.....,...............................,.,.......X
X.........................:.,.XXE,,.........................E.....,.....,.....,.....,...............................,.,.....E.X
X...........................,EXX.,,...............................,.....,.....,.....,...............................,.,.......X
X...........................,.E.E,,...............................,.....,.....,.....,...............................,.,.......X
X...........................,,,,,,,...............................,.....,.....,.....,...............................,.,.......X
X...........................,,,,,,,...............................,.....,.E...,.....,...............................,.,.......X
X..........................................:............:.........,.....,.....,.....,...............................,.,.......X
X,,,,,,,,,,,XXXXXXXXXXXXXXXXXXXXXXXXXXXXXXXXX,,,,,,,,,,,XXXXXXXXXXXXXXXXXXXXXXXXXXXXX...............................,.,.......X
X...........X-------------------------------X...........X---------------------------X...............................,.,.......X
X...........X-------------------------------XH........H.X---------------------------X...............................,.,.......X
X...........X-------------------------------X...........X---------------------------X...............................,.,.......X
X...........X-------------------------------X....H....W.X---------------------------X,,,,,,,,,,,,,XXX...............,.,.......X
X...........X-------------------------------X...........X---------------------------X..E..........X-X...............,.,.......X
X...........XXXXXXXXXXXXXXXXXXXXXXXXXXXXXXXXX,,,,,,,,,,,XXXXXXXXXXXXXXXXXXXXXXXXX---X.............XXX...............,.,.......X
X...........,...................................................................X---X...............,...............,.,.......X
X...........,..................................................................HX---XXXXXXXXXXX.....,...............,.,.......X
X...........,...................................................................X-------------X.....,...............,.,.......X
X...........,...................................................................X-------------X.....,...............,.,.......X
X...........,...................................................................X-------------X.....,...............,.,.......X
X...........,...................................................................X-------------X.....,.....E.........,.,.......X
X...........,...................................................................X-------------X.H...,...............,.,.......X
X...E.......,...................................................................X-------------XXXXXXX...............,.,.......X
X...........,...................................................................X-------------------X...............,.,.......X
X...........,...................................................................XXXXXXXXXXXXX-------X...............,.,.......X
X...........,...................................................................,.,........AX-------X...............,.,.......X
XXXXXXX,,,XXX...................................................................,.,..,,.....XXXXXXXXX...............,.,.......X
------X...X-X...................................................................,.,..,,...H.,A,..E..,...............,.,.......X
------X...XXX.....................,,,,,,,,,,,,XXXXXXXXXXX,XXXXXXX...............,.,.E.,,,,,.XXXXXXXXX...............,.,.......X
------X.....,.....................,...........X---------X.X-----X...............,.,...,,,W,.X-------X...............,.,.......X
------X.....,.....................,...........X---------X.X-----X...............,.,.....,,,.X-------X...............,.,.......X
------X.....,.....................,...........X---------X.X-----X...............,.,.........X-------X...............,.,.......X
------X.....,.....................,.......E...X---------X.X-----X...............,.,.........X-------X...............,.,.......X
------X.....,.....................,...........X---------X.X-----X...............,.,.........X-------X...............,.,.......X
------X.....,.....................,...XXXXXXXXX---------X.X-----X...............XXXXXXXXXXXXX-------X...............,.,.......X
------X.....,.....................,...X-----------------X.X-----X...............X-------------------X...............,.,.......X
------X.....,.....................,...X-----------------X.X-X>>>>...............X-------------XXXXXXX...............,XXXX.....X
------X.....,.....................,...X-----------------X.X-X...,...............X-------------X.....,...............,X--X.....X
------X.....,.....................,...X-----------------X.X-X.A.,...............X-------------X.....,...............,XXXX.....X
------X.....,.....................,...X-----------------X.X-X...,...............X-------------X.....,...............,.,.......X
------X.....,.....................XXXXX-----------------X.X-X...,...............X-------------X.....,...............,.,.......X
------X.....,.....................X---------------------X.X-X...,...............X-------------X.....,...............,.,.......X
------X.....,.....................X---------------------X.X-X...,,,,,,,,,,,,,,,,X-------------X.....,...............,.,.......X
------X.....,.....................X---------------------X.X-X...................X-------------X.....,...............,.,.......X
------X.....,.....................X-----XXXXXXXXXXXXXXXXX.X-X...................X---XXXXXXXXXXX.....,...............,.,.......X
------X.....,.....................X-----X.................X-X...................X---X...............,...............,.,.......X
------X.....,.....................X-----X...W.............XXX.E.................X---X.H...........XXX...............,.,.......X
------X.....,.....................X-----X...................,...................X---X.............X-X...............,.,.......X
------X.....,.....................X-----X.................XXX...................X---X,,,,,,,,,,,,,XXX...............,.,.......X
------X.....,.....................X-----X........E........X-X...................X---X...............................,.,.......X
------X.....,.....................XXXXX-X.................X-XXXXXXXXXXXXXXXXX...X---X...........................,,,,,.,.......X
------X.....,.....................,...X-X.....X..XX.......X-----------------X...X---X...<.......................,.....,.......X
------X.....,.....................,...X-X.XXXXX,,XXXXXXXX.X-----------------X...X---X...........................,.....,.......X
------X.....,.....................,...X-X.X---X...X-----X.X-----------------X...X---X.<.........................,.....,.......X
------X.....,.....................,...X-X.X---X...X-----X.XXXXXXXXXXXXXXX---X...X---X...........................,.....,.......X
------X.....,.....................,...X-X.X---X...X-----X.,.............X---X...X---X...........................,..H..,.......X
------X.....,.....................,...X-X.X-XXX,,,XXX---X.,.......A.H.W.X---X...X---X...<.......................,.....,.......X
------X.....,.....................,...X-X.X-XH,,,,,HX---X.,.............X---X...X---X...........................,.....,.......X
------X.....,.....................,...X-X.X-XXXXXXXXX---X.XXXXXXX.....A.X---X...X---X.<.........................,.....,.......X
------X.....,.....................,...X-X.X-------------X.X-----X.......X---X...X---X...........................,.....,.......X
------X...H.,.....................,...XXX,XXXXX---------X.X-----X.....A.X---X...X---X...........................,.....,.......X
------X.....,.....................,...........X---------X.X-----X.......X---X...X---X...........................,.....,.......X
------X.....,.....................,.........H.X---------X.X-----X.......X---X.H.X---X...........................,,,,,.,.......X
------X.....,.....................,...........X---------X.X-----X.......X---X...X---X...............................,.,.......X
------X.....,.....................,...........X---------X.XXXXXXX,,,,,,,XXXXX...X---X,,,,,,,,,,,,,XXX...............,.,.......X
------X.....,.....................,...........X---------X..E............E...,...X---X.............X-X...............,.,.......X
------X.....,.....................,,,,,,,,,,,,XXXXXXXXX-X.....XXXXXXXXXXXXXXX...X---X.............XXX...............,.,.......X
------X.....,.........................................X-X.....X-------------X...X---X...............,...............,.,.......X
------X...E.,.........................................X-X.....X-XXXXXXXXXXXXX,,,X---XXXXXXXXXXX.....,...........W...,.,.......X
------X.....,.........................................X-X.....X-X...............X-------------X.....,...............,.,.......X
------X.....,.........................................X-X.A...X-X.W.............X-------------X.....,...............,.,.......X
------X.....,.........................................X-X.....X-X.......E.......X-------------X.....,...............,.,.......X
------X.....,.........................................XXX..E..X-X...............X-------------X.....,...............,.,.......X
------X.....,.........................................,.......X-X...............X-------------X.H...,...............,.,.......X
------X.....,...................................E.....XXXXXXX.X-X...............X-------------X.....,...............,XXXX.....X
------X.....,.........................................X-----X.X-X...............X-------------X.....,...............,X--X.....X
------X.....,.........................................X-----X.X-X...............X-------------XXXXXXX...............,XXXX.....X
------X.....,.........................................X-----X.X-X...............X-------------------X...............,.,.......X
------X.....,.........................................X-----X.X-X...............XXXXXXXXXXXXX-------X...............,.,.......X
------X.....,.........................................X-----X.X-X...............,...........X-------X...............,.,.......X
------X.....,.........................................X-----X.X-X...............,...........X-------X...............,.,.......X
------X.....,.........................................X-----X.X-X...............,....:......X-------X...............,.,.......X
------X.....,.....................,,,,,,,,,,,,XXX,XXXXX-----X.X-X...............,.........W.X-------X...............,.,.......X
------X.....,.....................,...........X-X.X---------X.X-X.W.............,...........X-------X...............,.,.......X
------X.....,.....................,.........H.X-X.XXXXXXXXXXX.X-X.......A.......,...........X-------X...............,.,.......X
------X.....,.....................,...........X-X.............X-X...............,..E........X-------X...............,.,.......X
------X.....,.....................,...XXXXXXXXX-X.XXXXXXXXXXX.X-X...............,.........A.X-------X...............,.,.......X
------X.....,.....................,...X---------X.X---------X.X-X...............,...........X-------X...............,.,.......X
------X.....,.....................,...X---------X.X-------XXX,XXX...............XXXXXXXXXXXXX-XXXXXXX...............,.,.......X
------X.....,.....................,.:.X---------X.X-------X.....,...............X-------------X.....,...............,.,.......X
------X.....,.....................,...XXXXXXXXXXX.X-------X.....,...............X-------------X.E...,...............,.,.......X
------X.....,.....................,...,...........X-------X.....,...............X-------------X.....,...............,.,.......X
------X.....,.....................,...XXXXXXXXXXX.X-------X.....,...............X-------------X.....,...............,.,.......X
------X.....,.....................,...X---------X.X-------X.....,...............X-------------X.....,...............,.,.......X
------X.....,.....................,...X---------X.X-------X.....,...............X-------------X.....,...............,.,.......X
------X.....,.....................,...X---------X.X-------X.....,...............X-------------X.....,...............,.,.......X
------X.....,.....................,...XXXXXXXXX-X.X-XXXXXXX.....,...............X---XXXXXXXXXXX.....,...............,.,.......X
------X.....,.....................,...........X-X.X-X...........,...............X---X...............,...............,.,.......X
------X.....,...........E.........,...........X-X.X-X.H.........,...............X---X..H..........XXX...............,.,.......X
------X.....,.....................,...........X-X.X-X...........,...............X---X.............X-X...............,.,.......X
------X.....,.....................,,,,,,,,,,,,XXX,XXX,,,,,,,,,,,,,,,,,,,,,,,,,,,XXXXX,,,,,,,,,,,,,XXX...............,.,.......X
------X.....,.......................................................................................................,.,.......X
------X.....,.......................................................................................................,.,.......X
------X.....,.......................................................................................................,.,.......X
------X.....,.......................................................................................................,.,.......X
------X.....,.......................................................................................................,.,.......X
------X.....,.......................................................................................................,.,.......X
------X.....,.......................................................................................................,.,.......X
------X.A...,.......................................................................................................,.,.......X
------X.....,.......................................................................................................,.,.......X
------X.....,.......................................................................................................,.,...E...X
------X.....,.......................................................................................................,.,.......X
------X.....,.......................................................................................................,.,.......X
------X.....,.......................................................................................................,.,.......X
------X.....,.......................................................................................................,.,.......X
------X.....,.......................................................................................................,.,.......X
------X,,,,,,,,,,,,,,,,,,,,,,,,,,,,,,,,,,,,,,,,,,,,,,,,,,,,,,,,,,,,,,,,,,,,,,,,,,,,,,,,,,,,,,,,,,,,,,,,,,,,,,,,,,,,,,,XXX,,,,,X
------X...............................................................................................................X-X.....X
------X...............................................................................................................XXX.....X
------X.......................................................................................................................X
------X...E.....................................E.................E.........H.........................E.......................X
------X.................................E.....................................................................................X
------X.A...................................................................................................................A.X
------X.............................XX.............XX.........................................................................X
------XXXXXXXXXXXXXXXXXXXXXXXXXXXXXXXX,,,,,,,,,,,,,XXXXXXXXXXXXXXXX,,,,,,,,,,,,,,,,,,,,,,,,,,,,,,,XXXXXXXXXXXXXXXXXXXXXXXXXXXXX
------------------------------------X...............X-------------X,.............................,X----------------------------
------------------------------------X.E.....E....E..X-------------X.,,,,,,,,,,,,,,,,,,,,,,,,,,,,,.X----------------------------
------------------------------------X...............X-------------X.,...........................,.X----------------------------
------------------------------------X.....E.........X-------------X.,...........................,.X----------------------------
------------------------------------X...............X-------------X.,...........................,.X----------------------------
------------------------------------X.A...A...A...A.X-------------X.,,,,,,,,,,,,,,,,,,,,,,,,,,,,,.X----------------------------
------------------------------------X...............X-------------X...............................X----------------------------
------------------------------------XXXXXXXX,XXXXXXXX-------------XXXXXXXXXXXXXXXXXXXXXXXXXXXXXXXXX----------------------------
-------------------------------------------X.X---------------------------------------------------------------------------------
-------------------------------------------XXX---------------------------------------------------------------------------------
