----------------------------XXXXXXXXXXXXXXXXXXXXXXXXX----------------------------------------
----------------------------XE+EEEE,,...........L,EE>----------------------------------------
----------------------------XXXXXXXXX...........XXXXX----------------------------------------
------------------------------------X...........X--------------------------------------------
------------------------------------X...........X--------------------------------------------
------------------------------------X...........X--------------------------------------------
------------------------------------X,,,,,,,,,,,X--------------------------------------------
------------------------------------X...........X--------------------------------------------
------------------------------------X...........X--------------------------------------------
------------------------------------X........E..X--------------------------------------------
------------------------------------X...........X--------------------------------------------
------------------------------------X.....:.....X--------------------------------------------
------------------------------------X...........X--------------------------------------------
------------------------------------X...........X--------------------------------------------
------------------------------------X.........E.X--------------------------------------------
------------------------------------X...........X--------------------------------------------
------------------------------------X...........X--------------------------------------------
------------------------------------X...........X--------------------------------------------
------------------------------------X.E.........X--------------------------------------------
------------------------------------X...........X--------------------------------------------
------------------------------------X...........X--------------------------------------------
------------------------------------X...........X--------------------------------------------
------------------------------------X...........X--------------------------------------------
------------------------------------X...........X--------------------------------------------
------------------------------------X...........X--------------------------------------------
------------------------------------X:.........:X--------------------------------------------
------------------------------------XXXXX,,,XXXXX--------------------------------------------
--------------------------------------XXX,,,XXX----------------------------------------------
------------------------------------XX:,,,E,,:XXX--------------------------------------------
------------------------------------X..........AX--------------------------------------------
------------------------------------B.......,T,AX--------------------------------------------
------------------------------------B.......W.,.X--------------------------------------------
------------------------------------B.......,,,BX--------------------------------------------
------------------------------------X...........X--------------------------------------------
------------------------------------W...........X--------------------------------------------
------------------------------------XA...:.<....X--------------------------------------------
------------------------------------X,,........BX--------------------------------------------
------------------------------------XA,....<...BX--------------------------------------------
------------------------------------X.,....<....X--------------------------------------------
------------------------------------A.,..<.....EX--------------------------------------------
------------------------------------X,,.........X--------------------------------------------
------------------------------------XW,.........X--------------------------------------------
------------------------------------X,,.........X--------------------------------------------
------------------------------------:..........:X--------------------------------------------
--------------------------XXXXXXXXXXX...........XXXXXXXXXXX----------------------------------
-------------------------X.................................X---------------------------------
------------------------X...,,,,,,,,,,,,,,,,,,,,,,,,,,,.....X--------------------------------
-----------------------X....,........................A,......X-------------------------------
----------------------X.....,.........................,.......X------------------------------
---------------------X......,........................,,........X-----------------------------
--------------------X.......,.....,,,,XX,,,XX,,,,....,,.........X----------------------------
-------------------X........,.....,,..XX...XX..,,....,,.........BB---------------------------
------------------X.........,.....,.,,,,,,,,,,,.,....,,..........BX--------------------------
-----------------X.....:,,,,,.....,.,.........,.,....,,............X-------------------------
----------------X.....,,,,,,,.....,.,.........,.,.....,.............X------------------------
---------------X......,,,,,,,.....,.,.........,.,.....,,,,X:.........X-----------------------
--------------X...,,,.,:,,,,,,,,,,X.,.........,.,.....,,,,,,,.........X----------------------
-------------X....,.,.............X.,.........,.,.....,,,,,,,..........X---------------------
------------X.....,,,.....:.....A.X.,.........,.X,,,,,,,,,X:,...:.......X--------------------
-----------X...................A..X.,....E....,.B.............XXXXXXX....X-------------------
XXXXXXXXXXX...........,,,.,,,...BBX.,,,,,,,,,,,.B............EX-----XE....XXXEXEXXXXXXXXXXXEX
X.....................,.,.,.,..B.BX.:.X,,,XX:...B.B..........BX-----X.................,.....X
X.............,,,,,A,.,,,.,,,.BBBXXXXXXX,XXXXXXXXX..B........BX-----XE..............E.,.....X
X.............,W..,.,........BXXX------X,,X-------XXXBB.....B.BXXXXXXEB.B.............E.....X
XXXXXXXXXXXXXXXXXXXXXXXXXXXXXX---------X..X----------XXXXXXXXXXXXXX,,,XXXXXXXXXXXXXXXXX...,,X
---------------------------------------X..X-----------------------X,,,XX--------------E...,.X
------------------------X:XXXXXXXXXEXXXX,,XXXXXXXXXXXXXXX:X-------X,,.X-XXXXXXXXXXXXXXX,,,,,X
------------------------X.......,...,.........,...,E......X-------XHE.X-XH.H..............,,X
------------------------X.......,...,.........,...,....H..X-------X,,,X-X................E.,X
------------------------X:......,..E,.........,...,E.....:X-------X...X-X..................,X
------------------------X.....XXXXXXXXX:...:XXXXXXXXX..H..X-------X.E.XXX..................,X
------------------------X.....X-------X.....X-------X....HX-------X...,.,.E..H............E,X
------------------------H.....XXXXXXXXX.,,,.X-------X.....X-------X..EXXX..................,X
------------------------XH.......,E,.XX.,.,.X-------XB.HB.X-------X,,,X-X.................E,X
------------------------X........,.,.XX.,.,.X-------XXX.XXX-----XBX,,,X-X..................,X
------------------------X........,.,.XX.,.,.X---------XEX-------BXX...X-H,H,,,,,,,,,,,,,,,,,X
------------------------X:.......,K,.XX.,,,.X---XXXEXXX,XXXXXXXXXXX...X-X,,,,,,,,E,,,,,,,,HHX
------------------------XXXXXXXXXXXX.XX.....X---X,..,,,B,,.E,,.E.XX...X-XK.E.E.E..........HHX
--------------------------XXXXXXXXXX.XX,,,,XX---X,XXXXX,XXXXXXXXXXX...X-XXXXXXX...........HHX
--------------------------XH:.HXX.,..XX....X----XEX-XEX,XXXXX....XX.E.X-------XE..........H.X
--------------------------X....XX,XX.XX....X----X.X-X...E,KXXLXXXXX...XEXXXXXXX...........HHX
--------------------------XH...,,.XX.XX....X----XEX-X....XXXX.XX.XX,,.X.....E.,...........HHX
--------------------------X:..:,,EXXEXX,,,,XX---X.X-X.E.EXXXX+XXEXX,,,X.XXXXXXXXXXXXXXXXXXXXX
--------------------------X..:.,,.XX.XX.....X---X.X-X....XX...XX.XX...X.X--------------------
--------------------------X:...,,.XXXXX.....X---X.X-X,BB,XX,,,XX.XX...XEX--------------------
--------------------------XA...,,.X---X.....X---X.X-X,..,.,E..XX.XX...X.X--------------------
--------------------------XA..:,,.XXXXX.,,,.XXXXX.X-X,..,.,,,.XX.XX...X.X--------------------
--------------------------X..:.,,..E....,.,.......X-X,..,E,H,.XX.XX...X.X--------------------
--------------------------X:...,,.......,.,.......X-XE..,,,,,.XX.XX...X.X--------------------
--------------------------XW...,,.......,.,.......X-X..E,E,E..XX.XX...X.X--------------------
--------------------------XW..:,,.XXXXX.,,,.XXXXX.X-X...,,,,,EXX.XX...X.X--------------------
--------------------------X..:.,,.X---X.....X---XEX-X...,E,H,.XX.XX...X.X--------------------
--------------------------X:...XXEX---X.....X---XLX-X.,,,.,,,.XX.XX...X.X--------------------
--------------------------X.W.WXX.X---X.....X---X.X-X.,.B.,...XX.XX,,,X.X--------------------
--------------------------XXXXXXXXX---X,,,,XX---X+X-X.,,,.,.H,XX.XX,,,X.X--------------------
--------------------------------------X,,,,X----X.X-XE..,.,.,.XX..,..,,.X--------------------
--------------------------------------X,..,X--XXX,XBX...,.,.H.XX..,..,,.X--------------------
--------------------------------------X,,,,X--XE..,....E,.,.,HXX..,..,,.X--------------------
--------------------------------------X,,,,XX-X...,...,,,.,.H.XX..,..,,.X--------------------
--------------------------------------X.....X-XE..,...,H,.,.,.XX..,..,,.X--------------------
--------------------------------------X.....X-X...,...,.W.,.,.XX..,..,,.X--------------------
--------------------------------------X.....X-XE..,...,H,.,.,.XX..,..,,.X--------------------
--------------------------------------X.,,,.X-X...,...,,,.,.,EXX..,..,,.X--------------------
--------------------------------------X.,.,.X-X...,....E,.,...XX..,..,,.X--------------------
--------------------------------------X.,E,.X-XE..,.....,,,..:XX..,..,,.X--------------------
--------------------------------------X.,.,.X-X...,.....,HE..:XX..,..,,.X--------------------
--------------------------------------X.,,,.X-X...,.....,,,.::XXX.,..,,.X--------------------
--------------------------------------X.....X-XE..,..E..,.,.::XX..,..,,.X--------------------
--------------------------------------X.....X-XXB.,B,,,.,.,...XXE.,..,,.X--------------------
--------------------------------------X.....X---X.,.,.,.,.,..EXX..,..,,.X--------------------
----------------------------------XXXXX,,,,,XXXXX.,E,.,E,.,...XX..,..,,.X--------------------
----------------------------------X...........L.+.,.,H,E,.,..EXX..,..,,.X--------------------
----------------------------------XXXXXX,,,XXXXXXXXXXXXXXXXXXXXX..,..,,.X--------------------
---------------------------------XXXXXXX+++XXXXXXXXXXXXXXXXXXXXX..,..,,.X--------------------
---------------------------------X...W:,...,:.E....E..........:X..,..,,.X--------------------
---------------------------------X.....,...,...................X..,..,,.X--------------------
---------------------------------X,,,,,,,,,,,,,,,,,,,,,,,,,,,,,XX,,..,,.X--------------------
---------------------------------X,,........................,,,...,..,,.X--------------------
---------------------------------X,,......................E.,,,XX,,..,,.X--------------------
---------------------------------X,,,,,,,,,,,,,,,,,,,,,,,,,,,,,XX.,..,,.X--------------------
---------------------------------E,,,,,,,,,,,,,,,,,,,,,,,,,,,E,X..,..,,.X--------------------
---------------------------------XXXXXXXXXXXXXXXXXXXXXXXXXXXXX:X..,..,,.X--------------------
---------------------------------------------------------------X..,..,,.X--------------------
---------------------------------------------------------------X..,,,,,.X--------------------
---------------------------------------------------------------X:.,,,,,.:--------------------
---------------------------------------------------------------XXXXXXXXXX--------------------
