--------------------------------------------------------XXXXXXXXXXXXXXXXXXXXXXXXXXXXXXXXXXXXXXX---------
--------------------------------------------------------X:........E.....E....................:X---------
--------------------------------------------------------X.....................E...............XXEXEXXXX-
--------------------------------------------------------X.....................................,......EX-
--------XXXXXXXXXXXXXXXXX-------------------------------X.....................................,...E.AEX-
--------X,,,,,,,,,,,,,,,,XXXXXXXXXXXXXXXX---------------X.:...................................,.E.....X-
--------X..........:..........:.......:.,X--------------X.....................................,....E.EX-
--------X.:.............................,.X-------------X.....................................,.E.....X-
--------X...............................,..X------------X.....................................,.E....EX-
--------X...............................,...X--------XX-X...:...............................:.,...E...X-
--------X...............................,....X-----XX.X-X.....................................XXXXXXXXX-
--------X...............................,.....X--XX.:.XKX.....................................X---------
--------X...............................,......XX.....XEXX,XXXXXXXXXXXXXXXXXXXXXXXXXXXXX...XXXX---------
--------X...............................,.............X......X-------------------------X...X------------
--------X...............................,.............X,,.,,,X------------------------XX.:.X------------
--------X...............................,.............X:,.,EAX------------------------XX...X------------
--------X...............................,.............X..:,,,X-------------------------X...X------------
--------X...............................,.............X..XXXXXXXXXXXXXXXXXXXXXXXXXXXXXXX,,,XXX----------
--------X...............................,.............X..XX:.,:.............................:X----------
X-------X...............................,..........:..X.,XX..,..............E.....E..........X----------
XX------X...............................,.............X.:XX..,...............................X----------
X.X-----X...............................,,,,,,,,,,,...X,BXX..,...............................X----------
X..X----X...............................,,,,,,,,,,,...X,,XXE.,.............................E.X----------
X...X---X...............................,,,.......,...X,,XX..,.......E.......................X----------
X...X---X...............................,,,.......,...XEHXX..,...............................X----------
X....X--X...............................,,,A.,,,..,.:.XXXXX..XXX,XXX,,,XXX,,,XXX,,,XXX,,,,,,,X----------
X.....X-X...............................,,,..,:,..,...X---X..X-XXX-XXXXX-XXXXX-XXXXX-:.......X----------
X......XX...............................,,,..,,,..,...X---X..X----------------------XX.......X----------
X.......X...............................,,,.......,...X---X..X----------------------X,.......X----------
X.......X...............................,,,.......,...X---X..X----------------------X,.......X----------
X.......X...............................,,,,,,,,,,,...X---X..X----------------------X,.......X----------
X.......X...............................,.............X---X..X----------------------XX.......X----------
X.......X...:...........................,.............X---X..X-----------------------X.......X----------
X.......X.......................:.......,.............X---X..X----------------------XX.......X----------
X.......X...............................,..:......:...X---X..X----------------------X,.......X----------
X......,X,,..................,,,+,,.....,.............X---X..X----------------------X,.....E.X----------
X......,X,.,,:,.:...........E,,A.W,E....,.............X---X..X----------------------X,.......X----------
X......,,,..,,.,,,,:.........,,,,,,.....,...,,,,,,,,,,X---X..XXXX-------------------XX.......X----------
X......,,,..,,.....,,,,:.....,,,,,,.....,...,.........X---X..XX..XXXXX---------------X.......X----------
X......,,,..,,.........,,,,:....:.......,...,.H.....H.X---X..X........XXXXXXXXXXXXXXXX.......X----------
X......,,,..,,.............,,,,.........,...,....,,,..X---X,,......E...:XX...........,.......X----------
X......,,,..,,.................,,,,.:...,...,....,:,..X---X.............XX.....E.....,.......X----------
X......,,,..,,.....................,,,,.:..:,....,,,..X---X.........,:,.X,.E.........,.......X----------
X......,,,..,,.........................,,,,,,,,,,,,,,,XX--X:........,:,.X,..,,,,,,,,,,.......X----------
X......,X,.,,,,.........................,...,.,,,,,,.,:X--X.........,,,.X,..,.,,,,,.,:.......X----------
X......,X,,..:.,,,,.....................,...,.,,,,,,.,,XXXX........:,,E.XX..,.......,,.......X----------
X.......X.......:..,,,,.................,...,.,,,,,,.,,,++,.........,.,.XX..,.......,,.......X----------
X.......X..........:...,,,,......<......,...,.,,,,,,.,,,++,.....K...,.,.XX..,.......,,.....E.X----------
X.......X..............:...,,,,.........,...,.,,,,,,.,,,++,.........,:,.XXE.,.......,,.......X----------
X.......X..................:...,,,,.....,...,.,,,,,,.,,XXXX.........,.,.XX..,.......,,.......X----------
X.......X...:......................,,,,.,...,.,,,,,,.,:X--X.........,.,.X,..,.......,,.......X----------
X.......X...........................:..,,,,,,,,,,,,,,,XX---X:.......,.E.X,..,,,,,,,,,:.......X----------
X.......X...............................:...,....,,,..X----X.......:,,,.X,...........,.......X----------
X.......X...............................,..:,....,:,..X----X............XX.....E.....,.......X----------
X.......X...............................,...,....,,,..X----X,.......A..:XX...........,.......X----------
X.......X...............................,...,.........X----X.X........XXXXX,,,XXX,,,XX.......X----------
X.......X...............................,...,.H.....H.X----XHX...XXXXX----XXXXX-XXXXXX.......X----------
X......XX...............................,...,,,,,,,,,,X----XX-XXX-------------------XX.......X----------
X....XX-X...............................,.............X----XX-----------------------X,.......X----------
X...X---X...............................,..:..........X----XX-----------------------X,.....E.X----------
X..X----X...............................,..........:..X----XX-----------------------X,.......X----------
XXX-----X...............................,.............X----XX-----------------------XX.......X----------
X-------X...............................,.,,,,,,,,,,..X----XX------------------------X.......X----------
--------X...............................,.,,,,,,,,,,..X----XX-----------------------XX.......X----------
--------X...............................,.,.......,,..X----XX-----------------------X,.......X----------
--------X...............................,.,.......,,..X----XX-----------------------X,E......X----------
--------X...............................,.,..,,,..,,..X----XX-----------------------X,.......X----------
--------X...............................,.,..,:,..,,:.X----XX-----------------------XX.......X----------
--------X...............................,.,.A,,,..,,..X----X-------------------------X.......X----------
--------X...............................,.,.......,,..X----XXXXXXXXXXXXXXXXXXXXXXXXXX:.......X----------
--------X...............................,.,.......,,..X----X:........................,.......X----------
--------X...............................,.,,,,,,,,,,..X----X...E.....E.....E.........,.......X----------
--------X...............................,.............X----X.........................,.......X----------
--------X...............................,.............X----XE........................,.......X----------
--------X...............................,..........:..X----X.........................,.......X----------
--------X...............................,.............X----X.........................,.......X----------
--------X...............................,.............X----X.....................E...,.....:.X----------
--------X...............................,.............X----XXX,,,XXX,,,XXX,,,XXX,,,XXXXX,,,XXX----------
--------X...............................,.............X------XLLLX-XXXXX-XXXXX-XXXXX---XXXXX------------
--------X...............................,.............X-----XX...X----------------------------------XX--
--------X...............................,.............X-----X,...X-------------------------------XXX.X--
--------X...............................,.............X-----XX.E.X-----------XXH---------------XX....X--
--------X...............................,.............X------X...X-----------XEX---------------X.....X--
--------X...............................,.............X----XXX,,,XXXXXXXXXXXXX,XXXXXX---------X......X--
--------X...............................,.............X----X:......................:X---------X......X--
--------X...............................,.............X----X........................X---------X......X--
--------X...............................,.......XX....X----X...........E.....:......X---------X......X--
--------X...............................,......X--XX:.X----X........................XXXX:X---X.......X--
--------X...............................,.....X-----XXX----X........................,:LL.XXXXX.......X--
--------X...............................,....X--------X----XE.....................E.,,LL.,,,,>.......X--
--------X...............................,...X--------------X........................,.LL.XXXXX.......X--
--------X....................:..........,..X---------------X........................XXXXXX---X.......X--
--------X.:.........:.................:.,.X----------------X..................E.....X---------X......X--
--------X...............................,X-----------------X........................X---------X......X--
--------X,,,,,,,,,,,,,,,,,,,,,,,,,,,,,,,X------------------X:XX,XXXX,XX,XXX,XX,XXX,:X---------X......X--
--------XXXXXXXXXXXXXXXXXXXXXXXXXXXXXXXXXX--------------XXAXXXX,XXXXXXX,X-XXXXXX-XXX----------X......X--
--------------------------------------------------------X........,HX--XEX----------------------X.....X--
--------------------------------------------------------X........,EX--XXX----------------------XX....X--
--------------------------------------------------------X........,.X-----------------------------XXX.X--
--------------------------------------------------------X........,EX--------------------------------XX--
--------------------------------------------------------XE....E..,HX------------------------------------
--------------------------------------------------------XXXX,XXXXXXX------------------------------------
-----------------------------------------------------------X.X------------------------------------------
--------------------------------------------------------XXXX,XXXXXXX------------------------------------
--------------------------------------------------------X......E..HX------------------------------------
--------------------------------------------------------H.......,,,X------------------------------------
--------------------------------------------------------X.......,.,H------------------------------------
--------------------------------------------------------X.......,.,X------------------------------------
--------------------------------------------------------X.......,.,H------------------------------------
--------------------------------------------------------X.......,.,X------------------------------------
--------------------------------------------------------X.E....E,.,H------------------------------------
--------------------------------------------------------X.......,.,X------------------------------------
--------------------------------------------------------X.......,.,H------------------------------------
--------------------------------------------------------XE......,,,X------------------------------------
--------------------------------------------------------X.........EX------------------------------------
--------------------------------------------------------XXXXXXXXXXXX------------------------------------
---------------------------------------------------------------XK---------------------------------------
