XXXXXXXXXXXXXXXXX---------------------------XXXXXXXXXXXXXXXXXXXXXXX--------------------
X...............X---------------------------XE...,..............,,X--------------------
X....E.....E..EAX---------------------------X.XXXX,,,,,,,,,,,,,,..X--------------------
X..............AX---------------------------X.X--:............:...X--------------------
X...............X---------------------------X.X--X............,...X--------------------
XE..............X-----------XXXXXXXXXXXXXXXXX.X--X............,.:.X--------------------
X...............X-----------X......E...E.....EX--X.....E......,...X--------------------
X...............X-----------X.XXXXXXXXXXXXXXXXX--X............,...X--------------------
X..............EX-----------XEX--XXX-------------X.........,K.,...X--XXXXXXX-----------
X...............X-----------X.X--XKX-------XXXHXXX.........,,.,...X--X..E..:-----------
XE......E.......XXXXXXXXXXXXX.X--X.X-------X:,..,X............,...X--XEXXXXX-----------
X..............E,.,....E..E.E.X--XEX-------X.,..,X.....:......,...X--X.X---------------
X...............XXXXXXXXXXXXXXX-X..X----XXXX,,...X............,...X--X.X---------------
X...............X---------------X..X----X:.XA....,..XXXX,,,XXX:XHXX--XEX---------------
X...............XXXXXXXXXXXXXXXXX,,X----X..XW..E.X:.XXXX,,,XXX-------X.X---------------
E..............EX:,.,,,,,.,,E.,,,.:X----X..XA.E.:X..X...E.EE.EXXXXXXXX,X---------------
X...............X.,.XXXXXXXXXXXXXXX:----X..X,,,,,X..A........,.,..E.E..X---------------
X..............:X,XXXXXXXXXXXXXXXXXXXXXXXE.+.E.E.X..A....EE.EXXX.......:---------------
X...............,..,,,,,,,,,,,,,,,.,,.,.,..XXXXXXX..X........X-X:......X---------------
X...E..E.....E.:XXXXXXXXXXXXXXXXXXXXXXXXXE.XXXXXXXXXXLX:XXXXXX-XX,,,XX,X---------------
X...............X<<......X--------------X..L,.,......E.:X-------XE.EXX.X---------------
X,,,,,,,,,XXXXXXX<<......X--------------XE.XXXXXEXEXX+XXX-------XXXXXXEX---------------
X.........X-----X.......:XXXXXXXXXXXXXXXX..X-----XXXX+XAWAXXXX-------X.X---------------
X.........X-----X....W.A.,.,,.,,,,,,,,,,,..XXXXXXX..X.,......X-------X.XXXXXXXXXXXXXXX-
X........EX-----X........XXXXXXXXXXXXXXXXE.+..E:WXH.X.,..E.E.X-------XE,...E.....>.,.X-
X..E......X-----X.......:X--------------X..X,,,,,X..X.E......X-------X.XXXXXXXXXXX.XXX-
X.....E...X-----XT.......X--------XXXXXXX..X..E.:X..X.,.EE.EEX-------X.X---------XXX---
X.........X-----XXXXXXXXXX--------W....++..X.....,..X:XX,,,XXX-------XXX---------------
X.E..H....X-----------------------X,,,,XX:.X.E...,..XXXX,,,XXX:XXX---------------------
XXXXXXXXXXX-----------------------:....XXXXX,,...X........ttt.,..X---------------------
----------------------------------X..E.XX:.,.,E.,X........t.t.,..X---------------------
----------------------------------X....XX..,.,..,X........ttt.,..X---------------------
----------------------------------X,,..XX..,,XXXXX............,..X---------------------
----------------------------------X.,.,XX....X---X............,.:X---------------------
----------------------------------X.,.,XX...HX---X.:........:.,..X---------------------
----------------------------------XXXHXXX....X---X............,..X---------------------
----------------------------------------X.:.HXXXXX............,..X---------------------
----------------------------------------X.......+,............,..X---------------------
----------------------------------------XXXXXXXXX:............:..X---------------------
-------------------------------------------------X,,,,,,,,,,,,,..X---------------------
-------------------------------------------------X...............X---------------------
-------------------------------------------------XXXXXXXXXXXXXXXXX---------------------
