--------------------------------------------------------------XXXXX----------XXX-------------------------------------------------------------------------------
--------------------------------------------------------------X...X----------X,X-------------------------------------------------------------------------------
--------------------------------------------------------XXXX-X.....X-XXXX-X:XX,XXX:----------------------------------------------------------------------------
--------------------------------------------------------XE.X-X.....X-XE.X-X.<.<<.<X----------------------------------------------------------------------------
--------------------------------------------------------X..XX,,,,,,,XX..X-X...:...X----------------------------------------------------------------------------
-------------------------------------------------------XX,,XX,,,,,,,XX,,XXX.......X----------------------------------------------------------------------------
-------------------------------------------------------X:.......:.......:XX.......X----------------------------------------------------------------------------
-------------------------------------------------------X.................XX.......X----------------------------------------------------------------------------
-------------------------------------------------------X.................,,.......X----------------------------------------------------------------------------
-------------------------------------------------------X................H,,...W...X----------------------------------------------------------------------------
-------------------------------XXXXX-------------------XH.......H........,,.......X----------------------------------------------------------------------------
------------------------------X..E..X------------------X....++.H.H..+....,,.......X-XXXXXXXXXXXXXXXXXXXXXXXXXXXXXXXXX------------------------------------------
-----------------------------XE....B.X-----------------XH..+..H+W.H+.+..HXX:......:-X....E..........................X------------------------------------------
----------------------------X..,,,,,..XX---------------X..+....H+H...+...X--X+++XX--X.E.........E.....E........E....X------------------------------------------
---------------------------XH.,.....,H..X--------------XH.+.....H.....+.HX--X...X---X........E.....t..........t...E.X------------------------------------------
--------------------------X..,.......,.t.X-------------X.+.............+.X--X...X---X.............t.E......E..t.....X------------------------------------------
-------------------------X..,..,,,,,.,tTt.X------------X+...............+X--X...X---X...........tt.....E.......E....X------------------------------------------
-------------------------XE,..,:..:.,.,t.X-------------X:E............E.:X--X...X---X.......E..t...............t....X------------------------------------------
------------------------X..,.,......,..,.X---------------XXX...........XXX--X...X---X...E......tE..E........E...t...X------------------------------------------
-----------------------XE.,.,......:.,..X-------------------X:,,,,,:XXX-----X..:X---X.t.........t...............t...X------------------------------------------
----------------------X..,..,.E......,..X--------------------X.....X--------X..::---X..t........t.........E.....t.E.X------------------------------------------
---------------------XB.,..,..........,.X--------------------X..H..X--------X...X---X..t.........t..E.........E..t..X------------------------------------------
--------------------X..,..,............,X-----------XXXXX-----X....X--------X...X---X...t.E..E...t.........E.....t..X------------------------------------------
-------------------X..,..,:....B,,B....:X------XXXXXX,,,XXX----X..X---------X...X---X.E.t.........t....E..........t.X------------------------------------------
-------------------X..,..,.....,W.,.H...XXXXXXX,..........X----X..X---------X:..X---X....t..............ttttttttttt.X------------------------------------------
-------------------XE.,..,.E...K..E....E...E..,,E..AH.....X----X..X---------X...X---X....t....E.....E........E......X------------------------------------------
-------------------X..,..,.....,A.,...........,,.......E..X----X..X---------X,,,X---X.....E.......E.t...............X------------------------------------------
-------------------X.H,..,:....B,,B....:XXXXXXX,..........X----X,,X---------X.W.X---X.E...t.........t....E........E.X------------------------------------------
--------------------X..,..,............,X------XXXXXXX....X----X..X---------X...X---X......t....E...t...............X------------------------------------------
---------------------X..,..,........H..,X------------X....X----X,,X---------X...X---X...E..t........t.E......E......X------------------------------------------
----------------------XB.,..,.........,.X-----------XX....XX---X,,X---------X...X---X.E.....t.......t...........E...X------------------------------------------
-----------------------X..,.,........,..X--XXX------X,....,X---X..X---------X...X---X.....E.t...E...t........E......X------------------------------------------
------------------------XE,..,......,...X-X,,,XXXXXXX,....,X---X,,X---------X,,,X---X........t......t.....E.........X------------------------------------------
-------------------------XE,..,:..:.,..,TXX,A,,AA,H.+,..A.,X---X,,X---------X...X---X...E...........t...............X------------------------------------------
-------------------------X..,..,,,,,..,...X,,,XXXX..X,....,X---X..X---------X...X---X.......E...E..Etttttttttttt.E..X------------------------------------------
-----------------XX-------X.H,.......,H..XX...X--XXXX,....,X-X:X,,X:--------X...X---X.E.............................X------------------------------------------
---------------XX..XX------X..,.....,...X--XXX------X,....,X-X.ttt.X--------X...X---X...............................X------------------------------------------
-------------XX......XX-----X.B,,,,,E.XX---------XXXX,....,X-X.tTt.X--------X...X---XXXXXXXXXXXXXX..XXXXXXXXXXXXXXXXX-----XXX----------------------------------
-----------XX.H.....H..XXX---X...E...X-----------XHXXX....XX-X.ttt.X--------X...X----------------X..X-------------------XX...XX--------------------------------
---------XX......XX.......XX--X.....X------X:----X,X-X....X--X:XXXX:--------X...X----------------X,,X-----------------XX..,,,..XXX-----------------------------
-------XXtt....XX--XXX...H..XX-XXXXXXXXXXXXXXXXXXX,XXX....X-----------------X,,,X----------------X..X---------------XX.,,,...,,...XXX--------------------------
-----XX.tTt...X--XX---XXX.....XX----X.....,..,.E...:XX..H.X---------------XX.....X---------------X..X-------------XX.,,........,,....XX------------------------
------XXttt..X---XAXX----XX...H.XX--X.....,..E..EW..XX....X-------------XX........X--------------X..X-----------XX,,,............,,,...XXX---------------------
--------XX.XX----XE.X---XX....XX----X..XXXXXXXXXXX+XXX....X-------------X:..,,,,,.X--------------X..X---------XX,,.....B.....:......,,....XX-------------------
----------X------X..X-XXA...XX------X..X---X:----X.X-XXLLLX------------X....,...,..X-------------X..X-------XX,.......................,,....XX-----------------
---------------XXX..XX....XX--------X..X--XXXXXXXXEXXXXLLLXX-----------X....,...,...X------------X..X-----XX,.......W...A.A.......:.....,,...X-----------------
---------------X.X.B...XXX---XX---XXX,,XXXX....+,E..,+.....X---------XX..B..,.A.,.B.X------------X..X---XX................................,,.X-----------------
--------------X......XX----XX.X---X:....:XX..E.+,...,+..A..X-------XX.......,...,....X-----X-----X..X-XXX..................................,.X-----------------
--------------X....XX----XX..W+---X...E..XXH...+,...,+.....X-----XX..........,..,....X---XBX-----X..X---X.:.........B....A....A.......H..:..,.X----------------
------XXX----X.H.XX----XX..E...+--X......XX..E.+,...,+..E..X---XX....B.......,..,.....XXX..X-----X..X---X....A..E..........B................,.X----------------
------X..XXXXXX+.X---XX.......XX--X......XX....+,...,+.....X----XX.......E...,..,..:..X,.E.X-----X..X---X........................B..:....:...,X----------------
-----X.:..E..XX+X--XX......XXX----X......XX....+,...,+..B..X------X.........,...,.....,,...BX----X..X---X..................................XX,X----------------
-----XX..........XX.B....XX-------X......XX.E..+,...,+.E...X-------X...:....,..,......,.B..EX----X..X---X...........:..:.........B....E....:-XX----------------
-------XXXX...........XXX---------X......XX..A.+,...,+.....X------X+.......,.:.,...E...,,E.XX----X..X---X...H...E..........E...............X-------------------
-----------XXX......XX------------X..H...XX....+,...,+.....X-----X..XX.....,...,.....B.,XXX------X..X---X..........:..:...........B......,,XXXXXBXX------------
--------------XX.....XX-----------X......XX....+,.E.,+.....X----X-XX--XX...,...,.......X---------X..X---X...H............................,,.+,.E..X------------
-------------XX........XX---------X.....AXX...E+,...,+...E.X---X.X------X..,...,......X----------X..X---X........E...............W.......,,XXX,..,X------------
------------X.....X...E..XX-------XE.....XX....+,...,+.....X--X..X-----X..,....,..B...X----------X..X---X................................,:X-XXX,.X------------
-----------X..H..X-XX......XX-----XXX,,XXXXE...+,,,,,+.....X--X..X-----X..,....,.....X-----------X..X---X...H..............................XXXXX..X------------
---------XX.....X----XX.B..H.XX-----X..X--X....+,...,+.E...X--X..X----X...,....,....X------------X..X---XT........B...........................XXE.X------------
--------X..A..XX-------XX......X--XXX,,XXXX..H.+,...,+.....X--X..X---X...,....B,....X------------X,,X---X............A..XX...............E..B.XX..X------------
------XXX,...X-----------XX..:.X--X......XX....+,.A.,+.....X--X..X---X...,....,B....X------------X..X----X,,,,,,,,,,,XXX-X.:......:...........XX..X------------
---XXX...,,.XXXXXXXXX------XX..HX-X......XX....+,...,+..E..X--X..X--X...,,,,,,....E.X----XXXXXXXXX,,XXXXXX,,,,,,,,,,,XX--X...XXXX.....:......XXX..X------------
---X.E....XX.........XXXXXXXXXX.X-X......XX..E.+,...,+.....X--X..X---XX..............X---X:.........................,.X--XXXXXXX-XXX....B..XX--X..X------------
----X...B.........B....E.....X-XXXX.:....XX:...+,...,+.....X--X..X-----X.............X---X,.......B....E.........H..,.X--XXXX...XX--XXXXXXX--XXX..X------------
----X................E........X--XX......XX....+,...,+.....X--X..X------X,,XXXXXXXXXXXXXXX,....H.............E......,.X--X....E...XXXX-----XX.,...X------------
----X....E.....................X--X......XXE...+,...,+.....X--X,,X------X..XX.E..H.H..E.XX,........B................,.X-X.A,,,,,,,,..XXXXXX...XXXXX------------
----X........XXXX...XXXXXX....X---X......XX....+,.W.,+..E..X--X..X------X..XX...........XX,.........................,.XXX.,...AEHE.,.,.......X-----------------
-----X.B..XXX---X.E.X----X.E..X---X......XX...E+,...,+.....X-X....X-----XT.XX....E...E..,,,......B..E.B...A.......E.,.++,.,AAH.....,.,.....E.X-----------------
-----X....X-----X...X---X....X----X.H....XX....+,...,+.....X-X....X-----X..XX...A..W....,,,E........................,.XXX..,,,,,,,,..XXXXXX...XXXXX------------
-----X.....X----X...X---XE...X----XXX,,XXXXXXXXXX,,,XXXXXXXX:.ttt..:----X..XX.E.........,,,....:..............B.....,.X-X.....E..XXXXX-----XX.,...X------------
------X....X----X.H.X--X....X-------X..X--------X,,,X-------X.tTt..X----XW.XX....E...E..,,,...B.............E.......,.XXXXXXXXXXXX:XXXXXXXXX-XXX..X------------
----XXXE....X---XXXXX--X.....X----XXX,,XXX------X...X--------Xttt.X-----X..XX.E....E....,,,.B.........W...........:.,.X:...X--XXXX.....E.,.X---XE.X------------
-XXX......E.X-----------X..E.X----XE....EX------X.E.X--------X....X-----X..XX...E...H.E.XX,.....E...................,.,..X.X--XE.+.......,.X---X..X------------
-Xttt.E....X------------X....BX---X......X------X.E.X--------X.:..X-----X..XX...........XX,,B,,,,,,,,,,,,,,,,,,,,,,,,.,..X.X--X..+..B....,.XXXXX..X------------
-XtTt....XX--------------X.B...X--X......X------XXXXX---------XXXX------X..XXXXXXXXXXXXXXX,,,,,,,,,,,XXXX,XXXXXXX,,,,XX..X.X--XE.+:......,..E.....X------------
--Xtt.XXX----------------X...E.X--X......X-----XXXXXXXXXXXXXXXXXXXXXXXXX:,,:XXXXXXXXXXXXXX,,,,,,,,,,,XX-X.X-XXXXX,,,,XX..X.XXXX..+.....B.,.XXXXXXXX------------
--XXXX--------------------XX,,,XX-X......X-----X:.:.....,..............,,,,,,...............,.........:-X.X-X......H...E.X...++E.+.B.....,.X-------------------
----------------XXXXXXXXXXXX,,,XXXX......X-----X........,.......A......,,,,,,..A............,.........X-XHX-X.H.W........X:XXXXXXX.......,.X-------------------
----------------X................XX......X-----X........,..............:....:............E..,...E.....X-X.X-X..XXXXXXXXX:X-------X:XXXXXXXXX-------------------
----------------X....W...........,,......XXXXXXX........,.............:,,,,,,:,.............,.........X-X,X-X..X-----X:XXXXX---------XXXXX---------------------
----------XX----X................,,......X.EE.E,........,...........,,,,,,,,,,,,.....B......,.........X-XHX-X..XXXXXXX...H.XXXX:XXXXXX,,,XXXXXXXXX:------------
--------->..XXXXX..........A.....,,......X.EEHE,.....:..,..........,............,...........,.........X-X,X-X.E...,..,.....,,AXX.A..,....,........X------------
--------->E.,,,,,......E......T..,,......X.....,........,..........,:..........:,...........,.........X-XHX-X...E.,..,.:.E.,,.XX....,....,......E.X------------
---------X..XXXXX................,,......X.EE.E,........,.........,,,,,,,,,,,,,,,,..........,.........X-X,X-:.....,..,.....XX,XX...,....,...E.....X------------
----------XX----X................,,,,,,,,XAEE.E,........,........,XX...........XXX..........,.........X-X.X-XXXXXXXXXX.....,:....:.,....,.B.......X---XXX------
--------------XXX...H............,,......X..H..,........,.......,,XX,,,,,,,,,,,XXX,.........,.........X-X,.XXXXXXXX--X:.E..XX....:,.....,......B..XXXX..X------
--------------XE,.........B......,,......X.EE.E,........,...................................,.........X-XH.,,H,H.EX--XXXXX+XX..T...,....,.........,+:BW.X------
--------------X.,................,,..A...XXXXXXX........,...................................,.H.......X-XXXXXXXXX.X------X,XX......,..,..,..A.....,+B...X------
-----------XXXXXX................,,......X-----X........,...................................,.........X---------XHX------X,XX.......,,H,.+.....E..,+...HX------
-----------XH..++....,,,,,...E...XX......X-----X......:.,...................................,.........X---------X.X-----XX,XXH.......,,.W.+.......,+...BX------
-----------X.XXXX..+,,.,H,.......XXXX,,XXX-----X........,...................................,.........X---------XAX------X.XX........,.,..,+,.....,+.E..X-XXXX-
-----------X.X--X..,+H.,.,.......X--X..X-------X........,.....:........................B....,.........X---------X.X------X,X,,,,,,...,..,,..,.....,+B..HXX,,,X-
-----------X.X--X.,.+.,,.,.....H.XXXX,,XXX-----X........,...................................,.........X---------X.X------X+,.,,.,,...,.....,..B...,+....++,T,.:
-----------X.X--X.,H,+,,,,.......XX......XXXXXXX........,...................................,.........X---------X.X------X.,.,,.,,...,...:.,......,+..E.++,,,.X
-----------X+X--X.,..,.....B.....XX......,E...L,........,...........A......,,,,...A.........,.........XXXXXXX---X.X-----X.,,,,,,,,....,.....,...E.,+B...XXXXXX-
-----------XHX--X.,E,,..H........XX......,....L,........,........A.......,,.W..,............,...T.....,+,...XXXXX.X----X:.............B,....,.....,+:.BAX------
-----------X.X--X.,,,,........B..XX......,....L,........,................,.....,............,.........,++,W.,.....X----X...............,.....,....XXXX..X------
-----------XEX--X.,..,...........XX.:....XXXXXXX........,................,..K..,............,.........,++,.,XXXXXXX-XXXX..............,.....,...H.X---XXX------
-----------X+X--X.ttt,...........XX......X-----X........,.B..............,.....,............,.........XXXXXXX-------XH,,......A.......,....,......X------------
----------XX,XX-X.tTt,....XX,,XX.XX......X-----X........,.................,...,.............,.........X---X:--------XXXX...:.........,....,.B.E.:.XX-----------
----------XA.AX-XAttt,:...XXX+XX.XX......X-----X........,..................,,,..............,.........X----------------X.............,.....,......X+-----------
----------XA.AX-XXXXXXXXXXXXX+XXXXX......X-----X........B..B................................,.........X----------------:..............,....,......:------------
-XXXXXXXXXX.H.X------------X,,X---XE.....X-----X.....:..,...................................,......A..X----------------XXXXXXXXXXXXXXXX,,,XXXXXXXXX------------
-X.E.,.,,XX:XX:------------X..X---XXX,,XXX-----X........,,,,,,,,,,,,,,,,,,,,,,,,,,,,,,,,,,,,,.........X-------------------------------XXXXX--------------------
-X...,.,,,X-------XXXXXXXX-X..X-----X..X-------X..............................E.......................X--------------------------------------------------------
-X..XXXX,.X-------XE.E.E.X-X..X---XXX,,XXX-----X......................................................X--------------------------------------------------------
-X..X--X,,X-------X.H.E.EX-X..X---X......X-----X..............E........A..............................X--------------------------------------------------------
-X..X--X..X-------X......X-X..X---X......X-----X..................H...........................B.......X--------------------------------------------------------
-X..X--X,,XXXXXXXXXX,,,,XXXX..X---X......X-----X......................................................X--------------------------------------------------------
-X..X--X,,,,.E..,.............X---X..H...X-----X.W...............................................E....X--------------------------------------------------------
-X+X---XX,.,....,............:X---X......X-----X......................................................X--------------------------------------------------------
-X.X-----XXXXXXXXXXXXXXXXXXXXXX---X......X-----X:X,,,,,,XXXXXXXXX,,,,,,,XXXXXXXXXX,,,,,,,XXXXXXXXXXXXX:--------------------------------------------------------
:X,XXX:-X:XXXXXX:-----------------X...E..X-----X:X,A,,,,XXXXXXXXX,,,,,,,XXXXXXXXXX,,,,,,,XXXXXX----------------------------------------------------------------
X.E...X-X.E...A.X-----------------X......X-----X..H..A.H..XX......B..........E.E.....B....E...X----------------------------------------------------------------
X.....X-X.......XXXX--------------X,,,,,,XX----X...A.A.A.HXX.E.E.E..E.E.E..E....E.E.E.E.E.....X----------------------------------------------------------------
X...E.XXX,,.....,,EX-------------X.........XX--X.H.......:XX..........B.E.EE.B.E....E.B.....E.XXXXX------------------------------------------------------------
X.....,A.A,.E...XXXX-----------XX............XXX...XXXXXXXXX.E.EB.E.E....B.....E.BE.....E.E.E.+.:.X------------------------------------------------------------
X.....,...,....EX--------XXXXXX,,,,,,,,,,,,,,,,XX+XX-------X...............E........B.........XXXXX------------------------------------------------------------
X.....,...,.....X----:XXXX....,................E...X-------X.E....E...E......B.EE.B.E.E...E...X----------------------------------------------------------------
X...H.,.W.,.....XXXXXX..LL....,................,.:.X-------X............E..E...E........H.E...X----------------------------------------------------------------
X.....,...,.....,.E.,,..LL....,............:...,...X-------X.E...EE......W...E..E.E.E.E.E...E.X----------------------------------------------------------------
X:....,...,.....XXXXX:..LL....,................,...X-------XXXXXX.XXXXXXXXXXXXXXXXXXXXXXXXXXXXX----------------------------------------------------------------
X.....,A.A,.....X----XXXXX....,................,...X------------X+X--------------------------------------------------------------------------------------------
X....:XXX,,.E.:.XXXX-----X....,.........H......,...X------------X.X--------------------------------------------------------------------------------------------
X.....X-XE......,,EX-----X....,................,...X-----------X,,X--------------------------------------------------------------------------------------------
X.....X-X.......XXXX-----X....,................,...X-----------X,HX--------------------------------------------------------------------------------------------
XE...EX-X.......X-XXXXXXXX....,................,...X-----------X..X--------------------------------------------------------------------------------------------
:.....:-X:...A..:-XE.EE..+....,..............:.,...X-----------X,,X--------------------------------------------------------------------------------------------
XXXXXXX-XXXXXXXXX-X......+....,.E....E.........,...X-----------X,,X--------------------------------------------------------------------------------------------
------------------XE.EH..+....,................,...X-----------X..X--------------------------------------------------------------------------------------------
------------------X..WH..+....,..........E.....,...X-----------X,,X--------------------------------------------------------------------------------------------
------------------XH.....+....,.......H........,...X-----------X,.X--------------------------------------------------------------------------------------------
------------------XE.EH..+....,................,...XXXXXXXXXXXXX.,X--------------------------------------------------------------------------------------------
------------------X......+....,................,H..XX.+,E,,.,,.,:.X--------------------------------------------------------------------------------------------
------------------XE.EE..+....,................,....+.+,.,,W,,.,.X---------------------------------------------------------------------------------------------
------------------XXXXXXXX...H,................,...XXXXXXXXXXXXXX----------------------------------------------------------------------------------------------
-------------------------X....,............W...,...X-----------------------------------------------------------------------------------------------------------
-------------------------X:...,................,...:-----------------------------------------------------------------------------------------------------------
-------------------------X....,................,...X-----------------------------------------------------------------------------------------------------------
--------------XXXXXXXXXXXX,,,,,,,,,,,,,,,,,,,,,,,,,XXXXXXXXXX--------------------------------------------------------------------------------------------------
--------------X,,............,....E............,,.........,,X--------------------------------------------------------------------------------------------------
--------------X,,,,..........,.........T.......,,.......,,,,X--------------------------------------------------------------------------------------------------
---------------X.,,,,........,.............:...,,.....,,,,.X---------------------------------------------------------------------------------------------------
---------------X...,,,,......,,...............,,,....,,,...X---------------------------------------------------------------------------------------------------
---------------X.....,,,,....,,,,,.........,,,,,,..,,,....X----------------------------------------------------------------------------------------------------
----------------X......,,,,......,,,,,,,,,,,,....,,,,.....X----------------------------------------------------------------------------------------------------
----------------X........,,,,...................,,,......X-----------------------------------------------------------------------------------------------------
-----------------X.........,,,,...............,,,........X-----------------------------------------------------------------------------------------------------
-----------------X...........,,,,...........,,,,........X------------------------------------------------------------------------------------------------------
-----------------X.............,,,,.......,,,,..........X------------------------------------------------------------------------------------------------------
------------------X..............,,,,,,,,,,,...........X-------------------------------------------------------------------------------------------------------
------------------XXXXXXXXXXXXXXXXXXXXXXXXXXXXXXXXXXXXXX-------------------------------------------------------------------------------------------------------
