-------------------------------------------------------------------------------------X---------------------------------------------------------------------------------
------------------------------------------------------------------------------------XBX--------------------------------------------------------------------------------
-----------------------------------------------------------------------------------XE..X---XXXX------------------------------------------------------------------------
----------------------------------------------------------------------------------X...E.XXX....XX----------------------------------------------------------------------
---------------------------------------------------------------------------------X.E.B.,....E..A.X-----------------------------------------XXXXXXXXXXXXXXXXXXXXXXX-----
----------------------------------------------------------------------------------X.B.,...........X----------------------------------------X:..,...:.,,,.....,..:X-----
-----------------------------------------------------------------------------------X.,..E.:........X---------------------------------------X..,......,T,......,,.X-----
------------------------------------------------------------------------------------X.H..........H.X--------:XXXX:X------------------------X.,+++++..,,,..,,,,,.,X-----
------------------------------------------------------------------------------------X...............X-------X...<.X------------------------X,.+E..+.......,...,..X-----
-----------------------------------------------------------------------------------X................XXXXXXXXX...<.X------------------------X..+...+.......,.E.,..X-----
----------------------------------------------------------------------------XXXXXXXX.......,,,......,,......,.....XX-----------------------XH.+..A+.......,...,..X-----
---------------------------------------------------------------------------X,H...W,,.......,.,......,,TA..A.,..:.<,X-----------------------X..+++++...:...,,,,,..X-----
---------------------------------------------------------------------------X.XXXXXXX..E....,,,......,,......,.....XX-----------------------X.....................X-----
--------------------------------------------------------------------------X.X------X............H...XXXXXXXXX...<.X------------------------X...................H.X-----
-------------------------------------------------------------------------X..X------X..A.............X-------:....:X------------------------X....,,,,,,,,,,,,,....X-----
-------------------------------------------------------------------------X.X-------X....A.E.........X-------XXXXXXX------------------------X....,...........,....X-----
------------------------:XXXXWXX-----------------------------------------X.X--------X....B..H..E...X---------------------------------------X....,...........,....X-----
------------------------X.......XX---------------------------------------X.X-------X.,B............X---------------------------------------X....,...........,.W..X-----
------------------------X..E....E:X--------------------------------------XEX------X.E,........B...X----------------------------------------X.H..,:........:.,....X-----
------------------------X...+++...X--------------------------------------X.X-----X.E..E...........X----------------------------------------X....,...........,....X-----
------------------------X...+H+.E.XXXX-----------------------------------X.X------X....XXXX.....XX-----------------------------------------X....,.....H.....,....X-----
------------------------XE..W++.....,.X----------------------------------X.X-------XE.X----X,,XX-------------------------------------------X....,...........,..E.X-----
------------------------X...........,..X---------------------------------X,X--------X.X----X:.X--------------------------------------------X....,...........,....X-----
------------------------X....E....XXXX..X-------------------------------:..:X--------X-----XA.X--------------------------------------------X....,,,,,,,,,,,,,....X-----
------------------------:.......:.X---X..X------------------------------X...X--------------X..X--------------------------------------------X.....................X-----
------------------------XXX,,,XXXX-:X--X..X----------------------------X.....X-------------X.EX--------------------------------------------X.....................X-----
--------------------------X...X---X..X--X.X----------------------------X.....X-------------X..X--------------------------------------------X..,,,,,.......,,,,,..X-----
--------------------------XtttX--X....X-X.X---------------------------XE......X------------XH.X--------------------------------------------X..,...,.......,.H.,..X-----
--------------------------XtTtX-X...X..X..X---------XXXXXXX-----------X,,,,,,,X------------XE.X--------------------------------------------XE.,.HE,.......,.E.,..X-----
--------------------------XtttX-XH.X-X...X----------X....AX--------XXXX....E..XXXX---------X..X--------------------------------------------X..,...,.......,...,..X-----
--------------------------XXXXX-X..X--XXX----------X..A...X--------XE,,.......,,EX---------X.EX--------------------------------------------X..,,,,,.......,,,,,H.X-----
--------------------------------X...:XXXXAXXXXXX---X....E.X--------X.,,..,,,..,,.X---------XW.X--------------------------------------------X....E................X-----
---------------------------------X....,.......,.XXX.......X--------X.,,..,A,..,,EX---------XXXX--------------------------------------------X....,,,,,,,,,,,,,....X-----
----------------------------------X...,.......,..:X.......X--------XE,,E.,,,..,,BX---------------------------------------------------------X..W.,...........,....X-----
-----------------------------------XXXXXXXXXXX....,...E.E.X--------XXXX..,.,H.XXXX---------------------------------------------------------X....,...........,....X-----
----------------------------------------------X..,........X-----------XW.,.,..X------------------------------------------------------------X....,...........,....X-----
----------------------------------------------X..,........X-----------XXXXHXXXX------------------------------------------------------------X..E.,.:...E...:.,E...X-----
-----------------------------------------------X:.........X--------------X.X---------------------------------------------------------------X....,...........,....X-----
----------------------:XXXXXXXXXXXXXXXXXXXXXXXX:X.........X---:XX:-------X.X---------------------------------------------------------------XH...,...........,....X-----
-----:XXXHXX-:XX:X---X...............E..........,.....E..:X--X....X------XAX---------------------------------------------------------------X....,...........,..H.X-----
-----X.H...X-X...X---X......................E...,.........XXX.....:X-----X,X------------------------------------------------X--------------X....,,,,,,,,,,,,,....X-----
-----X.E..EXX..tttX-Xttt........................,.........+,,..ttt.X-----X.X----------------------------------------------XX.X-------------X.....................X-----
-----X.....,E..tTtX-XtTt.:..................A...,.H..E....+,,..tTt.X----X.:.X-------------------------------------------XX.H..XX-----------X.....................X-----
-----X.....XX..tttX-Xttt.................E......,.........+,,..ttt:X----X...X------------------------------------------X.H...H..X----------X..,,,,,.......,,,,,..X-----
-----XH....XX:..:.X--X.......W..................,........:XXX......X----X+++X----------------------------------------XX..........X---------X..,E..,...:...,E..,..X-----
-----X....HX-XXXXX---X:........................:,.........X--X:..:X-----X+++X-------------------------------X++----XX...E......E..XX-------X..,.A.,.......,.H.,.HX-----
-----XH....X----------XXXXXXXXXXXXXXXXXXXXXXXXXXX....E....X---XXXX------X...X-------------------------------X,XXXXX..B......E.......X------X..,...,.H...H.,...,.,X-----
-----XXX,XXXXXX---------------------------------X.........X---------XXX:X,,,X:EXX-------------------------XX,.,.E.,..............B...X-----X,,,,,,,.......,,,,,,.X-----
-------X.X--XAX----------------------------------X........X--------X.H.,.....,...X-------------XXXXXXXXXXX.,..B,..,...E........H....H.XX---X..,E..............,..X-----
-------X.X--X.X----------------------------------X......E.X-------X...,.......,...X-----------X.......H.,,.,E..,..,.H....H.ttt.....E....X--X:..,,............,..:X-----
-------XLX--X,X----------------------------------X........X-------X...,.......,..EX----------X..H..H....,,,.....E.,........tTt..E.....H..X-XXXXXXXXXXX,XXXXXXXXXXX-----
-------XLX--X:X----------------------------------X..:..E..X------X...,..:......,...X--------X...........,,,E....,.,........ttt..........X------------X+X---------------
--XXXXXX,XXXX,XXXX--------------------------------X.......X-----X.E.,...........,...X------X.H.XXXXXXXXXXX.....E.,,.A...E..B...E.E.H..XX-------------X,X---------------
--X:......E.....:X--------------------------------X..E....X----X...,.............E...X----X...X-----------XX.W..H,,..................X---------------XtX---------------
--X.............EX--------------------------------X.....A.X----X...,.E...,,,..B..,...XXXXX.H.X--------------XXXXXXX....A...EE...E...X----------------XTX---------------
XXX..E...........X---------------------------------X......X----X...,.....,W,.....,...,,.H...X----------------------XX.............XX-----------------XXX---------------
X:,..............XXXXXXXXXXXXXX-----------XXXXXXXXXXXXXXXXX----X...,.....,,,..A..,...,,....X-------------------------XX.E..B.....X-------------------------------------
XXX..............XX.E,,,,.E..,:XX---------XE..,...X------------X...,.............,.E.XXXXXX----------------------------X.....E..X--------------------------------------
--X.A......E....,,,.,.B.H....,.,.XX-------X,...E..X------------X..:,...B....E....:...X----------------------------------XX.....,X--------------------------------------
--X............E,,,.,.,,,....,.,.,:XX-----X,...,..X-------------X..E,...........,...X-------------------------------------XX.,,X---------------------------------------
--X..E.........,.,,.,.,......,.E.,.,.XX--X.A,..,..X--------------X...,E...E...,,H..X----------------------------------------XA.X---------------------------------------
--X............,AXX.,:,.B,,B,,.,.,.,.,:XX:..,..,..X---------------X....,.....,....X-----------------------------------------XEX-XXXXXXXXXX-----------------------------
--X...........XXXXX.,,,.,E..,,.,.,.,.,.,.X.,...,..X----------------XX...:,,,:.A.XX------------------------------------------X.XX,...,..,..XXX--------------------------
--X.H.........XXXXX.....,...,,.H.,.,.,E,.,.,...,..X---XXXXX----------X.........X--------------------------------------------X,..,...,H.,...,X------XXXXX---------------
--X........E....++,..H..,.E.,,.,.,.,E,.,.,,..E..,,XXXX,...X-----------X..H.E..X---------------------------------------------X,,..,..,..,.,,.X------X...X---------------
--X.............++,.....,...,,.,.,.,.,.H.,,....W,.,.,.,tttX------------X.....X----------------------------------------------X..,.XXXXXXXX.H.X------X.E.X---------------
--X.....E.......++,.....,...,,.,.,E,.,.,.,.,:...,.,.,.,tTtX-------------XXXXX-----------------------------------------------X.E.X-------X...X------X...X---------------
--X...........XXXXX.....,.A.,,.,.,.,B,.,.,.,....,.,.,.,tttX-------------:XXXXXXXXXXXXXXXXXXXXXXXXXXXXXXXXXXXXXXXXXXXXXXXX:X-XE..X-------X.E.X------X.H.X---------------
--X........H..XXXXX.,,,.B..B,,.E.,.,.,:,.:.,...,,,XXXX,...X-------------X...W.............................................X-X,,,X-------X...X------X...X---------------
--XE...........W.XX.,:,.,,,,,,.,.,.,.,.XXX.A..,A..X---XXXXX-------------X...............................................:.X-X...XXXXXXXXX,,,XXXXXXXX,,,X---------------
--X....E.......,.,,.,.,......,.,H,:,.XX--X.,.,,...X---------------------X..............E...........A...........E..........X-X..,.,..+.,.,...,......,...X---------------
XXX.........E...,,,.,.,,,....,.,.,.XX----X.,...,..X---------------------X..A..............................................X-X,,..,H.+.,.,.H.,....T.,...X---------------
:.,..:.........:,,,E,E..,.B.E,:,.XX-------X.,H.,E.X---------------XXXXXXX....,,,,,,,,,,,,,,,,,,,,,,,,,,,,,,,,,,,,,,,,,....X-XXX..,..+.,.,...,......,...X---------------
XXX..............XX.,,,,,....,.XX---------XE,..,..X--------------X:..EEXX....,.......................................,....X----XXXXXXXXXX,,,XXXXXXXX,,,X-------XXXWXXXX
--X....E....B....XXXXXXXXXXXXXX-----------XXXXXXXXX--------------X.E...,,....,...............B...................:...,....X-------------X...X------X...X-------XE...E.X
--X..............X-----------------------------------------------X.H.EE,,....,.......................................,....X-------------X...X------X...X-------XEHE...X
--X..E......E.A..X-----------------------------------------------X..HEE,,....:....E...................H..............,....X-------------X...X------XE.HX-------X..H..EX
--X:............:X-----------------------------------------------X.E...,,....,.......................................,....X-------------X.H.X------X...X-------XE.....X
--XXXXXX,,XXXXXXXX-----------------------------------------------X.H.EE,,....,...............A..............E........,....X-------------X...X------X...X-------X++++++X
-------XE.X----------------X:------------------------------------X.E.EE,,....,.......................................,.,,,XXXXXXXXXX----X,,,X------X...XXXXXXXXX,,,,,,X
-------X.,XX-------------XXXXXXXXXXXXEXX-------------------------X:....XX....,.............H............E............,.,..,.E,H.E.+X----X...X------X...,.......,.H..,,X
-------X..:X-------------X,..,.:..A...,X--------------------------XXXXXXX....,.......................................,.,..,E.,..++.XX---XEE.X------X.E.,...:...,..,,..X
-------X,,X--------------X.,.,.......,.X--------------------------------X....,.......................................,.,,,XXXXXX...,X---X...X------X...,.......,,,....X
-------X..X--------------X.,XXXXXXXXXA.X--------------------------------X....,...B...................................,....X----X...HX---X...X------XXXXXXXXXXXXXX...,,X
-------XE,X--------------XE.X-------X,,X----------XX--------------------X....,...............XXX,,,,,XXX.............,....X----X.E.,X---X...XXXXXXXXX------------X,,..X
-------X..X--------------X..X-------X..:X-------XXA.X-------------------X....,...............XXE,E,,,XXX.E...........,...X-----XE..,X---XE..,..E.HH.X------------X....X
-------X..X--------------XE.X-------X.,XX--------X.E.X------------------X....,...............XX....E.:XX.............,....X----X...HX---X...,...EAE.X------------XH...X
-------X..X--------------X..X-------X,.X----------X.A.X-----------------X....,...............,,.E.....,,...E....E....,....X----X...AX---XE..,.......X------------X....X
--XXXXXXH.X--------------XE.X-------X..X-----------X.E.X----------------X....,..H............,,E.+E+E.,,.............,....X----X.E.XX---X...XXH,H,XXX------------X++++X
--XE,EXX..X--------------X..X-------XE.X------------X...X---------------X....,...............,,..+.+..,,.............,....X----X...X----X.E.XXXXXXX--------------X....X
--X,.,XX..XXXXXXXXXXXXXXXX..X-------X..X-------------X.E.X--------------X..H.,...............,,E.+T+E.,,.............,....X----X...XXXXXX...H.X------------------X....X
--XE.E,,.,...H..,.,.E.,E,...X-------X,,X--------------X.H,X-------------X....,...............,,..+.+..,,.............,....X----X......E.....,EX------------------X....X
--XE.E,,,....,..,.,.,.,.,...X-------X..X---------------X,.,XXXXXXXX:X---X....,...............,,.W++EE.,,.......E.....,....X----XE.E.......E.,.X------------------X.E..X
--XXXXXXXXXXXXX:XXXXXXXXXXXXX-------X..X----------------X,..E...H...X---:....,...............,,..E....,,.............,....X----X............H.X------------------X....X
--------------XX--------------------X..X----------------X.A.......E.:XXXX....,.......A.......XXE.....EXX.............,....X----XXXXXXXXXXXXXXXX------------------X....X
------------------------------------X..XXXXXXXXXXXXBXXXXXB...B.:....,,..,....,...............XXX,,E,,XXX.............,....X--------------------------------------X....X
------------------------------------X..,..........,.................,,..,....,...............XXX,,,,,XXXE............,....X--------XX>>>XX-----------------------X....X
------------------------------------X..,A...E..H..,H..A...H.....E...,,E.,....,............B..........................,....X--------X:.E.:X-----------------------X..E.X
------------------------------------X..,..........,...............:.,,..,....,...............:.......................,....X--------X.....X-----------------------X....X
------------------------------------X..XXXXXXXXXXXXXXXXXX:..........,,..,....,.....................B..........H......,....X--------X.....X-----------------------X....X
------------------------------------XE.X----------------X...E..H..E.:XXX:....,.......................................,....X--------X..E..X-----------------------X....X
------------------------------------X..X----------------X,....:.....,X--X....,...........A...........................,....X--------X.....X-----------------------X.E..X
------------------------------------X..X---------------X,.,XXXXXXXXXX---X....,...A......................E............,...X---XXXXXXX...E.XXXXXXX-----------------X....X
------------------------------------X..X--------------X..,X-------------X....,.....................B...........ttt...,....X--X....E,.,,..,H...EX-----------------X....X
------------------------------------X..X-------------XKE.X--------------X....,.................................tTt...,....X--X.....,E,,E.,.....X-----------------X....X
------------------------------------X,,X------------X...X---------------X....,........................H........ttt...,....X--X.....,.....,.....X-----------------X.E..X
-----------------------------------:XA.X-----------X.E.X----------------X...:,.....................E........E........,....X--X.....,,,,,,,.....X-----------------X....X
-----------------------------------XX,.X----------X.H.X-----------------X....,........A..............................,....X--X.................X-----------------X,,,,X
------------------------------------XE,X---------X.E.X------------------X....,.............E........................E,....X--X.................X-----------------X....X
------------------------------------X..X--------XX..X-------------------X....,,,,,,,,,,,,,,,,,,,,,,,,,,,,,,,,,,,,,,,,,....X--X.......,B,.......X-----------------X....X
------------------------------------X..X----------XX--------------------X.................................................X--X.......,.,.......XX----------------X....X
------------------------------------X+XX--------------------------------X..E............................E.......A.........X--X.......,E,.......,:XX--------------X,,,,X
------------------------------------X..X--------------------------------X..............................................A..X--X.......,,,.......,,.EXX------------X....X
--------------------------XXXXX-----X..X----XXXXX-----------------------X..........E......................................X--X.E...............,,....XXXXXXXXXXXXX....X
-----------------------XXXX,,,XXXXXXX,,XXXXXX,,,XXXX--------------------:.........XX........................X............:X--X.................,,....,.......E........X
-----------------------X.,,,,,,,...,,..,,..,,,,,,,.X--------------------XXXXXXXXXXXXXXXXXXXXXXXXXXXXXXXXXXXX-XXXXXXXXXXXXXX--X.................,K.E.H,.E...........A..X
-----------------------XE,,,,,,,...,,..,,..,,,,,,,.X-------------------------------------------------------------------------X.................,,....,.....A..........X
----------------------X............,,..,,..A.E...H..X------------------------------------------------------------------------X.....:,,,,:,.....,,.E..,E..............X-
----------------------X....W...B...,,,,,,..,,,,,,,..X------------------------------------------------------------------------X.....,.....,.....,,...XXXXXXXXXXXXXXXXX--
----------------------X..,,,,:,,...,,..,,..,.....,..X------------------------------------------------------------------------X.....,..E..,.....,:.XX-------------------
----------------------XE.,.....,...,,H.,,..,..E..,..X------------------------------XXXXXXXXXXXXXXXXXXXXXXXXXXXXXXXXXXXXXXX---X.....,.....,.....XXX---------------------
----------------------X..,.....,...,,..,,..,.....E..X------------------------------X...................................:.X---XE.....,.E.,....E.X-----------------------
---------------------X...,..E..,H..,,,,,,.H,.....,...X-----------------------------X........................E............X---X......,...,......X-----------------------
---------------------X..H,.....,...,,..,,..,..H..,.A.X-----------------------------X.....................................X---XXXXXXXX,,,XXXXXXXX-----------------------
---------------------X...,..W.B,:..,,H.,,..,.....,...X-----------------------------X....:,,,,,XXX,,,,,,,,,,,XX,,E,,:,....X----------X...X------------------------------
---------------------X...,.....,...,,..,,A.,..E..,...X-----------------------------X....,.....XXX...........XX......,....X----------X...X------------------------------
---------------------X..A,...E.,...,++++,..,.....B...X-----------------------------X.B..,.....,.,..........,.,......,....X----------X,,,X------------------------------
---------------------XH..,.....,.E.,,..,,..,.....,...X----------------EXXXXX-------X....,..,,,.,.,.........,,.......,....X----------XE..X------------------------------
--------------------X....,.....,...,,..,,A.,..B..,..E.X---------------X..E.X-------X....,..,T,.,.,...H....,.,.......,....X----------X...X------------------------------
--------------------X....,E....,...,,H.,,..,.....,....X--------------X......X------X....,..,,,.:,,........,,......B.,.E..X----------X,E,X------------------------------
--------------------X.:..,.....,...,,..,,..H.....,....X--------------X..E.E.X------X....,.......,.,......,.,........,....XXXXXXXXXX:X...X------------------------------
--------------------X....,,,,,,,...,,,,,,A.,E,,,,,E.E.X-------------X.......X------X....,......B.,,......,,.........,....,L..,H.,..,.,..X------------------------------
--------------------X..........H...,,..,,.............X-------------X.:.....X------X....,........,.,....,.,.........,....,L..,..,E.,..,X-------------------------------
-------------------X...,,,,,,,.....,,..,,.....,,,,,,...X-----------XE.....E..X-----X....,.........,,....,,..B.......,....,L..,..,..,..XX-------------------------------
-------------------X.,,:,..,:.,,,,.,,H.,,.,,,,:,..,:,,.X-----------X.........XXXXXXX....,.........,,...,.,.......B..,....XXXXXXXXXXXXX---------------------------------
-------------------X,,,,,,,,,,,,,,,,,..,,,,,,,,,,,,,,,,X-----------X.,,,.....,.,.++,..E.,.H.......E,,..,,...........,....X---------------------------------------------
-------------------X:,,,,..,,,,,,,,,,,,,,,,,,,,,..,,,,,X-----------X.,W,.H.H.H.H.++,....,..........,,,,.,.....E.....,....X---------------------------------------------
-------------------X,................E................,X-----------X.,.,E....,.,.++,....,..........,,.,.,B..........,....X---------------------------------------------
-------------------X.,.....:.....E........E...E...E..,.X-----------X.,,,.....XXXXXXX....,..........,,,,.,...........,....X---------------------------------------------
-------------------X:.,.............................,.:X-----------X......E..X-----X....,..........A,.,.,.....:.....,....X---------------------------------------------
-------------------XXXXXXXXXXXXXXXXXXXXXXXXXXXXXXXXXXXXX-----------X.:..E...X------X....,.........,,...,.,.........E,....X---------------------------------------------
--------------------------------------------------------------------X.....E.X------X....,.........,,...,.,..........,....X---------------------------------------------
--------------------------------------------------------------------X.E.E...X------X..E.,........,,.....,.,.........,....X---------------------------------------------
---------------------------------------------------------------------X......X------X....,........B,.....,.,.....B...,....X---------------------------------------------
---------------------------------------------------------------------X..E..X-------X....,.......,.,......,,E........,....X-------XX:X----------------------------------
----------------------------------------------------------------------XXXXXX-------X....,.......,,.......,.,...ttt..,....X------X...X----------------------------------
-----------------------------------------------------------------------------------X....,......,.,........,,...tTt..,....XXXXXXX....HX---------------------------------
-----------------------------------------------------------------------------------X...H,......,,.........,.,..ttt..,....,+..E.,.ttt.X---------------------------------
-----------------------------------------------------------------------------------X....,....E,.,..B.......,,.......,....,+....,.tTt.X---------------------------------
-----------------------------------------------------------------------------------X....,.....,,...........,.,......,....,+....,.tttBX---------------------------------
-----------------------------------------------------------------------------------X....:....XXX.......B..:.XX......,....XXXXXXXXB...X---------------------------------
-----------------------------------------------------------------------------------X....,,,,,XXX,,,,,,,,,,,,XX,,,,,:,....X------X..:X----------------------------------
-----------------------------------------------------------------------------------X.W...................................X-------XXXX----------------------------------
-----------------------------------------------------------------------------------X.................................E...X---------------------------------------------
-----------------------------------------------------------------------------------X.....................................X---------------------------------------------
-----------------------------------------------------------------------------------XXXXXXXXXXXX,,,,,,,,,,,XXXXXXXXXXXXXXXX---------------------------------------------
----------------------------------------------------------------------------------------------X...........X------------------------------------------------------------
----------------------------------------------------------------------------------------------XE......E.H.X------------------------------------------------------------
----------------------------------------------------------------------------------------------XEH.EAE.....XXXXXX-------------------------------------------------------
----------------------------------------------------------------------------------------------X.....H.....+..,:X-------------------------------------------------------
----------------------------------------------------------------------------------------------XH....E.E.E.XXX..X-------------------------------------------------------
----------------------------------------------------------------------------------------------X...E.......X-X..X-------------------------------------------------------
----------------------------------------------------------------------------------------------XA....E.A.H.X-X,,X-------------------------------------------------------
----------------------------------------------------------------------------------------------H.EAA.E..E..X-X..X-------------------------------------------------------
----------------------------------------------------------------------------------------------X...........X-X,,X-------------------------------------------------------
----------------------------------------------------------------------------------------------XXXXXXXXXXXXX-X..X-------------------------------------------------------
------------------------------------------------------------------------------------------------XXXXXXXXXXXXX,:X-------------------------------------------------------
------------------------------------------------------------------------------------------------X.A....H.A.XX..X-------------------------------------------------------
------------------------------------------------------------------------------------------------X..........XX,,X-------------------------------------------------------
------------------------------------------------------------------------------------------------X..H.:.A.:.XX..X-------------------------------------------------------
------------------------------------------------------------------------------------------------XA.........XX,,X-------------------------------------------------------
------------------------------------------------------------------------------------------------X.......XXXXX..X-------------------------------------------------------
------------------------------------------------------------------------------------------------XXXXXX,,XXX:X,,X-------------------------------------------------------
-----------------------------------------------------------------------------------------------------X....,.,..X-------------------------------------------------------
-----------------------------------------------------------------------------------------------------X....,.,..X-------------------------------------------------------
-----------------------------------------------------------------------------------------------------XXXXXXXXXXX-------------------------------------------------------
