------------------------------------------------------------XXX-------------------------------
-----------------------------------------------------------XX<XX------------------------------
-----------------------------------------------------------X<.<X------------------------------
-----------------------------------------------------------X.,.X------------------------------
-----------------------------------------------------------X,:,<X-----------------------------
----------------------------------------------------------XX....XX----------------------------
--------------------------------------------------------XX...,....XX--------------------------
------------------------------------------------------XX...,,.,,....X-------------------------
----------------------------------------------------XX...,,.....,,...X------------------------
--------------------------------------------------XX...,,:........,,..XX----------------------
------------------------------------------------XX...,,.............,,..X---------------------
------------------------------------------------X..,,........W........,.X---------------------
------------------------------------------------X..,...............:..,.X---------------------
------------------------------------------------X..,.......:..........,.X---------------------
-------------------------------------------------X.,...........B......,.X---------------------
-------------------------------------------------X.,..................,.X---------------------
-------------------------------------------------X.,............,,,,..,X----------------------
-------------------------------------------------X.,............,.W,..,X----------------------
-------------------------------------------------X.,..:.:.......,..,..,X----------------------
-------------------------------------------------X.,............,,,,..,X----------------------
-------------------------------------------------X.,...:...B..........,X----------------------
--------------------------------------------------X,..................,X----------------------
--------------------------------------------------X,............:..:..,X----------------------
--------------------------------------------------X,......B...........,X----------------------
--------------------------------------------------X,.............A....,X----------------------
--------------------------------------------------X,.........B.:......,X----------------------
--------------------------------------------------X,.:......,.......A.X-----------------------
---------------------------------------------------X.....B,,E,,..B....X-----------------------
---------------------------------------------------X.....,.E..E,,.....X-----------------------
---------------------------------------------------X...,,E..EE.E.,,..:X-----------------------
---------------------------------------------------XXXX..EE....EE.:XXXX-----------------------
-------------------------------------------------------:...B.E....X---------------------------
-------------------------------------------------------X.EE.E.EE.EX---------------------------
--------------------------------------------------------X:.......X----------------------------
--------------------------------------------------------X.EB.EB.EX----------------------------
---------------------------------------------------------X.,,,,.X-----------------------------
---------------------------------------------------------X,....,X-----------------------------
--------------------------------------------------------X:.,,,..:X----------------------------
--------------------------------------------------------X,,.H.,,,X----------------------------
-------------------------------------------------------:,:....W..,:---------------------------
-------------------------------------------------------X...ttt....X---------------------------
-------------------------------------------------------X..:t.t....X---------------------------
-------------------------------------------------------X...ttt...X----------------------------
-------------------------------------------------------X:.......:X----------------------------
-------------------------------------------------------XXX....XX------------------------------
----------------------------------------------------------XX:X--------------------------------
----------------------------------------------------------------------------------------------
----------------------------------------------------------------------------------------------
----------------------------------------------------------------------------------------------
----------------------------------------------------------------------------------------------
----------------------------------------------------------------------------------------------
--------------------------------------------X:XXX---------------------------------------------
-------------------------------------------X.....XEXXXXXXX-------------------------X----------
-----------------------------------------XX..:..B.......,,XXXXXXXX----------------XXX---------
----------------------------------------X............A.E,T,.......BXX:X---------XXH..X--------
---------------------------------------X...E...,,,,,,...,,,.B.A.E......X-------X.E.H.X--------
--------------------------------------X.......,......,,,,,,,,,,.....:..X-----XX.EK.XX---------
------------------------------------XX...A..,,.................,,,,,....X--XXB,,.XX-----------
-----------------------------------X..H....,........................,.H.XXX...A,X-------------
----------------------------------X.......,.........................,....X,E...X--------------
------------XXXXXXXXXXXXXXXX----XX...W..,,...........................,.W..,.B...X-------------
------------X,.H,.,H.,H..H..X--X.......,.........................E....,...,,..E:X-------------
------------X.XXXXXXXXXXXXXX.XX...E...,...............................,B.A.,....AX------------
------------X,X------------X,,.,,...,,.......,,,,,,....................,...,,B....X-----------
------------X.X-------------X....,.,.........,,,.,,.....................,...,,AE.AX-----------
------------X,X-----------XX.,,T..,..........,.TE.B.....................,E..,,.....X----------
------------XLX----------X.....,.,...H.H.....,....,......................,...,,B..X-----------
------------XLX---------X...A.E.,.H..........,B,,,,......................,.A.,,.XX------------
-------:XXXXX,X:X-----XX..H...,,...............,,,.............,,.........,...XX--------------
-------X.HA..:..X----X.......,...H..H...................:.....B,,,.........,...X--------------
-------X........X----X:....,,.........H.......................,.,,.........,.E.X--------------
------+XE......EXXXXXX..A.,.......H..........................,.TE,,.........,...X-------------
------+,W..E....,.E..,....,............H.....................,,B,.,..........,...X------------
------+,........,,,,.,.B..,.E.................................,,,,.......E...,.E.X------------
------XXA.....W.,,H,.,....,..............H....................................,,,,X-----------
-------X...E....,,,,.,....,.................................................,,....:X----------
-------XA.......,...E,....,...............H................................,:...:.:X----------
-------X.:.E....XXXXXX..E.,................................................,....,,,X----------
-------:XXXXAXA:X----X....,..........................,.....................,.AB,,:X-----------
---------------------X....,.........,,.............XX,XXX.................,....,,.X-----------
---:X---X:----X:-----X....,.......,,B,,......,,,,XXX.A.XX.................,....,,.XXXXXXXX:XX-
XXXXXXXXXXXXXXXXXXX--X..B.,.......,,..,......,H.H,,A...WXX................,....,,+,........XXX
XH.A...E....:....,.XXX....,.......,.ET,,.....,.,XX,,,,.:,,................,W.T.,K+,.E..E..WH.>
X................,..L,.,,,,.......,,..,,.....,H,XX,T.,..H,,...............,....,B+,.......:XX>
X.W:....E.H....E.,..L,.,T,,.......,,B,,...,,,,.,XX,.,,...,,...............,....,,.XXXXXXXXXX--
X.....:..........,..L,.,,,,...............,H.HH,.,,,...AX,................,..B.,,:X-----------
XH.H...E.........,.XXX.H..,...............,.,,,,.XXA.:A.XX.................,...,.,X-----------
XXX:XX,XX:XXXXX:XXX--X....,...............,H,.....XXX,,XX........,,,,,.....,:...,,.X----------
---XXX.XXX----XX-----X.E..,...............,H,.......X,,..........,,.,,......,...E.:X----------
----X,AX-------------X....,...............,.,........H..........,,.T.,.......,....:X----------
----X,,X-------------X....,...............,H,...................,,...,........,,,,X-----------
----X,HX-------------X...B,...............,H,....................,,,,,........,E..X-----------
----X,,X-------------X....,...............,.,,,,...................,,........,...XXXXXX-------
---X:,AX:------------X.A..,...............,H..H,.............................,...XX,:.+-------
---X.:.:X------------X....,...............,,,,A,............................,B..X-X..X+-------
---X..HAX------------X..:.,..................,.,............................,...X-X.,X--------
--XX,,,,XX-----------X....,.................H,H,............:...............,..X--X,.X--------
XXX.H.H.:XXX---------X....,H.........,,,,,,,,,H,...........................,.A.,X-X..X--------
X.,A.:,,.,.X---------X.B..,..........,H.HH.WH..,...........................,..B.,XX,,X--------
X:,..,H,H,:X---------X:.W..,,........,H,,,,,,,,,.....,,....................E..,,H.X,,X--------
X.,A.,,,.,.X---------X.......,.......,.,...........,,.,,..................,...,,...BX---------
XXX:.HH.:XXX----------X....E..,......,H,...........,..,,..................,.B,,B.E..X---------
--XXXXXXXX-------------XX......,,....,H,..........,,.T.,............E....,...,,..B.X----------
-------------------------X....H..,...,.,..........,,,.E,.................,..,.,....X----------
--------------------------X.......,.,H,............,,,.,.................,..,,.E..X-----------
---------------------------XX...,,,,,.,..............,,.................,..B,B....X-----------
-----------------------------X..,T,..,..................................,..,,...B.X-----------
------------------------------X.,,,...,................................,.H.XX.E..X------------
-------------------------------X.B.W..B,,............................,,,...X-XXH.X------------
--------------------------------XX.......,....E.................,,,,,.....X----XX-------------
----------------------------------X.......,................,,,,,..........X-----X-------------
-----------------------------------X...A...,,.........,,,,,.........E...:.X-------------------
------------------------------------X........,...,,,,,....E..............:--------------------
-------------------------------------XX...E...,,,...E..........A.......XXX--------------------
---------------------------------------XB.............A..........XXXXXX-----------------------
----------------------------------------X..................XXXXXX-----------------------------
-----------------------------------------XX.:........XXXXXX-----------------------------------
-------------------------------------------X......XXX-----------------------------------------
--------------------------------------------X:XXX,.X------------------------------------------
-------------------------------------------------X,X------------------------------------------
-------------------------------------------------X.X------------------------------------------
-------------------------------------------------X.X------------------------------------------
---------------------------------XXXXXXXXXXXXXXXXX,XXXXXXXXXXXXXXXXX--------------------------
---------------------------------XEE.EE.EE.E,tttttttttt,,.....E.EE.X--------------------------
---------------------------------X..........,tE.E.E...t,,.E.E......X--------------------------
---------------------------------XEE.EE.EE.E,t......E.t,,.....E.EE.X--------------------------
---------------------------------XEE.EE.EE.E,tE.E.E.E.t,,.E.E.E.EE.X--------------------------
---------------------------------X..........,tE.E.E...t,,..........X--------------------------
---------------------------------XEE.EE.EE.E,t......E.t,,.....E.EE.X--------------------------
---------------------------------XEE.:E.EE.E,tE.E.E.E.t,,.E.E.E.EE.X--------------------------
---------------------------------XXXXXXXXXXXXttttttttttXXXXXXXXXXXXX--------------------------
--------------------------------------------Xttt,,tt,ttX--------------------------------------
--------------------------------------------X...,,..,..X--------------------------------------
--------------------------------------------X.E.,,E.,E.X--------------------------------------
--------------------------------------------X...,,..,..X--------------------------------------
--------------------------------------------XttttttttttX--------------------------------------
--------------------------------------------X.E.,,E.,.EX--------------------------------------
--------------------------------------------X...,,..,..X--------------------------------------
--------------------------------------------XtttXXttXttX--------------------------------------
--------------------------------------------X.E.XXE.X.EX--------------------------------------
--------------------------------------------XXXXXXXXXXXX--------------------------------------
