----------XXXXX---------------------------------------------------------------------------------
----------X...XXXXXXXXXXXXXXXXXXXXXXXXXXXXXXHXXXXXXXXXXX----------------------------------------
----------X...X...,............................+.......XXXXXXXX---------------------------------
----------E.A.,E..,...........................+........,E.E..EX---------------------------------
----------X...X..,............................+........,....A.X---------------------------------
----------X.A.X,,............................+.........,E.E.HEX---------------------------------
----------X...X..............................+.........,......X---------------------------------
----------W..AX.............................+..........,E.E..EX---------------------------------
----------XXXXX.............................+..........XXXXXXXX---------------------------------
--------------X.......,,,,,,,,,,,,,,,,,,,,,+,,,,,,,XXXXX----------------------------------------
--------------X.......,A.........................E.X------------------XXXXX---------------------
--------------X.......,,...........................X------------------X.E.X---------------------
--------------X.......,,...........................X------------------X...X---------------------
--------------X.......,,.....................W..:..X------------------X,,,X---------------------
--------------X.......,,.......E...........E.......X----------XXXXXXXXX,,,XXXXXXXXXXXXXXXXX-----
--------------X.......,,.....XXX,XXXXX,,,XXXXXXXXXXX----------X...H...................A...X-----
--------------X.......,,.....XXXEXAX-X,,,X----------XXXXXAX---X........................A..X-----
--------------X.......,,.....X.,.,.X-X,,,X---XXXXXXXX.....X---X...........................X-----
--------------X.......,,.....X,.,..X-X,,,X--X.,,.,.XX.....XXXXX...........................X-----
--------------X.......,,.....X,.,..XXX,,,XX-X,,,.,.,,..H..X...,............,,,,,..........X-----
--------------X.......,,.....X..,..XX.E..AXX,,,,,,.XX....HX.E.,..........,,.....,.........X-----
--------------X.......,,.....X.,...XXX,,,XXXE.,XXXXXX.....X...,.........,........,........X-----
--------------X.......,,....AX.,...X-X+++X-X,,,X---XX.....XXXXX........,........,...,.....X-----
--------------X.......,,.....X,....XXE,,EXXX,,,XXX-X,.....X---X....W..,.........,.,,,.....X-----
--------------X.......,,.....X,..................X-XXE...EX---X......,.........,.,..,.....X-----
--------------X.......,,.....X,.................HX--XXXXXXXXXXX......,.........,,...,.....X-----
--------------X.......,,.....X...................X----XXXXXXEXX.....,..........,,...,.....X-----
--------------X.......,,.....XE......,,,,,.......X----X.,.,,.+,....A,..........,.,..,.....X-----
--------------X.......,,.....X.......,,,,,.......X---X.,,.,,.+,....,...........,.,..,.....X-----
--------------X.......,,....EX,,,,,,,,,,,,,,,,,,AX--X,,,.,,,E+,....,...........,.,..,.....X-----
--------------X.......,,.....X...................X--X..,XXXX.XX....,..........+.,....,....X-----
--------------X.......,,.....X.E.................X--X,,,X--XXXX....,........,,.+.....,....X-----
--------------X.......,,.....X.................E.X--X...X-----X....,........,.,.....,.....X-----
--------------X.......,,.....X.......E...........X--X...X-----X....,.......,,.,,....,.....X-----
--------------X.......,,.....XA..................X--X...X-XXXXX....,.......,K.E,...,H.....X-----
--------------X.......,,.....X,,,,,,,,,,,,,,,,,,,X--X,,,X-X...,....,.......,...,.tt.......X-----
--------------X.......,,.....X.......,,,,,.......X-X,,,X--X.E.,....,.......,,,,tt.,H.H...TX-----
--------------X.......,,A....X.......,,,,,.......XXX,.,X--X...,....H,.............,..H....X-----
--------------X.......,,.....X...................,.,.,.X--XXXXX...H.,..............,H.....X-----
--------------X.......,,.....X.E..............E..,.,,.X-------X....,...............,H.....X-----
--------------X.......,,.....X...................,.,XX--------X...H,........A.......,.....X-----
--------------X.......,,.....X...........E.......XXX----------X....,................,.....X-----
--------------X.......,,.....X...A..............HX------------X...,,..,....,........,.....X-----
--------------X.......,,.....XXXXXXXXXXXXXXXXXXXXX------------X.....,,.,,,,.,,,,,...,.....X-----
--------------X.......,,.......E...........E.X----------------X..................,,,......X-----
--------------X.......,,.....................X----------------X...........................X-----
--------------X.......,,..H..................X------------XXXXX...........................X-----
--------------X.......,,.................W...X------------X...,........................A..X-----
--------------X.......,,...................A.X------------X.E.,...........................X-----
--------------X.......,,,,,,,,,,,,,,,,,,.....X------------X...,..A........................X-----
XXXXXXXXXXXXXXX.......,,,,,,,,,,,,,,,,,,.....XXXXXXXXXXXXXXXXXX............HH.HH.H........X-----
X...........H.........................,,.....,.......H.......XX...........................X-----
X.....................................,,.....,...............XX.......................H...X-----
X.....................................,,.....,....A..........XX.......A...................X-----
X.....................................,,.....,.............H.XXXXXXXXXXXXXXXXXXXXXXXXXXXXXX-----
X.....................................,,.....,...............XX.E..E..X----XXXXXXXXXXXXXXXXX----
X..........XXXXXXX....................,,.....,...............,,.......X----X:.+...........+X----
X..........XXXXXXX....................,,.....,...............,,......AXXXXXX..+........E..+X----
X..........XX...XX,,..................,,.....,...............,,.E.....XX..+,.+...........+AX----
X..........XX.A.,,..,.................,,.....,...............,,.......+,..+,+...........+..XXXXX
X..........XA...,E...,................,,.....,...............,,.......XX..+,+.....A....+...,EEHX
X..........XX...,,...,................,,.....XXXXXXXXXXX.....,,.E.....XXXXXX...........+...,EE.X
X..........XW...XXXXXXXXXXXX,XXXXX,XXXXX.....X---------X..W..XX.......X----X........B.B....,...X
X..........XXXXXXXXXXXXX...,.,...,.,...,.....X---------X.....XX.......+----XB.B......+.....,EH.X
X..........X----X,.,A..,...,.,...,.,...,.....X---------XA...AXX.......X----X........+......,...X
X....A.....X--XX,,.,...,...,.,...,.,...,.....X---------XXX,XXXXE..E..EX----X........+......,EEAX
X..........X-X.,,.,,.E.,..,...,.,...,..,.....X-----------X+X--X.......X----X.......+.......,EEWX
X..,,,,,,,.X-X,.,,XXXXXX..,...,.,...,..,.....X----------XX,XX-XE.....EX----X....B.B......B.XXXXX
X..,.....,.XX,.,.X-----XXXXXXXXXXXXXXXXX.....X---XXXXXX-XA..:-X...E...X----H......+.....B.+X----
X..,..E.A,:XX.,,X----------------------X....AX---X.,.,.XX,,,X-X.......X----X.....+.......B.X----
XXXXXX,XXXXXX,,,X-----XXXXXXXHXHHXX----XXXXXXX--X.,,.,,.X...,XXXXX,XXXX----H....+......++..X----
-----X+X----X...X-----X...A.......X------------X,,,,,,,,XX,,,X---X+X-------H...+......+....X----
---XXX,XXXXXX...X-----X...........X------------X..,XXX.,XX,..,XHXX,XHX-----X...+.....+.....X----
---X......HXX...X-----XE........E.X------------X,,,X-X,.X-:,,.XX..E..X-----H..B.....+....E.X----
---X.......XX...X-----X.....E.....X------------X..AX-X,,,XX,,,XX,,,,,X-----H.+.....+....W..X----
---X,,,,,,,XX...X-----X..........HX------------XX+XX-X,,,XX,,.XX.....X-----X+.B..++...E....X----
---<,.....,XX...X-----X...........XXXXXXXXXXXXXXX+:XXX,,.X,,.,XX,,,,,X-----X+A..+........K.X----
---X,.....,XX...X-----X...........,...E.....E...E..,XX.,,,,,.X-X.....X-----XXXXX,,,,,,,XXXXX----
---<,.:...,,,...X-----X.........E.,...............,.X-XX,.,.X--X,,,,,X---------X,,,,,,,X--------
---X,.....,XX...X-----X.E....A....,..............,.HX---XXXX---X.....X---------XE.EAE.EX--------
---<,...W.,XX...X-----X...........,...E...E..E..,...X----------X,,,,,X---------X.......X--------
---<,,,,,,,XX...X-----X...........,............,...HX----------X.....X---------H.E..E.AX--------
---X.......XXE.EX-----X......E...HXXXXXXXXXXXXX.....X----------X...E.X---------XXX++XXXX--------
---X.......XX...X-----X...........X-----------X..WE.X----------X.....X--------------------------
---XXXXXXXXXXLLLX-----X...........X-----------X.....X----------X....HX--------------------------
------------X..HX-----A...........X-----------X....:X----------X.....X--------------------------
------------X,,,X-----XXXXX,,,XXXXX-----------XE....XXXXXXXXX--X.....X--------------------------
------------X..,X--XXXXXXXX+++XXXXX-----------X......,E..EE.XXXX.....X--------------------------
------------X,,,.XXXEXX..........:X-----------X....,,.......,+.,.....X--------------------------
------------X.,.,,,,.,,...........X-----------H...,.........,+.,.....X--------------------------
-------------X.,.,,,.,,..........AX-----------:..,.E....E.E.,+.,.....X--------------------------
--------------XX,,.,E,,........E..X-----------X,H...........XXXX.....X--------------------------
----------------XXXX.XX.A........:X-----------XXXXXXXXXXXXXXX--H....HX--------------------------
-------------------XXXXXXXX,,,XXXXX----------------------------XXXXXXX--------------------------
--------------------------XLLLX-----------------------------------------------------------------
-------------------------XX,,,XX----------------------------------------------------------------
-------------------------X.....X----------------------------------------------------------------
-------------------------X.....X----------------------------------------------------------------
-------------------------X.....X----------------------------------------------------------------
-------------------------X.....X----------------------------------------------------------------
-------------------------X.....X----------------------------------------------------------------
-------------------------X.....X----------------------------------------------------------------
-------------------------X.....X----------------------------------------------------------------
-------------------------X.....X----------------------------------------------------------------
-------------------------X.....X----------------------------------------------------------------
-------------------------X.....X----------------------------------------------------------------
------------X>X----------X.....X----------------------------------------------------------------
-----------XA,HX-HXHXXXXXX.....XXXXXXXHX--------------------------------------------------------
-----------X...X-X..L..H...............XXXXX----------------------------------------------------
-----------X,..XXX..L..................XA..X----------------------------------------------------
-----------XA.E,+,A.L..................,..HX----------------------------------------------------
-----------X...XXX..L..................X...X----------------------------------------------------
-----------XH.HX-H.HL.................HXXXXX----------------------------------------------------
-----------XXXXX-XXXXXXXXXXXXXXXXX...XXX--------------------------------------------------------
---------------------------------X...X----------------------------------------------------------
---------------------------------X...X----------------------------------------------------------
-------------------------XXXXX---X...X---XXXXX--------------------------------------------------
-------------------------X...X---X...X---X...X--------------------------------------------------
-------------------------X.E.X---X...X---X.E.X--------------------------------------------------
-------------------------X...X---X...X---X...X--------------------------------------------------
-------------------------X,,,X---X...X---X,,,X--------------------------------------------------
-------------------XXXXXXX,,,XXXXX,,,XXXXX,,,XXXXXXXXX------------------------------------------
-------------------X................................AX------------------------------------------
-------------------X.H...............................X------------------------------------------
-------------------X.............HH.H................X------------------------------------------
-------------------X...........,,,,,,,,,.............X------------------------------------------
-------------------X........A..,A,H,,,,,...........H.X------------------------------------------
-------------------X.................................X------------------------------------------
-------------------X.................................X------------------------------------------
-------------------XH................................X------------------------------------------
-------------------X.................................X------------------------------------------
-------------------X.................................X------------------------------------------
-------------------X.................................X------------------------------------------
--------------XHXXXX.................................XXXXX--------------------------------------
--------------X...,,..........................E......,...X--------------------------------------
--------------X..E,,.......E.........................,E..X--------------------------------------
--------------XA..,,.................................,..AX--------------------------------------
--------------XXXXXX.................................XXXXX--------------------------------------
-------------------X.......XX,,,,,,,,,,,,,,XX........X------------------------------------------
-------------------H.......XX..............XX........X------------------------------------------
-------------------X.......XX...E.....W....XA......A.X------------------------------------------
-------------------H......AX,............A.XX........X------------------------------------------
-------------------H.......XX..............XX........X------------------------------------------
-------------------X.......XX..............XX........X------------------------------------------
-------------------H.......XX,,,,,,,,,,,,,,XX........X------------------------------------------
-------------------H................................HX------------------------------------------
-------------------X.................................X------------------------------------------
-------------------X................................HX------------------------------------------
-------------------X................................HX------------------------------------------
-------------------A.........,,,.......,,,...........X------------------------------------------
-------------------X.........,T,.......,T,..........HX------------------------------------------
-------------------X..H......,,,.......,,,.......H..HX------------------------------------------
-------------------X.............,,,,,...............X------------------------------------------
------------------XX,,,,,,,,,,,,,,,,,,,,,,,,,,,,,,,,,X------------------------------------------
------------------X,............,,,,,,,..............X------------------------------------------
------------------X,............,,,,,,,..............X------------------------------------------
------------------X,............,,,,,,,..............X------------------------------------------
------------------X,,,,,,,,,,,,,,,+++,,,,,,,,,,,,,,,,XX-----------------------------------------
------------------X,,,,,.........................,,,,,X-----------------------------------------
------------------Xt,ttt..A..................A...tt,ttX-----------------------------------------
------------------XE,E.,............W............,E,E.X-----------------------------------------
------------------X.,..,..,,,....................,E,E.X-----------------------------------------
------------------XE,E.,..,T,......:.......,,,.K.,.,..X-----------------------------------------
------------------X.,..,..,,,..............,T,...,E,E.X-----------------------------------------
------------------XE,E.,......A....A.....A.,,,...,.,..X-----------------------------------------
------------------X.,..XXXXXXXXXXXXXXXXXXXXXXXXXXXE,E.X-----------------------------------------
------------------X.,..X-------------------------X.,..X-----------------------------------------
------------------XE,E.X-------------------------XE,E.X-----------------------------------------
------------------X.,..X-------------------------XE,E.X-----------------------------------------
------------------XE,E.X-------------------------X.,..X-----------------------------------------
------------------X,,,,X-------------------------XXXXXX-----------------------------------------
------------------X,,,,X------------------------------------------------------------------------
------------------XE,E.X------------------------------------------------------------------------
------------------X.,..X------------------------------------------------------------------------
------------------XE,E.X------------------------------------------------------------------------
------------------X.,..X------------------------------------------------------------------------
------------------XXXXXX------------------------------------------------------------------------
