---------------------------------------------------------------------------------------------------------XXX----------------------------------------------------------------
-----------------------------------------------------------------------------------------------------XXXX...X---------------------------------------------------------------
-----------------------------------------------------------------------------------------------------X.......X--XX------------------------X---------------------------------
----------------------------------------------------------------------------------------------------X...,,....XX.X------------------------XXX-------------------------------
----------------------------------------------------------------------------------------------------X..,..,,......X----------------------X:..XX-----------------------------
---------------------------------------------------------------------------------------------------X..,.....,,....X----------------------XAH.A.XX---------------------------
---------------------------------------------------------------------------------------------------X..,.......,,..X---------------------X..W.....X--------------------------
--------------------------------------------------------------------------------------------------X..,.........,..X---------------------X.HA.H.H.X--------------------------
--------------------------------------------------------------------------------------------------X.,..:......,...X--------------------X.....H.H.X--------------------------
-------------------------------------------------------------------------------------------------X..,.....<..<,...X--------------------X.H.AH.A.AX--------------------------
-------------------------------------------------------------------------------------------------X...,........,...X-------------------XA........H.X-------------------------
--------------------------------------------------------------------------------------------------X..,.<......,..X----------------XX---X.H...HA.H.X-------------------------
--------------------------------------------------------------------------------------------------X..,.....<.,...X-------------XXX.:X---X..A.....AX-------------------------
--------------------------------------------------------------------------------------------------X...,...,,,,...X-----------XX.E....X--X...H..HXX--------------------------
---------------------------------------------------------------------------------------------------X..,,,,.......X-----------XE...,...X--XH...XX----------------------------
---------------------------------------------------------------------------------------------------X............,X-----------X.E.,.,...X--X++X------------------------------
----------------------------------------------------------------------------------------------------X.........,,,,X----------X.,,..,....XXX++XXXX---------------------------
----------------------------------------------------------------------------------------------------X.......,,,,,..X--------XE,.....,...,........X--------------------------
----------------------------------------------------------------------------------------------------X....,,,,,,,....X-------X..,..:..,..,........X----XXXX------------------
-----------------------------------------------------------------------------------------------------X.,,,,,,,,.,,,,.X------X.,,,....,.,....,,,...XXXX....X-----------------
-----------------------------------------------------------------------------------------------------X,,,,,,..,,...,..X---XXX,.,.,..,..,...,...,,.,.......X-----------------
-----------------------------------------------------------------------------------------------------X,,,,..,,.....,...XXX......,.,.,..,.,,.....,.,........X----------------
-----------------------------------------------------------------------------------------------------X,...,,.....E.,..,.....,...,..,...,,.......,,.......,.X----------------
-----------------------------------------------------------------------------------------------------X...,.........,.,....,,.,...,....,..,......,,.....,,,..X---------------
-----------------------------------------------------------------------------------------------------X..,.........,..,..,,...,...XXXXXX...,....,.,...,,..,...X--------------
----------------------------------------------------------------------------------------------------X..,.......E.,..,...,.....,..X----X...,....,.,..,.....,..X--------------
----------------------------------------------------------------------------------------------------X.,,,.......,..X...,.....,...X-----X...,..,,,...,.....,...X-------------
----------------------------------------------------------------------------------------------------X....,,,,..,:.X-X..,.....,...X-----X....,,..,....,....,....X-----XX-----
----------------------------------------------------------------------------------------------------X,.......,,..X---X..,,..,....X------X,,,....X....,....,....X----X..XX---
----------------------------------------------------------------------------------------------------X.,,,,.......X---X....,.,...,X-----X....,,,X-X...,.....,....X--X.....XX-
---------------------------------------------------------------------------------------------------X......,,,,..X-----X....,.,,,..X----X........X-X...,..,,,....X-X........X
---------------------------------------------------------------------------------------------------X..........,X-------X..,,,......X--X..,,,,,..X--X..,,,........X+...A....X
--------------------------------------------------------------------------------------------------X............X--------X,.....,,...X-X..,....,..X-X......,,,.....++.......X
--------------------------------------------------------------------------------------------------X....,,.......X-------X....,,..,,..X..,.....,...X-X.....,K,.....++.....W.X
-------------------------------------------------------------------------------------------------X....,..,,,....X------X...,,......,.,..,......,..X--X....,,.......++..W...X
-------------------------------------------------------------------------------------------------X...,......,,...X-----X..,........,.,..,.......,.:X--X....,......++.....WX-
------------------------------------------------------------------------------------------------X...,........,...X----X...,........,.,..,......,..X----X..........++...W..X-
------------------------------------------------------------------------------------------------X..,.........,...X----X...,.......,...,..,..E.,...X---X..E.......XX..A..:.X-
-----------------------------------------------------------------------------------------------X...,........,...X--XXX....,.......,...,..,...,...X---X.....,,,..X-X.......X-
-----------------------------------------------------------------------------------------------X....,.......,...XXX...,....,......,...,..,,,,...X----X.,,,,..,..X--X....XX--
-----------------------------------------------------------------------------------------------X,...,.....,,...,......,....,.....,....X...E....X----X.,.....E..X---X..XX----
----------------------------------------------------------------------------------------------X..,...,...,....,........,....,,..,...XXXX,...E..X---X.,E..E..,.X-----XX------
----------------------------------------------------------------------------------------------X...,..,.,,....,.....,,..,......,,..XXX..X.,,,..X---X.,......,..X-------------
----------------------------------------------------------------------------------------------X....,,.,.....X....,,..,..,.......XXX..A.X....,X---X..,....,,..X--------------
---------------------------------------------------------------------------------------------X.E.....,.....XX....,...,...,....XXX...AH.X.....X--X...,.E.,...X---------------
---------------------------------------------------------------------------------------------X......:.,...X-X...,.....,..,..XXX...A..HHX..,..X--X..,.,,,..EX----------------
---------------------------------------------------------------------------------------------X.........,.X---X..,.....,...XXXH..AH....+X..,,..XX..,A,,.....X----------------
--------------------------------------------------------------------------------------------X...E.......X----X.,.......,..XX.HH..HHX+++X.,.,..X..,,.,..E..X-----------------
--------------------------------------------------------------------------------------------X...........X-----X.,.....,...XX.......X++...,..,.,....,,,,,..X-----------------
--------------------------------------------------------------------------------------------XE......,,,..X----X..,...,....XXAH.A.A.X.E..,....,.,.....,,....X----------------
---------------------------------------------------------X---------------------------------X....,,,,..,..X-----X..,.,.....XX.HH..H.XX..,.....,.,...........X----------------
--------------------------------------------------------X.X--------------------------------XW...,.....,...X----X...,......XXXXXXXHH.X.,.......,.,.,,,,,,,...X---------------
-------------------------------------------------------X...XX------------------------------X...,......,...X-----X.......,,...XXXXXXAX.,.......,.,..,.....,..X---------------
------------------------------------------------------X......X----------------------------X..E.,......,....X-----X....,,.........XXXX..,.......,.,..,....,...X--------------
-----------------------------------------------------X........X---------------------------X...,.......,...:X-----X..,,.............XXX.,.......,.,...,....,..X--------------
----------------------------------------------------X..........XX--------------------------XX.,.......,..XX-------X,....,,...........X..,....,,.,...,....,..X---------------
---------------------------------------------------X.............X---------------------------X.......,.XX---------X....,..,,,........,..,...,..,....,..,,..X----------------
--------------------------------------------------X...............XX------------------------XX.......XX----------X.....,.....,,......,...,,,...,...,.,,...X-----------------
-------------------------------------------------X...............,..XX----------------------X.LL...LX------------X....,........,,....,...,....,...,,,.....X-----------------
------------------------------------------------X...............,.....XX--------------------X...LLLLX-----------X....,....:....,.....,.......,...........X------------------
-----------------------------------------------X...............,........XX------------------X........X----------X....,........,......,.....XXXX.........X-------------------
----------------------------------------------X...............X.........,.XXXXXX------------X........X---------X.E..,.........,......,.XXXX----XXXXX...X--------------------
---------------------------------------------X..............XXX.........,.,.,...XXXXXXXXXXXXX........HX--------X.....,.......,.......XX-------------XXX---------------------
--------------------------------------------X..............X--X.........,.,.,......,.,.....,,.........X-------XE.E.E..,.....,......XX---------------------------------------
--------------------------------------------X..............X--X.........,.,.,......,:,......,,.......HX--------XX......,..,,....+XX-----------------------------------------
--------------------------------------------X..............X---X........,.,.,......,.,......,,........X----------XX.....,,..XX+++XX-----------------------------------------
--------------------------------------------X..............X---X........,.,.,......,.,.......,,.......X------------X......XX--X+...HXX--------------------------------------
--------------------------------------------X..............X---X........,.,.,......,.,.......,,.......X-------------XX:.XX---X..H.....XX------------------------------------
-------------------------------------------X...............X---X........,.,.,..E...,.,........,,......X---------------XX----X..H..H.AH.X------------------------------------
-------------------------------------------X...............X---X........,.,.,......,.,........,,,,,,,,X--------------------X.H...H.....X------------------------------------
-------------------------------------------X...............X---X........,.,.,......,.,.........,...,,,X-------------------X.H..H..H....X------------------------------------
-------------------------------------------X................X--X.....A..,.,.,......,.,.........,,,,....X-----------------X......H...H..X------------------------------------
-------------------------------------------X.................X--X.......,.,.,......,:,.................X-----------------X..A.H..H.H.HX-------------------------------------
-------------------------------------------X..................X-X.......,.,.,.......,.,.E...............X-----------------X.....HH....X-------------------------------------
-------------------------------------------X...................XX.......,.,.,........,,.......E.........X-----------------X....A...A.HX-------------------------------------
-------------------------------------------X....................X.......,.,.,........,.,.................X-----------------X.H..H.H...X-------------------------------------
------------------------------------------X........,,,..........,........,.,.,........,.,..........E.....X-----------------X...W....XXX-------------------------------------
------------------------------------------X........,..,.........,.....A..,.,.,.........,.,..E...E.......,,X-----------------X.:HXXXX----------------------------------------
------------------------------------------X........,,,..........,........,.,..,.........,,.........,,,,,:.X-----------------XXX---------------------------------------------
------------------------------------------X.....................,........,..,.,..........,,...,,,,,.....,,X-----------------------------------------------------------------
------------------------------------------X......................,........,.,..,..E......,.,,,.....,,,,,..X-----------------------------------------------------------------
------------------------------------------X......................,........,.,..,..........,:..,,,,,.......X-----------------------------------------------------------------
------------------------------------------X......................,........,..,..,..........,,,............X-----------------------------------------------------------------
------------------------------------------X......................,.........,.,..,........................X------------------------------------------------------------------
-----------------------------------------X.............E........XX.........,..,..,.......................X------------------------------------------------------------------
-----------------------------------------X...................XXX--X......A..,..,,.,,.....................X------------------------------------------------------------------
-----------------------------------------X...................X-----X.........,...,..,...............E....X------------------------------------------------------------------
-----------------------------------------X...................X-----X..........,...,..,...................X------------------------------------------------------------------
-----------------------------------------X...................X------X..........,...,..,,.................X------------------------------------------------------------------
-----------------------------------------X....................X------X..........,,..,...,...............X-------------------------------------------------------------------
-----------------------------------------X,...................X-------X...........,..,,..,,,,...........X-------------------------------------------------------------------
-----------------------------------------X,....,,,............XXX-----X............,...,.....,,,,,,,,...X-------------------------------------------------------------------
----------------------------------------X..,...,..,..............XXXXX-X............,...,,,,,........,,,X-------------------------------------------------------------------
----------------------------------------X..,...,,,....................XXX............,.......,,,,,,,,...X-------------------------------------------------------------------
----------------------------------------X..,.............................,.........A..,,,,,,,,,,.....,,,X-------------------------------------------------------------------
----------------------------------------X...,............................,......................,,,,,,,,X-------------------------------------------------------------------
----------------------------------------X...,.............................,.............................X-------------------------------------------------------------------
----------------------------------------X....,............................,..............................X------------------------------------------------------------------
---------------------------------------X.....,.............................,..............A..............X------------------------------------------------------------------
---------------------------------------X.....,..............................,..................A.....A...X------------------------------------------------------------------
---------------------------------------X......,.............................,............................X------------------------------------------------------------------
---------------------------------------X......,.........,,,..................XX..........................X------------------------------------------------------------------
---------------------------------------X.......,.......,..,..................X-XXX........................X-----------------------------------------------------------------
---------------------------------------X.......,........,,,.......E..........X----XXX.....................X-----------------------------------------------------------------
--------------------------------------X........,.............................X-------XXX..................X-----------------------------------------------------------------
--------------------------------------X...,,....,.............................XX--------XXX.............XX------------------------------------------------------------------
--------------------------------------X.,,.,....,...............................X---------XXX,.........X--------------------------------------------------------------------
--------------------------------------X.,,,,.....,.....................,,,.......XX---XXXX....,,......X---------------------------------------------------------------------
--------------------------------------X..........,....................,..,.........XXX..........,,..XX----------------------------------------------------------------------
--------------------------------------X..........,.....................,,,........................XX------------------------------------------------------------------------
-------------------------------------X............,.............................................XX--------------------------------------------------------------------------
-------------------------------------X............,...........................................XX----------------------------------------------------------------------------
-------------------------------------X.............,........................................XX------------------------------------------------------------------------------
-------------------------------------X.......,,....,,..........,,.........................XX--------------------------------------------------------------------------------
------------------------------------X......,,.,......,,,.......,.,...............E......XX----------------------------------------------------------------------------------
------------------------------------X......,,,,.........,,.....,.,....................XX------------------------------------------------------------------------------------
------------------------------------X.....................,,,...,,.................XXX--------------------------------------------------------------------------------------
------------------------------------X,,................,,....,,,.................XX-----------------------------------------------------------------------------------------
-----------------------------------X,.,..............,,.,.......,,,............XX-------------------------------------------------------------------------------------------
-----------------------------------X,.,..............,,.,..........,,........XX---------------------------------------------------------------------------------------------
-----------------------------------X,,.................,.............,,,...XX-----------------------------------------------------------------------------------------------
----------------------------------X........,,,..........................XXX-------------------------------------------------------------------------------------------------
----------------------------------X.....E.,..,................XXXXXXXXXX----------------------------------------------------------------------------------------------------
---------------------------------X.........,,,.......XXXXXXXXX--------------------------------------------------------------------------------------------------------------
--------------------------------X....,,..........XXXX-----------------------------------------------------------------------------------------------------------------------
--------------------------------X...,..,.....XXXX---------------------------------------------------------------------------------------------------------------------------
-------------------------------X....,,,...XXX-------------------------------------------------------------------------------------------------------------------------------
------------------------------X..........X----------------------------------------------------------------------------------------------------------------------------------
------------------------------X...E....XX-----------------------------------------------------------------------------------------------------------------------------------
-----------------------------X...,,...X-------------------------------------------------------------------------------------------------------------------------------------
----------------------------X...,..,.X--------------------------------------------------------------------------------------------------------------------------------------
---------------------------X....,,,.X---------------------------------------------------------------------------------------------------------------------------------------
--------------------------X........X----------------------------------------------------------------------------------------------------------------------------------------
--------------------------X,,....XX-----------------------------------------------------------------------------------------------------------------------------------------
-------------------------X,..,..X-------------------------------------------------------------------------------------------------------------------------------------------
------------------------X.,,,..X--------------------------------------------------------------------------------------------------------------------------------------------
-----------------------X.,,...X---------------------------------------------------------------------------------------------------------------------------------------------
----------------------X.,..,XX----------------------------------------------------------------------------------------------------------------------------------------------
---------------------X..,,,X------------------------------------------------------------------------------------------------------------------------------------------------
--------------------X,,...X-------------------------------------------------------------------------------------------------------------------------------------------------
------------------XX,..,.X--------------------------------------------------------------------------------------------------------------------------------------------------
-----------------X,.,,,XX---------------------------------------------------------------------------------------------------------------------------------------------------
----------------X,.,..X-----------------------------------------------------------------------------------------------------------------------------------------------------
---------------X.,.,.X------------------------------------------------------------------------------------------------------------------------------------------------------
--------------X...,,X-------------------------------------------------------------------------------------------------------------------------------------------------------
------------XX,...XX--------------------------------------------------------------------------------------------------------------------------------------------------------
-----------X.,.,.X----------------------------------------------------------------------------------------------------------------------------------------------------------
----------X..,.,X-----------------------------------------------------------------------------------------------------------------------------------------------------------
---------X....,X------------------------------------------------------------------------------------------------------------------------------------------------------------
--------X,,,.XX-------------------------------------------------------------------------------------------------------------------------------------------------------------
------XX,..,X---------------------------------------------------------------------------------------------------------------------------------------------------------------
-----X...,,X----------------------------------------------------------------------------------------------------------------------------------------------------------------
XXXXX,....X-----------------------------------------------------------------------------------------------------------------------------------------------------------------
X>..>>,.XX------------------------------------------------------------------------------------------------------------------------------------------------------------------
X>....,X--------------------------------------------------------------------------------------------------------------------------------------------------------------------
X....>X---------------------------------------------------------------------------------------------------------------------------------------------------------------------
X....>X---------------------------------------------------------------------------------------------------------------------------------------------------------------------
XX>.>X----------------------------------------------------------------------------------------------------------------------------------------------------------------------
--XX>X----------------------------------------------------------------------------------------------------------------------------------------------------------------------
----X-----------------------------------------------------------------------------------------------------------------------------------------------------------------------
