XXXXXXXX:XXXXX:XXXXXXXXXXXXXXXXXXXXXXXXXXXXXXXX:XXXXX:X--------------
X:....KXX.tWt..XX....H.....H.......EXX:....,.AXXttHtttX--------------
XXXXXXXXX.AttA.XX.XXXXXXXXX.XXXX.XX.XX.,,,.XX.XX...E..X--------------
XXXXXX:XXA.A..AXX.XXXXXXXXX.XXXX.XX.XX.,TXXXX.XX.E....X--------------
X,HE...XX.A..A.XX.XX.....H....,..XX.XX.,,XXXX.XX......X--------------
XXXXX..XX......XX.XX.XXXXXX,XXXX.XX.XX.....XX.XX......X--------------
XXXXX..XXXX+XXXXX.XX.X----XHX--XEXX.XXXXXX.XX.XX......X--------------
X,H..E.XXXX.XXXXX.XX.X---XX,XXXXXXX.XXXXXX.XX.XX...E..X--------------
XXXXX..XX.....HXX.XX.X-XX..E...X--X.,.........XX......X--------------
XXXXX..XX.XXXXXXX.XX.X-X.......X--X.XXXXXX.XX.XXXX,,XXX--------------
X..XX..XX.XXXXXXX.XX.XX..E..E...X-X.X----X.XX.XXX...XXX--------------
X..XX..XX.XXH..XX.XX.XX.........XX...XXXXX.XX.XX++++++X--------------
X......XX.XXXX.XX.XX.XX:...:....XX.H....XX.,..XXXX,,XXX--------------
XXX..XXXX.XXXX.XX.XX.XX..E..E...XX...XX.XX.XX.XXX...XXX--------------
XX...XXXX....H.XX.XXHXX.........X-X,X-X....XX.XX++++++X--------------
X......XX,XXXX.XX.XX.XX....E....X-XtX-XXXXXXX.XXXX,,XXX--------------
X.XXXX,XX.XXXX.XX.XX.X-XX......X--X.XXXXXXXXX.XXX...XXX--------------
X.XXXX.XXH........,..X---XX,XXX---XT,A:.......XX++++++X--------------
X.,....XXXXXXXXXXXXXXX----X.X-----XXXXXXXXXXXXXXE....EX--------------
X.XXXX.X-----XXXXXX------XX+XXX------XXXXXX----X......X--------------
X.XXXX.X---XX......X---XX......X---XX......X---X......X--------------
X..XX..X---X.......X---X.......X---X.......X---X......X--------------
X..XX..X--X.....E...X-X.........X-X..E:..E..X--X......X--------------
X..XX..XXXX..E......XXX.....:...XXX.........XXXX....E.X--------------
XE......,H,E...:..E.,.+:...E....+.,.E..:...E,H,...E...X--------------
X..XX..XXXX..E..E...XXX.........XXX...E.E...XXXX......X--------------
X..XX..X--X.........X-X......A..X-X.........X--X......X--------------
X..XX..X--X.....:...X-X.........X-X.........X--X......X--------------
X,,XXX.X---XX......X---XX......X---XX......X---X....E.X--------------
X..XXX.X-----XXXXXX------XX,XXX------XXXXXX----X......X--------------
X......X------------------X.X------------------X......X--------------
XA.....X-----------XXXXXXXX+XXXXXXXX-----------XE.....X--------------
XXX,XXXX----------X.................X----------XXX,XXXX--------------
XX...XXXXXXX:X---X..<................X---:XXXXXXX...XXX--------------
X......X..tttX--X.....................X--Xtt..X.......X------XXXXXX--
XT...E.L:.tWtX-:......................:X-XAt..+......TX----XX......X-
X..E...L..tttX-X............E.........XX-Xtt..+.......X----X.......X-
X......XX...:XXX....A.,,,,,,,,,,,.....XX-:....XX......X---X..,,,,L.tX
XXXXXXXXXXXXXXX,...,,,...E......,,,...,X-XXXXXXXXXXXXXX---X..,>>,L.tX
--------------X:T.<,,,:..:.:...:,,,..W,X------------------XT.,>>,L.tX
XXXXXXXXXXXX:XXX.....,,,,,,,,,,,,.....XX-:XXXXXXXXXXXXX---X..,,,,L.tX
X......X..tttX-X........,,............XX-Xtt..X.......X---X..LLLLL.tX
XT...E.+:.tWtX-:........,,....E.......:X-XAt..+......TX---X........tX
X..E...,..tttX-X.......................X-Xtt..+.......X----XX......X-
X......XX...:X--X.....................X--:....XX......X------XXXXXX--
XXX,XXXXXXXXXX---X..<................X---XXXXXXXXX,XXXX--------------
XX...XXX----------X......XX+X.......X----------XX...XXX--------------
X.....EX-----------XXXXXXXX.XXXXXXXX-----------X....A.X--------------
X......X------------------X.X------------------X......X--------------
X......X-----XXXXXX------XX,XXX------XXXXXX----X.XXX,,X--------------
X.E....X---XX......X---XX......X---XX......X---X.XXX..X--------------
X......X---X.......X---X.......X---X.......X---X..XX..X--------------
X......X--X.....E...X-X...:.....X-X......E..X--X..XX..X--------------
X......XXXX..E......XXX......A..XXX...E.....XXXX..XX..X--------------
X...E...,H,E...:..E.,.+:..:.....+.,.E....E.E,H,.......X--------------
X.E....XXXX..E..E...XXX.....:...XXX...E.....XXXX..XX..X--------------
X......X--X.........X-X.........X-X.........X--X..XX..X--------------
X......X--X.........X-X.........X-X.........X--X..XX..X--------------
X......X---XX......X---XX......X---XX......X---X.XXXX.X--------------
X......X-----XXXXXX------XX+XXX------XXXXXX----X.XXXX.X--------------
XE....EXXXXXXXXXXXXXX-----X.X----XXXXXXXXXXXXXXX...,..X--------------
X++++++XX........+,KX----XX,XXX--X.,.H........XX,XXXX.X--------------
XXX,,XXXX.XXXXXXXXX.X--XX......X-X.XX.XX.XXXX,XXAXXXX.X--------------
XX...XXXX.XXXXXXX-XtX--X...E...X-X.XX.XXHXXXX.XX......X--------------
X++++++XX.XX....X-X,X-X..E......XX.XX.XX......XXXX..XXX--------------
XXX,,XXXX.XX.XX.XX...XX.....E...XX.XX.XX.XXXX.XXX...XXX--------------
XX...XXXX.,.HXX....H.XX:...:....XX.XX.XX.XXXX.XX......X--------------
X++++++XX.XX.XXXXX...XX...E.....XX.XX.XX..HXX.XX..XX..X--------------
XXX,,XXXX.XX.X----X.X-X.....E...XX.XX.XXXXXXX.XX..XX..X--------------
XX...XXXX.XX.XXXXXX.X-X.........XX.XX.XXXXXXX.XX..XXX.X--------------
X..E...XX:.......,..X--XX..E...X-X.XX.X:.....HXX..XXX.X--------------
X......XX.XX.XXXXXX.XXXX-XX,XXX--X.XX.XXXXLXXXXX...H,.X--------------
X......XX.XX.XXXXXX.XXHX--XHX----X.XX.XXXX.XXXXX..XXX.X--------------
X......XX.XX.....XX.XX.XXXX,XXXXXX.XX.XX.A..A.XXE.XXX.X--------------
X....E.XX.XXXX,,.XX.XX.,...H.......XX.XXA.A..AXX...H,.X--------------
X..E...XX.XXXXT,.XX.XX.XXXX.XXXXXXXXX.XX.AttA.XXXXXXX.X--------------
X......XX.XX.,,t.XX.XX.XXXX.XXXXXXXXX.XX.tWt..XXA.....X--------------
:ttKtt:XX.,.....HXX:.................EX:.ttt.:XXt....:X--------------
XXXXXXXXXXXXXXXXXXXXXXXXXXXXXXXXXXXXXXXXXXXXXXXXXXXXXXX--------------
