------------------------------------------------------XXXXXXXXXXXXXXXXXXXXXXXXXXXXXXXXX------------------------------------------------------
------------------------------------------------------X......E..E.........E...........X------------------------------------------------------
------------------------------------------------------X....E.........E......E.E.......X------------------------------------------------------
------------------------------------------------------X..........................E....X------------------------------------------------------
------------------------------------------------------X.E.XXXXXXXXXXXXXXXXXXXXXXX,,,,,X------------------------------------------------------
------------------------------------------------------X...X---------------------X..:..X------------------------------------------------------
------------------------------------------------------X...X---------------------XXXLXXX------------------------------------------------------
------------------------------------------------------X.E.X-----------------------X.X--------------------------------------------------------
------------------------------------------------------X...X-XXXXXXXXXXXXXXX-XXXXXXXLXXXXXXX--------------------------------------------------
------------------------------------------------------X...X-XH...........,X-X.............X--------------------------------------------------
------------------------------------------------------X...X-Xtttt...E....,X-X.E.E.E.E.E.E.X---XXXXXXXXXXXXXXXXXXXXXXXXXXXXXXXXXXXXXXXXXXXXX--
------------------------------------------------------X.E.X-X...t.......,.X-X.............X---X...........,...........................,...X--
--------------------XXXXXXXXXXXXXXXXXXXXXXXXXXXXXXXXXXX...X-X...t...E..,..X-X,,,,,,,,,,,,,X---X.A.....,,,.,...........................,.H.X--
--------------------XW..,,,,,...,........E................X-X...t.....,...X-X...,.....,...X---X.......,.,.,...........................,...X--
--------------------X...,,,,,.K.,...E...........E..E...EA.X-Xtttt.E...,...X-X...,.....,...X---X.......,,,.,.......................E...,...X--
--------------------X...,,.,,,..,............E............X-XH.H.....,....X-X...,..E..,...X---X...........,...........................,...X--
--------------------X...,.,E,,,,,...XXXXXXXXXXXXXXXXXXXXXXX-XXXXXXXXX.....X-X...,.....,...X---X...........,...........................,...X--
--------------------X:..,.,..,,,,...X-------------------------------X.....X-X...,.....,...X---X...........,...........................,...X--
--------------------X...,.,,,.,,,.E.X-XXXXXXXXXXXXXXXXXXXXXXXXXXXXX-X.....X-X...,,,,,,,...X---X.........E.,...........................,...X--
--------------------X...,A...,,,,...X-X..........................,X-X.....X-X...,.....,...X--X,...........,...........................,...X--
--------------------X...,,,,,,,,,...X-X.H.............<.........E.X-X.....X-X...,.....,...XXX.,...E.......,...........................,...X--
--------------------X...........,...X-X........................,..X-X.....X-X...,.....,...L.L.,...........,...........................,...X--
--------------------X...........,...X-X.:.,,,,,,,,,,,,,,,,,,,,,,,,X-X...E.X-X...,.....,.E.L.L.,...........,...........................,.E.X--
--------------------X....E......,...X-X...,.......................X-X.....X-X...,.....,...L.L.,...........,...........................,...X--
--------------------X...........,.E.X-X...,.......................X-X.....X-XH..,.....,...XXX.,.........E.,.......................E...,...X--
--------------------X.......E...,...X-X...,.......................X-X.....X-X...,.....,...X--X,...........,...........................,...X--
--------------------X,,,,.......,...X-X...,.......................X-X.....XXX...,.....,...X---X...........,...........................,...X--
--------------------X...,.......,...X-X...,.......................X-X.....,H,...,.....,...X---X...........,...........................,...X--
--------------------X,,,,.......,...X-X...,.......................X-XXXXXXXXX...,.....,...X---X,,,,,,,,,,,,...........................,...X--
--------------------X...,.......,...X-X...,.......................X---------X...,.....,...X---X.......................................,...X--
--------------------X,,,,,,,,,,,,...X-X...,...............E.......XXXXXXXXX-X...,.....,...X---X.......................................,...X--
--------------------X...,.......,.E.X-X...,.......................,......HX-X...,.....,...X---X.......................................,...X--
--------------------X.E.,W.E...,,...X-X...,.......................,.....E.X-X...,.....,...X---X.E.....................................,...X--
--------------------X...,......,,...X-X...,.......................,..XXX..X-X...,.....,...X---X.......................................,...X--
--------------------X...,,,,,,XXX...X-X...,.......................,..X-X..X-X...,.....,...X---X...................,,,,,,,,,,,.....E...,...X--
--------------------X...,.....X-X...X-X...,.......................,..XXXE.X-X...,.....,...X---X...................,.........,.........,...X--
--------------------X...,.....X-X...X-X...,...............E.E.....,.......X-X...,.....,...X---X,,,,...............,.....E...,.........,...X--
--------------------X.E.,.E...X-X...X-X...,.......................,.......X-X...,.....,...X--X,...,...............,.........,.........,...X--
--------------------X...,.....X-X...X-X.A.,.......E.......E.XXX,,,,.....XXX-X...,.....,...XXX.,...,...............,.........,.........,...X--
--------------------X...,.....X-X.E.X-X...,.................X-X.E.,..E..X--X....,.....,...L.L.,...,...............,.........,.........,...X--
--------------------X.E.,AAAA,X-X...X-X...,.................XXX,,,,.....XXX.....,.....,...L.L.,...,,,,,,,,,,,,,,,,,,,,,,,,,,,,,,,,,,,,,...X--
--------------------X...,.....X-X...X-X...,.................,.,,,,,.....,.,.....,.....,...L.L.,...................,.,.,.,...,.........,...XXX
--------------------X...,.....X-X...X-X.T.,...W...........E.,.,,,,,...E.,A,...E.,.....,.E.L.L.A.A.A.A.A.A.A.A.A.A.A.A.A.A.A.A.A.A.A.A.A.A.A.X
--------------------X...,.....X-X...X-X...,.................,.,,,,,.....,.,.....,.....,...L.L.,...................,.,.,.,...,.........,...XXX
--------------------+++++..E..X-X.H.X-X...,.................XXX,,,,.....XXX.....,.....,...L.L.,...,,,,,,,,,,,,,,,,,,,,,,,,,,,,,,,,,,,,,...X--
------------------------X.....X-X...X-X...,.................X-X.E.,..E..X--X....,.....,...L.L.,...,...............,.........,.........,...X--
--------------------XXXXXH.H.HX-X...X-X.A.,.......E.......E.XXX,,,,.....XXX-X...,.....,...XXX.,...,...............,.........,.........,...X--
--------------------X...,.....X-X...X-X...,.......................,.......X-X...,.....,...X--X,...,...............,.........,.........,...X--
--------------------X...,.....X-X...X-X...,...............E.E.....,.....E.X-X...,.....,...X---X,,,,...............,.....E...,.........,...X--
--------------------X...,AAA.AX-X.E.X-X...,.......................,..XXX..X-X...,.....,...X---X...................,.........,.........,...X--
--------------------X.E.,,,,,,X-X...X-X...,.......................,..X-X..X-X...,.....,...X---X...................,,,,,,,,,,,.....E...,.E.X--
--------------------X...,.....X-X...X-X...,.......................,..XXX..X-X...,.....,...X---X.......................................,...X--
--------------------X...,.....X-X...X-X...,.......................,.......X-X...,.....,...X---X.E.....................................,...X--
--------------------X...,..E..X-X...X-X...,.......................,.....EHX-X...,.....,...X---X.......................................,...X--
--------------------X...,.....X-X...X-X...,...............E.......XXX,A,XXX-X...,.....,...X---X.......................................,...X--
--------------------X..E,.....X-X...X-X...,.......................X-X...X---X...,.....,...X---X.......................................,...X--
--------------------X...,,,,,,XXX.E.X-X...,.......................X-X,,,XXX-X...,.....,...X---X.......................................,...X--
--------------------X...,.....,.,...X-X...,.......................X-X.....X-X...,.....,...X---X.......................................,...X--
--------------------X...,W.E...,,...X-X...,.......................X-X.E.E.X-X...,.....,...X---X,,,,,,,,,,,,.......................E...,...X--
--------------------XE..,......,,...X-X...,.......................X-X.....X-X.H.,.....,...X---X...........,...........................,...X--
--------------------X,,,,,,,,,,,,...X-X.:.,.......................X-X.....X-X...,.....,...X---X.......E...,...........................,...X--
--------------------X...,......A,...X-X...,.......................X-X.E.E.X-X...,.....,...X--X,...........,...........................,...X--
--------------------X,,,,.......,...X-X...,,,,,,,,,,,,,,,,,,,,,,,,X-X.....X-X...,.....,...XXX.,...........,...........................,...X--
--------------------X...,......A,...X-X........................,..X-X.....X-X...,.....,...L.L.,...........,...........................,...X--
--------------------X,,,,.......,...X-X.H...<.................<.E.X-X.....X-X...,.....,.E.L.L.,...E.......,...........................,.E.X--
--------------------XA.........A,.E.X-X..........................,X-X.....X-X...,.....,...L.L.,...........,...........................,...X--
--------------------X...........,...X-XXXXXXXXXXXXXXXXXXXXXXXXXXXXX-X.....X-X...,.....,...XXX.,...........,...........................,...X--
--------------------XA.........A,...X-------------------------------X.....X-X...,.....,...X--X,...........,...........................,...X--
--------------------X......E....,...XXXXXXXXXXXXXXXXXXXXXXXXX-XXXXXXX.E.E.X-X...,,,,,,,...X---X...........,...........................,...X--
--------------------XA.........A,.E....E....................X-X....,,,....X-X...,.....,...X---X...........,...........................,...X--
--------------------X...........,...E.....E....E...E..E.A.E.X-X.E,,...,,..X-X...,.....,...X---X.......E...,.......................E...,...X--
--------------------XA.A.A.A.A.A,...........................X-X..,.....,..X-X...,..E..,...X---X...........,...........................,...X--
--------------------XXXXXXXXXXXXXXXXXXXXXXXXXXXXXXXXXXXXX...X-XE,.......,.X-X...,.....,...X---X.......,,,.,...........................,...X--
--------------------------------------------------------X...X-X.,...K...,.X-X...,.....,...X---X.......,.,.,...........................,...X--
--------------------XXXXXXXXXXXXXXXXXXXXXXXXXXXXXXXXXXX-X.E.X-XE,.......,.X-X,,,,,,,,,,,,,X---X.A.....,,,.,...........................,.H.X--
--------------------X.........,.,........,.....,......X-X...X-X..,.....,..X-X.............X---X...........,...........................,...X--
--------------------XWXXXXXXXXX,,.......,...A...,E..E.X-X...X-X.E,,...,,..X-X.E.E.E.E.E.E.X---XXXXXXXXXXXXXXXXXXXXXXXXXXXXXXXXXXXXXXXXXXXXX--
--------------------X.X-------X.,..E...,.........,....X-X...X-X....,,,...HX-X.............X--------------------------------------------------
--------------------X.X-------X,,.....,.....A.....,.E.X-X.E.X-XXXXXXXXXXXXX-XXXXXXXLXXXXXXX--------------------------------------------------
--------------------X.X-------X.,.....,...........,...XXX...X---------------------X.X--------------------------------------------------------
--------------------X.X-------X,,...T.,.A.A.A.A.A.,....W,...X-------------------XXXLXXX------------------------------------------------------
--------------------X.X-------X.,.....,...........,.E.XXX.E.X-------------------X..:..X------------------------------------------------------
--------------------X.X-------X,,.....,.....A.....,...X-X...XXXXXXXXXXXXXXXXXXXXX,,,,,X------------------------------------------------------
--------------------X.X-------X.,......,.........,..E.X-X..........................E..X------------------------------------------------------
--------------------X,X-------X,,..E....,...A...,.....X-X..E...E..E....E..E...E.......X------------------------------------------------------
--------------------X.X-------X.,........,.....,....E.X-X.............................X------------------------------------------------------
-------------------X.A.X------XXXXXXXXXXXXXXXXXXXXXXXXX-XXXXXXXXXXXXXXXXXXXXXXXXXXXXXXX------------------------------------------------------
-------------------X...X---------------------------------------------------------------------------------------------------------------------
XXXXXXXXXXXXXXXXX-X+++++X-XXXXXXXXXXXXXXXXX--------------------------------------------------------------------------------------------------
XA............,..XX.....XX..,.......E.....X--------------------------------------------------------------------------------------------------
X...E.........,...X+++++X...,...........A.X--------------------------------------------------------------------------------------------------
X.............,.............,.............X--------------------------------------------------------------------------------------------------
X,,,,,,,,,,,,,,......:......,,,,,,,,,,,,,,X--------------------------------------------------------------------------------------------------
X.............,,...........,,.............X--------------------------------------------------------------------------------------------------
X.............,,,,,,,,,,,,,,,.............X--------------------------------------------------------------------------------------------------
X.........................................X--------------------------------------------------------------------------------------------------
X.........................................X--------------------------------------------------------------------------------------------------
X.........................................X--------------------------------------------------------------------------------------------------
X...............,,,,,,,,,,,...............X--------------------------------------------------------------------------------------------------
X...............,.........,...............X--------------------------------------------------------------------------------------------------
X...............,.........,...............X--------------------------------------------------------------------------------------------------
X...,,,,,,,,,...,.........,...,,,,,,,,,...X--------------------------------------------------------------------------------------------------
X...,.......,...,.E....E..,...,.......,...X--------------------------------------------------------------------------------------------------
X...,.......,...,.........,...,.......,...X--------------------------------------------------------------------------------------------------
X...,....E..,...,.........,...,.....E.,...X--------------------------------------------------------------------------------------------------
X...,..W....,...,.........,...,...W...,...X--------------------------------------------------------------------------------------------------
X...,.......,...,,,,,,,,,,,...,.......,...X--------------------------------------------------------------------------------------------------
X...,.......,.................,.......,...X--------------------------------------------------------------------------------------------------
X...,.......,.................,.......,...X--------------------------------------------------------------------------------------------------
X...,,,,,,,,,.................,,,,,,,,,...X--------------------------------------------------------------------------------------------------
X.........................................X--------------------------------------------------------------------------------------------------
X.........................................X--------------------------------------------------------------------------------------------------
X.........................................X--------------------------------------------------------------------------------------------------
X.........................................X--------------------------------------------------------------------------------------------------
XXX,,,,,,,,,,,XXX,,,,,,,,,XXX,,,,,,,,,,,XXX--------------------------------------------------------------------------------------------------
--X...........X-X....K....X-X...........X----------------------------------------------------------------------------------------------------
--X....E......X-X...ttt...X-X....E......X----------------------------------------------------------------------------------------------------
--X...........X-X...t.t...X-X...........X----------------------------------------------------------------------------------------------------
--X,,,XXXXXXXXX-X...ttt...X-XXXXXXXXX,,,X----------------------------------------------------------------------------------------------------
--X...X---------X.........X---------X...X----------------------------------------------------------------------------------------------------
--X.H.XXXXXXXXXXX.E...E...XXXXXXXXXXX.H.X----------------------------------------------------------------------------------------------------
--X...,.,.,.,.,.,.........,.,.,.,.,.,...X----------------------------------------------------------------------------------------------------
--XXXXXXXXXXXXXXXXXXXXXXXXXXXXXXXXXXXXXXX----------------------------------------------------------------------------------------------------
