--------------------------------------------------------------XXXXXXXXXX
--------------------------------------------------------------Xt,EXXt,EX
--------------------------------------------------------------XXXXXXXXXX
--------------------------------------------------------------XXXXXXXXXX
--------------------------------------------------------------Xt,EXXt,EX
--------------------------------------------------------------XXXXXXXXXX
--------------------------------------------------------------XXXXXXXXXX
--------------------------------------------------------------Xt,EXXt,EX
--------------------------------------------------------------XXXXXXXXXX
--------------------------------------------------------------XXXXXXXXXX
--------------------------------------------------------------Xt,EXXt,EX
--------------------------------------------------------------XXXXXXXXXX
------------------------------------------------XXX---------------------
------------------------------------------------X<X---------------------
----------------------------------------XAA---XXAAXXX-------------------
----------------------------------------X+X--X......X-------------------
----------------------------------------X,XXX,,......X------------------
----------------------------------------X...,.,......X------------------
----------------------------------------X,,,,.,...,,,.XX----------------
---------------------------------------X....,.,...,T,...XX--------------
--------------------------------------X.,,,.,,,...,,,.....X-------------
--------------------------------------X.,T,.......,.,.....X-------------
--------------------------------------X.,,,.......,,,,,,,.XXX-----------
-----------------------------XXXXXXXXXX,..........,...,.,H,,X-----------
----------------------------X.........,.,E..,,,...,,,,,,,HXXX-----------
---------------------------X..........,.,...,T,......E,.,HX-------------
---------------------------X........XXX.,...,,,...,,,.,,,HXXX-----------
---------------------------X....:..X--X..,.......,,.,W,.,H,,X-----------
---------------------------X...X+XX---X...,......,,,,,,,,HXXX-----------
---------------------------X...XHW---X.....,......,.T.,H,HX-------------
---------------------------X...XXX--X..E....,.,,,.,,,,,.,HXXX-----------
---------------------------X...X---X........,.,T,.....,H,H,,X-----------
---------------------------X...X--X.....,,,.,.,,,.,,,.,,,.XXX-----------
---------------------------X.E.X--X.....,T,.,.....,T,.....X-------------
---------------------------X...X--X.,,,.,,,.,....E,,,.....X-------------
---------------------------X...X--X.,T,......,............X-------------
---------------------------X...X--X.,,,...E...,.......XXXXX-------------
---------------------------X...X--X...........,......X------------------
---------------------------X.E.X--XX..........XX,,,XX-------------------
---------------------------X...X----XX.......X-X...X--------------------
---------------------------X...X------XXXXXXX--X,,,X--------------------
----------------XXXXXXXXXXXX,,,XXXX------------X...X--------------------
----------------X..................XXXXXXX-----X...X--------------------
---------------X..........................XXX--X,,,X--------------------
---------------X.............................X-X...X--------------------
---------------X.............................X-X,,,X--------------------
---------------X.............................X-X...XXXXX----------------
--------------X..............................X-X.,,.,.,HH---------------
--------------X..........................E....X-X...,.,.HX--------------
--------------X...............................X--XXXXXX..X--------------
--------------X......,,,,,,,,,,,,,,,,..........XXXXXXXX..X--------------
--------------X.....,,,.E..E.....E...,........,....,.....X--------------
--------------X....,,,,..............,,,......,....,.....X--------------
--------------X....,.,,XXXX,,,,,,XXX,,,.,.....,....,....AX--------------
--------------X....,...XXXX,,,,,,XXXX....,....,....XXXXXXX--------------
--------------X....,..XXH,,......,,,XX...,....,...X---------------------
-----------XXXX,,,,,..XX,,,.E..E.,,,,XX..,....,...X---------------------
-----------XXH,....,..X,,.,......,,.,XX..,....,...X---------------------
--------XXXXX.,....,E.XX,,,......,,,,XX..,,,,,,...X---------------------
-------->E,+,.,....,..+,.............,,..,,,.,,...X---------------------
--------XXXXX.,....,..+,....E.ttt....,,E.,,,.,,...X---------------------
-----------XX.,....,..+,.E....tTt.E..,,..,,,.,,...X---------------------
-----------XXHX,,,,,..XX......ttt....,,..,,,,,,...X---------------------
--------------X....,E.XX,,,......,,,,,,..,.....,,,X---------------------
--------------X....,..XX,,,......,,,,,,..,........X---------------------
--------------X....,..L,,.,...E..,,.,XXE.,........X---------------------
--------------X....,..XX,,,......,,H,XX..,........X---------------------
--------------X..E.,..XX............XX...,........X---------------------
--------------X....,..,XXXX,,,,,,XXXX,,,,.........X---------------------
--------------X.....,,,,XXX,,,,,,XXX.,.,..........X---------------------
--------------X......,,...E...E......,,...........X---------------------
---------------X......,,,,,,,,,,,,,,,,...........X----------------------
---------------X.................................X----------------------
----------------X...............................X-----------------------
----------------X.......................E.......X-----------------------
----------------X.............................XX------------------------
----------------X..........................XXX--------------------------
----------------XXXXXXX..................XX-----------------------------
-----------------------X,,,,,,,,,,,,,,,,X-------------------------------
------------------XXXXXX,,,,,,,,,+,,,,,,XXXX----------------------------
-----------------X...............+..........XXX-------------------------
-----------------X...............+.E..........X-------------------------
----------------X.......E..,,,.E.+........ttt.X-------------------------
----------------X..........,T,...+..,,,...tTt.X-------------------------
---------------XX...,,,....,,,...+..,T,...ttt.X-------------------------
--XXXXXXXXX----X,...,T,...E......+..,,,.......X-------------------------
-X.........XX--X,...,,,.......E..+............X-------------------------
-X..,,.......X-X,................+.......E....X-------------------------
X..,..,......X-XX..........XX,,,,+,,,XXX......X-------------------------
XH.,.E,..E...X--X...E.....X-XH...E..HX--XX....X-------------------------
X...,,.......XXXX,,,,,,,XX--XHE.E..EHX----XXXXX-------------------------
X.......................X---XH....E.HX----------------------------------
X++......,,,............X---XHE.AA..HX----------------------------------
X+K+..E..,T,....E.......X---XXXXXXXXXX----------------------------------
X+.+.....,,,.E......,,,.X-----------------------------------------------
X++.................,T,.X-----------------------------------------------
X...,,....E...,,,...,,,.X-----------------------------------------------
X..,..,.......,T,.......X-----------------------------------------------
X..,.E,.......,,,.E.....X-----------------------------------------------
XX..,,..................X-----------------------------------------------
--XX....................X-----------------------------------------------
----XXXXXXXXXXXXXXXXXXXXX-----------------------------------------------
------------------------------------------------------------------------
------------------------------------------------------------------------
------------------------------------------------------------------------
------------------------------------------------------------------------
------------------------------------------XXXXX-------------------------
------------------------------------------X,tEX-------------------------
------------------------------------------XXXXX-------------------------
------------------------------------------XXXXX-------------------------
------------------------------------------X,tEX-------------------------
------------------------------------------XXXXX-------------------------
------------------------------------------XXXXX-------------------------
------------------------------------------X,tEX-------------------------
------------------------------------------XXXXX-------------------------
------------------------------------------XXXXX-------------------------
------------------------------------------X,tEX-------------------------
------------------------------------------XXXXX-------------------------
------------------------------------------XXXXX-------------------------
------------------------------------------X,tEX-------------------------
------------------------------------------XXXXX-------------------------
------------------------------------------XXXXX-------------------------
------------------------------------------X,tEX-------------------------
------------------------------------------XXXXX-------------------------
