--------------------------------X-------X-------X----------------
-------------------------------X.X-----X.X-----X.X---------------
------------------------------X.A.X---X.A.X---X.E.X--------------
-----------------------------X.....X-X.....X-X.....X-------------
----------------------------X.......X.......X,,,,,,,XXX----------
----------------------------XB........................X----------
XXXXXXXXXXXXXXXXXXX---------X.........................X----------
X........E........X---------X...............E.........X----------
X.E...E.....E...E.X-------XXX...................,,,,,.X----------
X.................X-------X:,...................,...,.X----------
X...T...,.........X-------X.,.....,,,...........,.E.,.X----------
X.......t,........X-------X.,.....,B,.....E.....,...,.X----------
X.E.....t.,.E...E.X-------X.,.....,K,...........,,,,,.X----------
X.......tBt.......X-------X.,.....,.,.................X----------
X.....E.t.t.......X-------X.,.....,,,...,,,,,,,.......X----------
X..E.....,t.......X-------X.,..........,.......,......X----------
X.........,.E...E.X-------X.,.........,...,,,...,.....X----------
X.................X-------X.,.........,.:.,B,.W.,.....X----------
XA....E..E......H.X-------X.,.........,...,,,...,.,,,.X----------
X.................X-------X.,..........,.......,..,E,.X----------
XXX,XXXXXXXXX,XXXXX-------X.,...........,,,,,,,...,,,.X----------
--X.X-------XBX-----------X:,.........................X----------
--X.X-------X.X-----------XXX.........................XXXXX------
--X.X-------X.X-------------X.........................L.LEX------
--X.X-XXXXXXX,XXXXXXXXXXXXXXX.....,,,...,,,...........XXXXX------
--X.X-X.,.......:...E.:..EL.L.....,E,...,.,.E.........X----------
--X.X-X.,.................L.L.....,,,...,.,.....,,,,,.X-XXXXXXX--
--X.X-X.,HA.......E.E.E.E.L.L...........,A,.....,.H.,.X-X.....X--
--X.X-X,XXXXXXXXXXXXXXXXXXXXX...........,.,.....,tttt.XXX.....XXX
--X.X-X.X-------------------X...........,.,...........,.,.....,.+
--X.XXX.X---XXXXXXXXX-------X...........,tt.T.........,.,...E.,.+
--X..E..X---XA...::.X-------X.........................,.,.....,.+
--XXXXX.XXXXX..::.>:X-------X...............,,,,,,,...XXX.....XXX
------X.....,.:.>>>.X-------X........B......,.....,...X-X.....X--
------X.XXXXX:>>..>:X-------X.......ttt...B.,.A...,...X-XXXXXXX--
------XHX---X..:>>>:X-------X.......A.t.....,.....,...X----------
----XXX,XXX-X...::>.X-------X.......ttt.....,,,,,,,...X----------
----X.....X-X......BX-------X.........................X----------
----X.E.E.X-XE......XXXXXXX-X.........................XXXXX------
----X.....X-X.......L.L..HX-X....................B....L.LEX------
----X.E.E.X-XXXXX,XXXXXXXLX-X.......,,,,,,,...........XXXXX------
----X.....X-----X.X-----X.X-X.......,.H...,...........X----------
----XXXXX+X---BXX,XXXXX-XLX-X.......,,,,,,,..E..,,,,,.X----------
--------X.X---X......:X-X.X-X...................,...,.X----------
--XXXXXXXLXXX-X<..,,,.X-XLX-X...................,:..,.X----------
--X.+.+.....X-X..B,W,.X-X.X-X...................,...,.X----------
--X.+.+.,,,.X-X.,,,,,.XXXLX-X...,,,...,,,,,,,...,.:.,.X----------
--X.+.+.,<,.X-X.,.,.,.H.,TX-X...,:,...,....,....,...,.X----------
--X.XXXXX,,.X-X.,,,,,.XXX,X-X...,,,...,.A.,.....,,,,,.X----------
--X.X---X..BX-X......EX-X.X-X.........,..,............X----------
--X.X---X.XXXXX,,,XXXXX-XAX-X.........,.,.............X----------
--X.X---X.X-X.,..BX-----X.X-X.........,,..............X----------
--X.X---X.XXX.XXXXX-----X.X-X.,.......,...............X----------
--X.X---X.,:,.X---------X.X-X.,.......................X----------
XXX.X---X.,,,,X-XXXXXXXXX+X-X.,,......................X----------
X..EX---X<...<X-X.,.....,TX-X.,,......................X----------
X.XXX---XXX,XXX-X,XXXXXXX,X-B.,.,.................:...X----------
X.X-------X.X---X.X-----K.X-X.,.,.....................X----------
X.XXXXXXX-X.X---X,X-----X.X-X.,..,....................X----------
X......WX-X.X---X.X-----X.X-X.,..,....................X----------
X.......X-X.X-XXX.XXXXXXX.X-X..,T.,...................X----------
X:.....HX-X.X-X..:.....E..X-X..,..,...................X----------
X...T...X-X.X-X,,,,.XXXXXXX-X..,...,..................XXXXXXXXX--
X.......X-X.X-XB..,HX-------X...,..,..................,.,...E.X--
X.......XXX,XXX...,,XXXXXXXXX...,,,,,.................XXXXXXXXX--
XB............,...,.......+.+...B....................AX----------
XXXXXXX+++XXXXX...,,XXXXXXXXXXXXXXXXX+++++B+XXXXX,XXXXX----------
------X...X---X..AK.X---------------X...A...X---X.X--------------
------X+++X---X,,,,EX---------------X,,,XXXXX---X.X--------------
------X...X---XH.E..X---------------X..:X-------X.X--------------
------X.E.X---XXXXX,X---------------X...XXXXXXXXX.X--------------
------X...X-------X.X---------------X...,.,.,A,.,HX--------------
------XXXXX-------X.XXXXXXXXXXXXXXXXX...XXXXXXXXXXX--------------
------------------X.,...T...........,..BX------------------------
------------------XXXXXXX,XXXXXXX,XXXXXXX------------------------
------------------------X.X-----X.X------------------------------
XXXXXXXXXXXXXXXXXXXXXXXXX,XXXXXXX,XXXXXXXXXXXXXXX----------------
XTB.............................................X----------------
XBB...E.....E................:................A.X----------------
X...................E....E............E...E.....X----------------
X.....ttttt.....E...............+++++...........X----------------
X.....,...,.................B...t...t...........X----------------
X.....,.B.,.....................t...t.........E.X----------------
X..E..,...,.....E...............t...t...........X----------------
X.....,tttt.............E...E...t,,,,.....E.....X----------------
X...............................................X----------------
X.E..A......:......H.................:........A.X----------------
X...............................................X----------------
XXXXXXXXXXXXXXXXXXXXXXXXXXXXXXXXXXXXXXXXXXXXXXXXX----------------
