-----------------------------------------XX,XX.........................................
----------------------------------XXXXXX:X.A.:XXXXXXX..................................
---------------------------------XX:..H..........H.:XX.................................
---------------------------------XA,,,...........,,,AX.................................
---------------------------------X.,,.,..E.E.E..,,,,.X.................................
---------------------------------X...,,,.......,,,...X.................................
---------------------------------X....,,,,.E.,,,,....X.................................
---------------------------------X.....,,,,.,,,,.....X.................................
---------------------------------X.......,XXX,.......X.................................
---------------------------------X...E....XXX...E....X.................................
---------------------------------X.......,,X,,.......X.................................
---------------------------------X.....,,,E.E,,,.....X.................................
---------------------------------X....,,,,EEE,,,,....X.................................
---------------------------------X...,,,.......,,,...X.................................
---------------------------------XA,,,,.........,,,,AX.................................
---------------------------------X,K,,.....A.....,,:,X.................................
---------------------------------XX,....:....:.....,XX.................................
----------------------------------XXXXXXXX,,,XXXXXXXX..................................
-----------------------------------------X.E.X.........................................
-----------------------------------------XLLLX.........................................
-----------------------------------------X...X.........................................
-----------------------------------------X...X.........................................
----------------------------X------------X...X.........................................
---------------------------XXX-----------X...X.........................................
--------------------------XX-XX---------XX,,,X.........................................
------------------------XX.AXE.X-----XXX......XX.......................................
-----------------------X.H..E...X-XXX...........X......................................
----------------------XXA..E.E.,XX...............X.....................................
---------------------XX-X.E...,,......X.....X.....XX...................................
----------------------XXX...E,,......X-X...X-X......X..................................
-----------------------XE.E.,,.......XXX,,,XXX.......X.................................
-----------------------X...,....X..,,,,,.H.,,,,,..X...XX.........XXXXXXXXXXXXX.........
------------------------X.,....X-X,,H.H.....H.,,,X-X....X........X:.,,..E,.,:X.........
-------------------------X.....XXX,............H,XXX.....X.......X...,,.EH,,.X.........
-------------------------X......,,H......A.......,,......X.......X..,,,.,,,,,X.........
----------XX-------------X.....,,....E......E...H.,,.....X.......X,,,XXXEX,,,X.........
----------X-XX-----------X.....,H..................,.....X.......X,,,,...,,,,X.........
-----------XAX----------X..XXX,,..................H,XXX..X.......X..,,...,.,.X.........
-----------X.X----------X..X-X,,...................,X-X..X.......X...,...,,,.X.........
----------X...X---------X.,.X.,H.......E...E.......H,X...XXXXXXXXX...,...,.,.X.........
----------X...XXXXXXXXXXX.,,.,,........>>>>>........,,...,...+E......,...,,,,X.........
---------X....,,.E.....,,.,,,,,H.......>...>.......H,,...,...+.E.E...,...,,.,X.........
---------X..,.XXXXXXXXXXX.,,.,,..E..E..>...>..E..E..,,...,...+.......,...,,.,X.........
---------X.,,,X---------X.....,........>...>........,....XXXXXEXXXXXXX...,,.,X.........
---------X,,,,X---------X..XXX,H.......>>>>>.......HXXX..X...............,,.,X.........
---------X.,,X----------X..X-X,,......E....E.......,X-X..X...............,...X.........
---------X,<,X-----------X.EX..,H.................H,.X...X...............,...X.........
----------XXXX--------X--X.....,...................,.E...X...........XXXXX...XXXXXXXXX.
-------XX------------XX--X......,.....E....E......,....E.X...........X,,,,,...,,,,,,HX.
--X----X:XXX--------X.X--X.......,H.............H,...E...X...........X,HH,,.....,,,,,X.
--XX---X..E.XXXX---X,:X---X....XXX,.H.........H.,XXX....EX...........X,,E,,.....,,.,,X.
-X:.X--X,E,,.,,,XXX.,,X----X...X-X,,,.H.....H.,,,X-X.....X...........XX,,,,.....,,E,,X.
-XEAXX-XE,,..,,.,,....XX----X...X..,,,,,.H.,,,,,..X.....X............XX,,,,.....,,,,,X.
-+H,E.X,.....,,K,,..E..H----X...E....,,,,,,,,,........XX.............X,....E.........X.
-+.,E.,......,,,,.....HXX----X.....E.,W,...,.,.......X...............X,.......E......X.
X+E,E,,..E..E.,,..E...HX------X..E....,.....,.......X................XX,,,E.....,,E,,X.
X:,AXX.,,......E.....,HX-------X....E.............XX.................,,,,,,.....,,,,,,.
XXXX-X,,,,.........E,,HX--------XX,,,XXX,,,X,,,,,X...................,,E.,,E+K+.,E.,,,.
-----X,,,,.......E..,,:X-------XXX,,,X-X,,,X.........................,,A,,,.....,,,,A,.
-----X:..,,.....E..XXXXX-------XH..,,X-X,.,X.........................X,,,,,,,,,,,,,,,X.
----X...E,,......XX-------XXXXXX,,E.EX-X,H,X.........................X,,,,,,,,,,,,,,,X.
----XXXXXXXXX,,,X---------XA...,XXXXXX-X,,LX.........................X.E.........E..EX.
------------X.H.X---------X...,,XXXXXXXXLLLXXXXXXX...................X...............X.
------------X...X-----XXXXX.E...XH.,...........,HX...................X..E....E....E..X.
------------X...X-----XH...,...HXX..E..E....E.E..X...................X..........E...EX.
------------X...X-----X.....XXXXXXX,,,,,,,,,,,,,XX...................XAEH.E.EE.....HAX.
------------X...XXXXXXX.....XXXXXHX,,,,,,,,,,,,,HX...................XXXXXXAXHXAXAXXXX.
------------XH..E....H,E....,E.HXX...,.......,...X.....................................
------------XXXXX,....,...E.,,.EXH.E.,.E.E.E.,..HX.....................................
----------------X,,...,E....,E.EXH....,.....,...HX.....................................
----------------X:XXXHXXXXXXHXXXXH..E.,.....,...HX.....................................
---------------------------------XX,,E,,,,,,E,,,XX.....................................
---------------------------------XX,,,,,,,,,,,,,XX.....................................
---------------------------------H.....,,,.,....AX.....................................
---------------------------------XXXXXXXXWXXXXXXXX.....................................
----------------------------------------XXX............................................
