--------------------X++----------------------------------------------------
-------------------X...X---------------------------------------------------
------------------X,,E,,X--------------------------------------------------
------------------X.....X--------------------------------------------------
------------------X.....X--------------------------------------------------
------------------X,,.,,X--------------------------------------------------
------------------H,,.,HX---XXXXX---------XXXXXAXXXXX---------XXXXXXXXX----
------------------H....HX---XE..X---------XE.E.E.E.EX--------X.........X---
--------XXXXXXX---XXX,XXX---X..EX---------X.........X-------X...........X--
--------XEE,EEX-----X.XXXXXXX,,,XX-XX-----X,,,,,,,,,X-------X...........X--
--------X,,,,,XXXXXXX,X,,,,,,,,,,XXXXXX-XXX,,,,,,,,,XXX-----X.....X.....X--
--------X.,...,E.E.E,.,.,.,.,.,.,.+...X-XH........E...X-----X....X-X....X--
--------K.,...,.A...,.,.,.,H,.,.,.+...X-X.,,,,,,,,,,,.XXXXX-X,,,X---X...X--
--------X.,...,E.E.E,.,.,.,.,.,.,.+...X-X.,.......,.,.,.E.X-XE..X---X...X--
--------X,,,XXXXXXXXXXXXXXXXXXXXXXX...XXX.,,,,,,,,,,,.,...X-X...X---X...X--
--------E.EEX-X...XXEX------X.X---X...,+,..A.E.A.E.A..,...X-X..E,X--X...X--
--------XXXXX-X...XE.EX---XX.AAXX-X...,+,.,,,,,,,,,,,.,.E.X-XE..,EX-XXXXX--
--------------X...XtttX--X.......XX...,+,.,.........,H,...X-X...,.X--------
--------------X...X...XXXH........X...,+,.,,,E,,,,,,,.,.E.X-X.E.,.X--------
--------------X...XXXXXX..,,,,E,,,.,..,+,..A...AE..A..,...X-X...E.X--------
------XXXXX---A,WAX----X..,.,,,,,,..,.XXX.,,,,,,,,,,,.,.E.X-XE..,.X--------
------XE.EX---E.EEX----X..,.,T.E,,..,.X-X.,K,.......,.,...X-X...,.X--------
------X...X---X,,,XXXXXXX.,.,...,,...,X-X.,,,,,E,,,,,.XXXXX-X...,.X--------
------XEAEX-XXX<<<,.....,.,.,...,,....X-XH............X-----X...,.X--------
------XE.EX-XXX.<,,..E..,A,.T.H.,EA...X-XXX,,,,,,,,,XXX-----X...,.X--------
------X,,,X---X..,XXXXXXX.,.,...,,...,X---X.........X-------X...,.X--------
------X,W,X-XHX,,,HX----X.,.,T..E,...,X---X.........X-------X...,.XXX------
------X+++X-X,...,,X----X.,.,...,,..,.X---XE.E.E.E.EX-------X...,.tTX------
------X.E.X-X,..,,,X---X..,,,,,,,,.,,.X---XXXXXXXXXXX-------X,,,XXXXX------
------XX,X--X,.,W,,X---X.H,,,,E,,,.,..X---XXXXX.X-----------X...X----------
------X,.E--X,,...,X----X.........X...X---XXXXX,XXXXX-------X...X----------
------X,.X--X,.,.,.X-----XX...A.XXX...X--X.E.E.E.E.EX------X....X----------
------X,.X--X,..,..X-------XXAXXXXX...XXXE,E,E,E,E,,XXXXXXX.,...X----------
------XE,X--XA....AX---------X--XTt...,............,,........,.:X----------
------X,,X---XX+++XX------------XXX...,...A.A.A.A.H,,.........,.X----------
XXXXX-X,,XXXXXX+++XXXXXXX---------H...,,,,,,,,,,,,,,,..........,X----------
X...X-X,.,,,,,.....,.,,AXX----AXXXX,,,XXXXXXXXX,,,,,XXXXXXXXXXXXX----------
X.E.X-X,.,,,,,E...E,.,,W,A----X..E,..,X-------X.....X----------------------
A,AAX-X,.,,,,,.EE..,.,,AXX----A...,..,X-------X.....X---------XXXXX--------
XAA.X-X,,,XXX,....AXXXXXX----X,..E,..,X-------X.....X---------X...X--------
X,A,X-X,,XX--X,,,,XX---------X,,,,,,,,XXXXXXXXX.....X---------X,,.X--------
XH.HX-X,,EX--X....X----------XX...,EE,,.,.,E,.,......X--------X.,,X--------
X+++X-X,,,X--X,,,,X-----------X...,..,,.,.,.,.,.......XXXXXXXXX,..X--------
XH.HX-X,.,X--X..E.X-----------XEHE,,,,,.,.,.,E,.........,,,A.A,...X--------
X,,,X-X,E,X--X,,,,X-----------X,XXXXXXX,XXXXXXX.........,,,...,...XHHHXXXXX
XH.HX-XX.XX--X....X-----------X.X-----XEXX..XXXX........,,,A.A,...HHHH....X
X,,,X-XX,X---XXXXXX---------XXX.X-----XXXX,,,,,XX,,,,,,,,,XXXXX...HHHH....X
XH.HX-X.,.X----------------X,.,.X--------X,....E,.,E,.,...X---X...HHHH....X
X,,,XX.,,..XXXXXXX--------X.,.,.X--------XX.....,,,,,,,...X---XE.EX,,,,...X
X.E.E,.,.,.,.E.E..X------X,.,.,.X--------X,,........,E,...X---X...X.,.,...X
X....,,...,,..H.E.X-----X.,.,,,,XXXXXXX---X,,,,,....,,,...X---X...X,,,,...X
X.E.E,.,.,.,.E.E.X------X.,,....,......X--X.....,,..,.,...X---X...X.......X
XXXXXX,,+..XXXX,X-------X.,.....,.......X-X,,,,,,.,.,,,...X---XE.EX...,,,,X
----X,,,,,,WX-X.X-------X,,.....,.......X-X.,.,.,.,.,E,...X---X...X...H.,.X
---X.EXXXXX.,XX,X-------X.,..H..,.......X-X,,>,,,,..,,,...X---X...,...,,,,X
---XA,XX---X.+,.X-------X,,.....,.......X-X.>.>.,.,.,.,LLLX---X...XXXXXXXXX
--+E.,X-----XXXX--------X.,.....,.......X-X,,>,,,.,.,,,...X---XE.EX--------
---+X,X-----------------X.,,....,.......X-X.,.,.,.,,,E,...X---X...X--------
----XX------------------X.,.,,,,XX......X-XXXXXXX,,,,,,,,,X---X...X--------
-------------------------X,.,.,.X-X..E..X----XXX,...,..A.AX---X...X--------
--------------------------X.,.,.X-X.....X----X.,,...,,,,,,X---XE.EX----+---
---------------------------X,.,.X-X.E.E.X---X.,.,......A.AX---X...XXXX+XX--
----------------------------XXXXX-X.....X---X.,.,,,,,XXXXXX---X...,....KX--
----------------------------------XE.A.EX---X..,,,,..X--------X...XXXXXXX--
----------------------------------X.....X---X........XX-------X.E.X--------
----------------------------------X.XXX.X---XX......XX--------X..,X--------
----------------------------------XX---XX-----XX..XX----------XXXXX--------
----------------------------------XX---XX-------XX-------------------------
----------------------------------XX---XX----------------------------------
----------------------------------X-XXX-X----------------------------------
----------------------------------XXXXXXX----------------------------------
