------------------------------XXXXXXXXXXXXXXXXXXXXXXXXXXXXXXXXXXXXX------------------------------
------------------------------X-----------------------------------X------------------------------
------------------------------X-----------------------------------X------------------------------
--------------XXXXXXX---------X-----------------------------------X------------------------------
--------------X-----XXXXX----X---------,,,,,,,,,,,,,,,,,,,---------X-----------------------------
--------------X-----,---X----X-------,,-------------------,,-------X-----------------------------
--------------X-----,,,,X----X----,,,-----------------------,,,----X-----------------------------
--------------X--------,X----X--,,-------,,,,,,,,,,,,,,,,------,,--X-----------------------------
--------------X--------,X----X,,-------,,,-------------,-,,------,,X-----------------------------
--------------X--------,X----X,------,,--,-------------,---,,-----,X-----------------------------
--------------X-----,,,,X---X,--,,,,,-----,-----------,------,,,,--,X----------------------------
--------------X-----,---X---X,--,,,,------,-----------,------,,,,--,X----------------------------
XXXXXXXXXXX---X-----XXXXX---XXX-,-,,------,-----------,------,-,,--XX----------------------------
X---------X---X---XXX----------XXXXX------,-----------,------XXXXXX-----------XXXXXXX------------
X,,,,,,,,,X---X---X-XXXXXXXXXXXXXXXX------,-----------,------XXXXXXXXXXXXXXXX-X----,XX-----------
X---------X---X---X-X---,,,,,-----,,------,-----------,------,------,,,,,---X-X----,-,X----------
X---------XXXXX---X-X---,,,,,-----,,-------,---------,-------,------,,,,,---X-X----,-,X----------
X-----------------X-X---,,,,,-----XX-------,---------,-------X------,,,,,---X-X----,,,X----------
X-----------------X-X,,,,,,,XX--XXXX-------,---------,-------XXX---XX,,,,,,,X-X---XXXX-----------
X-----------------X-X,,,,---XX----XX-------,---------,-------X----X-X---,,,,X-X---X----XXXXXXXXX-
X---------XXXXX---X-X,,,,----XX---XX-------,---------,-------,----XX----,,,,X-X---X----X-------X-
X---------X---X---X-X,,,,----,X---,,--------,-------,--------,---XX-----,,,,X-X---X----X-------X-
X---------X---X---XXX,,,,----,X---XX,,------,-------,-----,,-X---XX-----,,,,XXX---X----X-------X-
XX,,,,,,,XX---X---,-,--------,XXXXXXX,-----,,,,,,,,,,-----,XXXXXXXX---------,-,---X----X-------X-
-X-------X----X---,-,---------XXXXXXX,-----,,,,,,,,,,-----,XXXXXXXX---------,-,---X----X-------X-
-X-------X----X---,-,---------,-----,,------,-,---,-,------,------,---------,-,---X----X-------X-
-X-------X----X---,-,---------,-----,,------,-,---,-,------,------,---------,-,---X----X-------X-
-X-------X----X---,-,---------XXXX--,,-----,,-,---,-,------,---XXXX---------,-,---X----X-------X-
-X-------X----X---,-,--------,XXXXXXX,-----,,,,,,,,,,-----,XXXXXXXX---------,-,---X----X-------X-
-X-------X----X---,-,--------,X---XX,,------,-------,-----,,-X---XX---------,-,---X---XX,,,,,,,XX
-X-------X----X---XXX,,,,----,X---,,--------,-------,--------,---XX-----,,,,XXX---X---X---------X
-X-------X----X---X-X,,,,-----X---,,-------,---------,-------,---XX-----,,,,X-X---X---X---------X
-X-------X----X---X-X,,,,----XX---XX-------,---------,-------X----XX----,,,,X-X---XXXXX---------X
-XXXXXXXXX----X---X-X,,,,---XX--XXXX-------,---------,-------XXX--X-X---,,,,X-X-----------------X
-----------XXXX---X-X,,,,,,,XX--XXXX-------,---------,-------XXX---XX,,,,,,,X-X-----------------X
-----------X-,----X-X---,,,,,-----XX-------,---------,-------X------,,,,,---X-X-----------------X
------XXXXX-,,----X-X---,,,,,-----,,-------,---------,-------,------,,,,,---X-X---XXXXX---------X
------X-t+,-,,----X-X---,,,,,-----XX------,-----------,------X------,,,,,---X-X---X---X---------X
------XXXXX,,,----X-XXXXXXXXXXXXXXXX------,-----------,------XXXXXXXXXXXXXXXX-X---X---X,,,,,,,,,X
-----------XXXXXXXX-----------XX,,,,------,-----------,------,,,,-XX--------XXX---X---X---------X
----------------------------XX--,-,,------,-----------,------,-,,---X---XXXXX-----X---XXXXX,XXXXX
----------------------------X---,,,,------,-----------,------,,,,---X---X---,-----X------->>X----
----------------------------X,------,,----,-----------,----,,------,X---X,,,,-----X--------------
----------------------------X,--------,--,-------------,--,--------,X---X,--------X--------------
-----XXXXXXXXXX--------------X,,-------,,,-------------,,,-------,,X----X,--------X--------------
-----X,,-,-,,,X--------------X--,,-------,,,,,,,,,,,,,,,-------,,--X----X,--------X--------------
-----X,,-,-,,,XXX------------X----,,,-----------------------,,,----X----X,,,,-----X--------------
-----X,,-,-,,,t-X------------X-------,,-------------------,,-------X----X---,-----X--------------
-----X,,-,-,,,XXX------------X---------,,,,,,,,,,,,,,,,,,,---------X----XXXXX-----X--------------
-----XXXXX,,,,X--------------X-------------------------------------X--------XXXXXXX--------------
---------XXXXXX---------------X-----------------------------------X------------------------------
------------------------------X-----------------------------------X------------------------------
------------------------------XXXXXXXXXXXXXXXXXXXXXXXXXXXXXXXXXXXXX------------------------------
