XXXXXXXXXXXX-------------------------------
X.E..,.t...X---------XXXXXXXXXXXXXXXXX-----
X....,.t...X---------X.,.............X-----
X.E..,.t...X---------XW,.........<..HX-----
X....,.t...X----XHX--X.,......A......X-----
XXXXXXXXXXXX---X...X-XXXXX+++XXX+++XXX-----
--------------X.....XXXXXX,,,XWX,,,XX------
-------------X..<.....,.............X------
------------X.........,.,,,,,,,,,,,.X------
-----------X..........,.,.........,.X------
----------X..A..XXXXXXX,,.........,,X------
---------X.....X------X:,.........,WX------
--------X.T...X-------X.,.........,.X------
-------X.....X-------X.,.,........,.X------
------X,....X---X---X...,.,.......,.XXXXX--
------XW...X---XWX-X.H...,.,......,.,.,WX--
------X,,,X---X:,.X.......,.,,,,,,,.,...X--
-----X....X---X,,..,.......,.A......,...X--
----X.,,,.X--X..,,,.,.......XXX,,,XXX...X--
---XXA,.,.X--X.,...,.,...H.X--X...X-X...X--
---X,.,.,.XXX.,.....,.,...X---X...X-X...X--
---X,A,.,.,.,.,......,.,.X----X...X-XT..X--
---X,.,.,.,.,.,...H...,.X-----X...X-X...X--
---X,W,E,.,.,.,..HWH...,.X----X...X-X...X--
---X,.,.,.,.,.,...H.....,.XXXXX...X-X...X--
---X,A,.,.,.,.,.........,.,.......X-X...X--
---X,.,.,.XXX.,.........,.,.....H.X-X...X--
---XXA,.,.X-X.A,.......,E.,......X--X...X--
----X.,,,.X--X..,,,,,,,..,....XXX---X...X--
-----X....X--X...........,....XX----X...X--
------X,,,X---X,,,,,,,XXX.......XXXXX,,,X--
------X...X---X.......X--X......,.H.....X--
------X...XX>>X.......X---XX...,..,,,,,..X-
------X...XX+XX.......X-----XX.,.,.....,.X-
------X...XX,XX...A...X-------X.,.....<.,.X
------X.......,.......X-------X.,.......,.X
------X,......,.......X-------X,,...W...,.X
------X:......,.H.....X-------XW,.......,.X
------XXXXXXXXXXXXX,,,X-------X.,.......,.X
------------------X...X-------X.,....E.,.X-
------------------X...X-------X.,.....,..X-
------------------X<...X----XX,..,...,..X--
------------------X.....XXXX...,..,,,..X---
------------------X,,....H.....,...A...X---
------------------X,:..T........XXXXXXX----
-------------------X..........XX-----------
--------------------XXXXXXXXXX-------------
