------------------------------------------------XXXXX----------------------------------------------------------------------------------------
------------------------------------------------X---X----------------------------------------------------------------------------------------
------------------------------------------------X,,,X----------------------------------------------------------------------------------------
------------------------------------------------X,,,XX---------------------------------------------------------------------------------------
------------------------------------------------X-----XXXXX----------------------------------------------------------------------------------
------------------------------------------------X+,----,---XXXXX----------------------------X>>----------------------------------------------
------------------------------------------------X+,---,----,,--X-----X---------------------X---X---------------------------------------------
------------------------------------------------X,,---X--,,-,,XXX--XX-X--------------------X---X---------------------------------------------
------------------------------------------------X----X-XXX,,-----XX---,X-------------------X---X---------------------------------------------
------------------------------------------------X,,,X---X-------------,,X-------------------XLX----------------------------------------------
------------------------------------------------X,,,X---X-------------,,-X---------------XXXXLXX---------------------------------------------
------------------------------------------------X---X--X-------------,-,-X------------XXX-------X--------------------------------------------
------------------------------------------------XXXXX--X------------,,,--X-----------X-----------XX------------------------------------------
------------------------------------------------------X------------,,-----X----------X-------------X-----------------------------------------
------------------------------------------------------X------------,,-----X---------X---------------X----------------------------------------
------------------------------------------------------X----------,,,,-----X--------X----------,,,---X----------------------------------------
-----------------------------------------------------X---------,,--,,,---,X--------X--------,,---,,-X----------------------------------------
-----------------------------------------------------X----,,,,,---,,--,,-,-X-------X--------,-----,-X----------------------------------------
-----------------------------------------------------X--,,-,,,----,-,,,,,-,X-------X-,,,,--,-------,X----------------------------------------
------------------------------------------------------X,--,---,,,--,----,,--X------X,,,,,,-,-------,X----------------------------------------
-------------------------------------------------------X-,-------,-,--------X------X,-,,,,-,-------,X----------------------------------------
--------------------------------------------------------X---------,-,--------X-----X,,-,,,--,-----,-X-----XXXXXX-----------------------------
--------------------------------------------------------X---------,-,--------X-----X,,-,,,--,,---,,-X-----X---,-XX---------------------------
-------------------------------------------------------X----------,,--------X------X,,--------,,,---X-----X---,,,-XX------XX-----------------
-------------------------------------------------------X---------,-,--------X------X,,--------------X-----X---,,,--,X----X--XX---------------
-------------------------------------------------------X---------,,-,------X-------X,,------------XXX-----X---,,,-,--X---X---X---------------
--------------------------------------------------------X----------,-,-----X--------X-,,,---XXXXXX--------X-------,---X-X----X---------------
--------------------------------------------------------X---------,-,----,X----------X---XXX--------------X----,,,,----X-+--X----------------
-------------------------------------------------------X----------,-,-,,,X------------X,X-----------------X----,-,,-----+-XX-----------------
-------------------------------------------------------X---------XXXX,---X-------XXXXXX-X-----------------X----,,,,------+X------------------
------------------------------------------------------XX-------XX----X,,XX------X-------X-----------------X--,-,--,-------X------------------
--------------------------------------------------------XX,,,,X------X--,-XX----X-XXXXXX-------------------X-,,,--,--------X-----------------
---------------------------------------------------------X,,,X--------XXX---X--X,-X------------------------X-,,,--,--------X-----------------
----------------------------------------------------------X,X--XXX--XXX--X-,X--X-X------XXXXXXXXXXXXXXXXX--X-,,----,XXX----,XX---------------
----------------------------------------------------------X,X--X,X--X,X---X-X--X-X------X---------------X--X--,,,--X--X--,,---XX-------------
-------------------------------------------------------XXXX,XXXX,XXXX,XXX-X,X--X,-XX----X--,,,-,,,-,,,--X--X--,,,XX----X,-,,,---X------------
-------------------------------------------------------X----------------X-X--X--XX--XX--X--,-,-,-,-,-,--X--X--,XX----XX-,,---,,--X-----------
-------------------------------------------------------X----------------X-X--X----XX--X-X--,-,-,-,-,-,--X--X--X----XX-,,-------,-X-----------
-------------------------------------------------------X----------------X--X-X------X--XX--,-,-,-,-,-,--X--XXX---XX-,,----------,-X----------
-------------------------------------------------------X,,,-,,,-,,,-,,,-XXX-X-X-----X--XX--,-,-,-,-,-,--X--X----X-,,------------,--X---------
-------------------------------------------------------X,-,-,-,-,-,-,-,-,-X-X-X----X---LL--,-,-,-,-,-,--X------X-,---------------,-X---------
-------------------------------------------------------X,-,-,-,-,-,-,-,-XXX-X-X---X--XXXX--,-,-,-,-,-,--X-----X-,----------------,--X--------
-------------------------------------------------------X,-,-,-,-,-,-,-,-X---X,X--X,,X---X--,-,-,-,-,-,--X----X-,------------------,--X-------
-------------------------------------------------------X,,,-,,,-,,,-,,,-X---X-X--X--X---X--,-,-,-,-,-,--X---X-,--------------------,--X------
-------------------------------------------------------X----------------X---X-X--X--X---X--,-,-,-,-,-,--X--X-,----------------------,--X-----
-------------------------------------------------------X----------------X---X,X---X-X---X--,,,-,,,-,,,--X-X-,------------------------,--X----
-------------------------------------------------------X----------------X---X-X---X,X---X---------------X-X-,-------------------------,-X----
-------------------------------------------------------X----------------X---X,X---X+X---XXXXXXXXXXXX,,,XX-X-,--------------------------,-X---
-------------------------------------------------------X----------------X---X-X--XX,XXX------------X---X---X,--------------------------,-X---
-------------------------------------------------------XXXXXXXXXLLXXXXXXX---X,X--X-----XX----------X---X---X,--------------------------,-X---
--------------------------------------------------------------XXLLXXXXXXXXXXX-XXXX,,,,,-X----------X---X---X-,--------------------------,-X--
-------------------------------------------------XX---------XX--------------X-,X-,,,,,,-X---------XX,,,XX--X-,--------------------------,-X--
-------------------------------------------------X-XX------X----------------XX-,-,------XXXX---XX-X-----X---X,--------------------------,-X--
-------------------------------------------------X---XXXX--X----------------XXXX-,,,,,,-,-XXXXXXXXX-----XXXXX,--------------------------,-X--
-------------------------------------------------X---,,-X-X----X,,XXXXXXX,,XX--X-,,---,-,-,-------,-----,--XX,--------------------------,-X--
-------------------------------------------------X---,,-X-X---XX--X-----X--X---X-,,,,,,-,-XXXXXXXXX-----XX--XX--------------------------,-X--
--------------------------------------------------X--,,-XX----XX,,XXXXXXX,,XXXXX-,------XXXX---XX-X-----XX--XX,-------------------------,-X--
--------------------------------------------------X--,,-XX---X-X--------------XXXX-----X----------XXXXXXX-X--XX-,,,,,,,,,,,,,,,,--------,-X--
--------------------------------------------------X--,,-XX--XXX---------------X--X----X--XXXXXX-----------X,,XX,-,,,,,,,,,,,,,,---------,-X--
-------------------------------------------------X---,,-,,--,-,---------------X--XXX,X--X------XX--------X----XX--,,,,,,,,,,,,----------,-X--
-------------------------------------------------X---,,-,,--,-,---,,,,,,,,,---XX---X-X-X---------X-------X-----XX--,,,,,,,,,,-----------,-X--
-------------------------------------------------X---,,-XX--XXX---,,,,,,,,,---,-XXXX,XXX---------X---XX-X--,,,,,X---,,,,,,,,-------------,-X-
--------------------------------------------------X--,,-XX--X-X---,,----,,,---,----,-,-,---------XXXXXXX,--,,,,,XX--X,,,,,,XX------------,-X-
---------------------------XX---------------------X--,,-XX--X-X---,,,,,,,,,---,---,---,,---------,,-,-,-,--,,,--XX-XX------XX-------------,X-
-----------------------XXXX--XX-------------------X--,,-XX--XXX---,,,,,,,,,---,-XXXXXXXX---------,,-,-,,,--,,,,-X-X--X,,,,X-X-------------,-X
--------------------XXX--------X-----------------X---,,-,,--,-,---,,,,,,,,,---XX-------X---------XXXXXXX,--,,-,-X----X,,,,X-X--------------,X
------------------XX,-----------XX---------------X---,,-,,--,-,---------------X---------XX-----XX----XX-X--,,,,-X---X------X-XX------------,X
----------------XX--,-------------XX-------------X---,,-XX--XXX---------------X-------XXXXX,,,XXXXX------X-----X----X-------X--X-----------,X
--------------XX---,----------------X-------------X--,,-XX---XX---------------X--XXXXXX---,,,,,---XXXXX--X----X-----X-,,-,,,X---X----------,X
------------XX-----,-----------------XX-----------X--,,-XX---X-X,,XXXXXXX,,XXXX--X-t-,,,,,,,,,,,,,,,t-X---X,,X------X-,,-,,,-XX--X--------,-X
-----------X-------,-------------------X----------X--,,-X-X---XX--X-----X--X-----X-t-,,,-,,,,,,,-,,,t-X---X,,X-----XX-,,-,,,-,-X-X--------,-X
-----------X-------,--------------------XX-------X---,,-X-X----X,,XXXXXXX,,XX----X-t-,,,-,,,,,,,-,,,t-X---X--X----X,,-,,-,,,-,-X-X--------,-X
----------X--------,----------------------X------X---,,-X--X----------------X----X-t-,,,-,,,,,,,-,,,t-X---X,,X----X,,-,,-,,,-,-X-X--------,-X
---------X---------,----,,,,,,-------------XX----X---XXXX--X----------------X----X-t-,,,,,,,,,,,,,,,t-X---X,,X---X--X-,,-,,,-,-X-X--------,-X
---------X--------,-----,---,,---------------XX--X-XX-------XX--------------X----XXXXXX---,,,,,---XXXXX---X-,X---X,-X-,,-,,,-XX--X--------,X-
--------X---------,-----,,,,,,-----------------X-XX-----------XX,,XXXXXXXXXXX---------X---,,,,,---X-------X,,-XXX,-XX-,,-,,,-X--X--------,-X-
-------X----------,-----------------------------XX-----------XXX,,XXXX----------------X---,,,,,---X-------X-,-,,,-,X-X------X--X---------,-X-
-------X----------,-------------------------------X-------XXX---------XXXX--------X---X---,,,,,---X--XX----XX,,,,,XXXXXXXXXXXXX----------,-X-
------X-----------,-------------------------------X-------X----ttt-------X-------XX---X---,,,,,---X--X-XXX---XXXXX-X-XXXXXXXX-----------,-X--
-----X-----------,--------------,,,,,,------------,X------X-,,,-tt--,,,--X------X--X---X--,,,,,--X--X-----XXX------X--------------------,-X--
-----X-----------,--------------,---,,------------,X------X-,-,-----,-,--X-----X---X---X--,,,,,--X--X--------XXX---X,------------------,--X--
----X------------,--------------,,,,,,------------,X------X-,-,-----,-,--X----X-----X---X,,,,,,,X---X-----------XX-X,------------------,-X---
---X-------------,-------------------------------,-X------X-,-,-----,-,--X---X------X----X,---,X---X-------------X--X,--------------,,,--X---
---X-------------,-------------------------------,--X-----X-,,,-----,,,--X--X--------X----X,,,X----X-------------X--X-,--------,,,,,--XXX----
--X--------------,-------------------------------,--X-----X--------------X-X---------X----X---X---X--------------X---X-,,,,,,,,--XXXXX-------
-X--------------,--------------------------------,--X-----Xttt-------ttt-XX-----------XXXXX,,,XXXXX--------------X----XXXXXXXXXXX------------
-X--------------,--------------------------------,--X-----X-tt--,,,---tt-XX--------------------------------------X---------------------------
X---------------,---------,,,,,,-----------------,---X----X-----,-,------X---------------------------------------X---------------------------
X---------------,---------,---,,-----------------,---X-----X----,-,-----XX----------------------------------------X--------------------------
X---------------,---------,,,,,,-----------------,---X------X---,-,----X-X----------------------------------------X--------------------------
-X--------------,-------------------------------,----X------X---,,,---X--X----------------------------------------X--------------------------
-X-------------,--------------------,,,,,,------,-----X------X-------X--X-----------------------------------------X--------------------------
-X-------------,--------------------,---,,------,-----X-------XXXXXXX---X------,,,--------------------------------X--------------------------
-X-------------,--------------------,,,,,,------,-----X-----------------X----------------,,,----------------------X--------------------------
--X------------,--------------------------------,------X---------------X------------------------------------------X--------------------------
--X------------,--------------------------------,------X---------------X-----------------------,,,----------------X--------------------------
--X-----------,---------------------------------,------X---------------X------------------------------,,,---------X--------------------------
--X-----------,-,,,,,,------,,,,,,--------------,------X---------------X------------------------------,,,---------X--------------------------
---X----------,-,---,,------,---,,-------------,--------X-------------X-------------------------------------------X--------------------------
---X----------,-,,,,,,------,,,,,,-------------,--------X-------------X-------------------------------------------X--------------------------
---X----------,--------------------------------,--------X-------------X-------------,,,----------,,,--------------X--------------------------
---X----------,--------------------------------,--------X------------X---------------------------,,,---------------X-------------------------
----X--------,---------------------------------,---------X-----------X---------------------------------------------X-------------------------
----XXXXX----,---------------------------------,---------X-----------X--------,,,--------,,,-----------------------X-------------------------
---------XXXXXXXX------------------------------,---------X----------X-------------------------------,,,------------X-------------------------
-----------------XXXXXX------------------------,---------X----------X-------------------------------------,,,------X-------------------------
-----------------------XXXXXXX----------------,-----------X---------X---------------,,,-------,,,---------,,,------X-------------------------
------------------------------XXXXXXX---------,---------,,XXX-------X----------------------------------------------X-------------------------
-------------------------------------XXXXXX---,---,,,,,,-----XXXX--X----------------------,,,----------------------X-------------------------
-------------------------------------------XXXX,,,---------------XXX-----------------------------------------------X-------------------------
----------------------------------------------X--------------------,------------,,,--------,,,-------,,,--,,,------X-------------------------
---------------------------------------------X---------------------,-----,,,---------------,,,---------------------X-------------------------
---------------------------------------------X----------------------,----------------------------------------------X-------------------------
----------------------------------------XXXXX-----------------------,---------------,,,--------,,,-----------------X-------------------------
----------------------------------------X---,-----------------------,----------,,,--------------------,,,-----------X------------------------
----------------------------------------X---,-----------------------,----------------------,,,----------------------X------------------------
----------------------------------------X---,-----------------------,-----------------------------------------------X------------------------
----------------------------------------XXXXX------------------------,----------------------------------------------X------------------------
--------------------------------------------X------------------------,----------------------------------------------X------------------------
--------------------------------------------X------------------------,-----------------------,,,--------------------X------------------------
--------------------------------------------X------------------------,-------------,,,------------------------------X------------------------
-------------------------XX-----------------X-------------------------,--------------------------------------------X-------------------------
------------------------X--XX--------------X--------------------------,-------------------------------------------X--------------------------
------------------------X----XX------------X--------------------------X-------------------,,,--------------------X---------------------------
-----------------------X-------XX----------X--------------------------XXX-----------------,,,-------------------X----------------------------
----------------------X----------X---------X--------------------------X--XX-------------------,,,--------------X-----------------------------
----------------------X----------X---------X-------------------------X-----X----------------------------------X------------------------------
---------------------X-----,,,,,-X---------X-------------------------X------XX-------------------------------X-------------------------------
--------------------X------,,,,,-X---------X-------------------------X--------X-----------------------------X--------------------------------
-------------------X--------------X--------X-------------------------X---------XX-------------------------XX---------------------------------
-------------------X--------------X--------X------------------------X------------XX----------------------X-----------------------------------
------------------X---------------X---------X-----------------------X--------------X--------------------X------------------------------------
------------------X---------------X---------X-----------------------X---------------XX-----------------X-------------------------------------
------------------X---,,,,--------X---------X-----------------------X-----------------XX--------------X--------------------------------------
------------------X---,,,,--------X---------X----------------------X--------------------XXX----------X---------------------------------------
------------------X----------------X--------X----------------------X-----------------------XXX------X----------------------------------------
------------------X-----------,,,,-X--------X----------------------X--------------------------XXX--X-----------------------------------------
-------------------X----------,,,,-X--------X----------------------X-----------------------------XX------------------------------------------
-------------------X---------------X---------X--------------------X--------------------------------------------------------------------------
-------------------X---------------X---------X--------------------X--------------------------------------------------------------------------
-------------------X---------------X---------XX-------------------X--------------------------------------------------------------------------
-------------------X-----,,,,-------X------XX--,,-----------------X--------------------------------------------------------------------------
-------------------X-----,,,,-------X---XXX------,---------------X---------------------------------------------------------------------------
-------------------X----------------X-XX--,,------,,-------------X---------------------------------------------------------------------------
-------------------X------------,,,,XX-----,,-------,------------X---------------------------------------------------------------------------
-------------------X------------,,,,-------,,--------,,----------X---------------------------------------------------------------------------
-------------------X---,,,,----------------,,----------,,-------X----------------------------------------------------------------------------
--------------------X--,,,,----------------,,------------,------X----------------------------------------------------------------------------
--------------------X--------,,,,,------------------------,,----X----------------------------------------------------------------------------
--------------------X--------,,,,,-----,-----------,--------,---X----------------------------------------------------------------------------
--------------------X-----------------,-,---------,-,--------,,X-----------------------------------------------------------------------------
--------------------XX-----------------,,----,-----,-,--------XX-----------------------------------------------------------------------------
----------------------XX---------------,,---,-,-----,,,-----XX-------------------------------------------------------------------------------
------------------------XX-------------,,----,,----------XXX---------------------------------------------------------------------------------
--------------------------XXX----------------,,--------XX------------------------------------------------------------------------------------
-----------------------------XX--------------,,------XX--------------------------------------------------------------------------------------
-------------------------------XX-----------------XXX----------------------------------------------------------------------------------------
---------------------------------XXX------------XX-------------------------------------------------------------------------------------------
------------------------------------XX-------XXX---------------------------------------------------------------------------------------------
--------------------------------------XX---XX------------------------------------------------------------------------------------------------
----------------------------------------XXX--------------------------------------------------------------------------------------------------
