----------XXXXX-XXXXX-------
--XXXXXXXX....X-XA...X------
XX.....,......X:X.....X-----
X......,......,.,......X----
X.....,.......,.,.......X---
X.....,.......,.,.......X---
X...XXXXX,,,,,,.,,,,,,XXX---
X.W.X---:............:X-----
X...X-XXX,,,,,,,,,,,,,XXX---
X.<.X-X.,...,,,,,,,,,...X---
X<<<X-X.,..,,,,,,,,,,,..XXX-
-XXX--X.,.,,.........,,.,,,>
------X.,.,,.........,,.,E,>
------X.,.,,.........,,.,,,>
------X.,.,,.........,,.,..X
------X.,..,,,,,,,,,,,..XXX-
------X.,...,,,,,,,,,...X---
------XXX,,,,,,,,,,,,,XXX---
--------:............:X-----
------XXX,,,,,,.,,,,,,XXX---
------XA......,.,.......X---
------X.......,.,.......X---
-------X......,:,.....XX----
-------:X.....XXX....X------
---------X....X-X....X------
----------X,XXX-XXX,X-------
----------X.X-----X.X-------
----------X.X-----X.X-------
----------X..XXXXX..X-------
-----------X.,.H.,.X--------
------------XXXXXXX---------
