XXXXXXXXXXXXXXXXXXXXXXXXXXXXXXXXXXX
X................................,X
X.,,,,,,,,,,,,,,,,,,,,,,,,,,,,,,,,X
X.,.............,,,.............,,X
X.,.X,,XX......,XXX.......X,,XX.,,X
X.,.,...,,,....,X-X.......,...,.,,X
X.,.,.<.,,,....,XXX.......,.<.,.,,X
X.,.X..XX.................X..XX.,,X
X.,.X,,XX....,............X,,XX.,,X
X.,..........,......,......,,...,,X
X.,..........,,...,,,......,,...,,X
X.,.......,..,,.,,..,..,,.......,,X
X.,.......,,,,.,...,.,,,.,......,,X
X.,.......,..,.....,,..,,.......,,X
X.,........,..,,,,,,..,.,.......,,X
X.,.,,,....,..,..A.,...,....,,,.,,X
X.,,XXX....,..,.,,,.,...,,.,XXX.,,X
X.,,X->...,...,H,W,H,.....,,X-X.,,X
X.,,XXX..,....,.,,,.,....,.,XXX.,,X
X.,.......,...,,.A.,....,.......,,X
X.,........,....,,,....,........,,X
X.,.......,............,........,,X
X.,.....,,...........,.,........,,X
X.,..,,,,,,,,,,,,..,,,,.........,,X
X.,..,,..........,,E..,.........,,X
X.,.,,,,........................,,X
X.,.X,,XX................,X,,XX.,,X
X.,.,...,.......,,,....,,,,...,.,,X
X.,.,.<.,......,XXX....,,,,.<.,.,,X
X.,.X..XX......,X-X......,X..XX.,,X
X.,.X,,XX......,XXX.......X,,XX.,,X
X.,.............................,,X
X.,,,,,,,,,,,,,,,,,,,,,,,,,,,,,,,,X
X,,,,,,,,,,,,,,,,,,,,,,,,,,,,,,,,XX
XXXXXXXXXXXXXXXXXXXXXXXXXXXXXXXXXX-
