XXXXXXXXX
X-------X
X-------X
X-------X
X,,,,,,,X
X-------X
X-------X
X-------X
XXXXX,XXX
----X-X--
----X-X--
----X-X--
XXXXX,XXX
X-------X
>-------X
>-------X
>-------X
X-------X
X-------X
X-------X
XXXXXXXXX
---------
---------
