XXXXXXXXXXXXXXXXXXXXXXXXXXXXXXXXXXXXXXXXXXXXXXXXXXXXXXXXXXXXXXXXXXXXXXXXXXXXXXXXXXXXXXXXXXXXXXXXXXXXXXXXXXXXXXXXXXXXXXXXX
X.......................................................................................................................X
X.......................................................................................................................X
X.......................................................................................................................X
X.......................,,,,,,,,,,,,,,,,,,,,,,,,,,,,,,,,,,,,,,,,,,,,,,,,,,,,,,,,,,,,,,,,,,,,,,,,,.......................X
X......................,.........................................................................,......................X
X.....................,...........................................................................,.....................X
X....................,.............................................................................,....................X
X...................,...............................................................................,...................X
X..................,.................................................................................,..................X
X.................,..................................,,,,,,,,,,,,,....................................,.................X
X................,...................................,H.........,,.....................................,................X
X...............,....................................,...<.<.<.W,,......................................,...............X
X..............,.....................................,.A.......A,,.......................................,..............X
X.............,.....................................XXX....<....XXX.......................................,.............X
X............,.....................................X---X.......X---X.......................................,............X
X...........,.......XXXXX.........................X-----X..:..X-----X...........................XXXXX.......,...........X
X..........,.......X-----X........................X-----X.....X-----X..........................X-----X.......,..........X
X.........,.......X-X-----X.:.................:...X-----H,,,,,X-----X...:...................:.X-----X-X.......,.........X
X........,.......X-X.X----X........................X---X.,...,.X---X..........................X----X.X-X.......,........X
X.......,.......X-X.:.X---X,,,,,,,,,,,,,,,,,,,,,,,,,XXX,,,,,,,,,XXX,,,,,,,,,,,,,,,,,,,,,,,,,,,X---X.:.X-X.......,.......X
X......,........X--X.W.X--X........................E..............E...E.......................X--X.E.X--X........,......X
X.....,...E.E...X---X.E.X-X.....................E.E................E.E........................X-X.E.X---X.........,.....X
X....,.....E....X----X.E.X.......................E..................E..........................X.E.X----X..........,....X
X...,....E.E.E..X-----X.,.......................................................................,.X-----X...........,...X
X...,............X-----X.........................................................................X-----X............,...X
X...,.............XXXXX...........................................................................XXXXX.............,...X
X...,...............,...............................................................................,...............,...X
X...,.............:.,...............................................................................,.:.............,...X
X...,...............,...............................................................................,...............,...X
X...,...............,...............................................................................,...............,...X
X...,...............,...............................................................................,...............,...X
X...,...............,..................................,,,,,,,,,,,..................................,...............,...X
X...,...............,..................................,,.......,,..................................,...............,...X
X...,...............,.....................,,,,,,,,,,,,,,,.......,,,,,,,,,,,,,,,.....................,...............,...X
X...,...............,...................,,.............,,.......,,.............,,...................,...............,...X
X...,...............,.....:............,...........H...,,.......,,...............,..................,...............,...X
X...,...............,.................,................,,.......,,....H........H.,..................,...............,...X
X...,...............,...............W.,....H...........,,.......,,..........H.....,.W...............,...............,...X
X...,...............,..............A.,...........E.....,,.......,,................,.................,...............,...X
X...,...............,................,........H........,,.......,,.......H.....E..,.................,...............,...X
X...,...............,...............,..................,,.......,,.................,................,...............,...X
X...,...............,...............,..........,,,,,,,,,,.......,,,,,,,,,,,........,................,...............,...X
X...,...............,...............,...H....,,........,,.......,,.........,,.......,...............,...............,...X
X...,...............,...............,.......,..........,,,,,,,,,,,...........,,.....,...............,...............,...X
X...,...............,..............,.......,...................................,....,...............,...............,...X
X...,...............,..............,.......,..................................W,..H.,...............,...............,...X
X...,...............,..............,..H...,....................................,....,...............,...............,...X
X...,...............,..............,.....,......................................,...,...............,...............,...X
X...,...............,..............,.....,......................................,...,...............,...............,...X
X...,...............,..............,.....,......................................,...,...............,...............,...X
X...,...............,..............,.....,......................................,.H.,...............,...............,...X
X...,...............,..............,....,.......................................,...,...............,...............,...X
X...,...............,..............,.H..,.....,,,,.....................,,,......,...,...............,...............,...X
X...,...............,..............,....,....,...,,...................,,,,......,...,...............,...............,...X
X...,...............,..............,....,....,.WA,XW.................,,.AW,.....,...,...............,...............,...X
X...,...............,..............,....,....,..,,XXX,,,XXX+++XXX,,,XXX,,A,.....,...,...............,...............,...X
X...,...............,..............,....,....,,,,.XXX,,,XXX,,,XXX,,,XXX.,.,.....,.H.,...............,...............,...X
X...,...............,..............,....,.....,XXX........,.E.,.......EXX,......,...,...............,...............,...X
X...,...............,..............,....,......X-X.,,,,,,,,...,,,,,,,,,XX.......,.H.,...............,...............,...X
X...,...............,..............,.H..,......X:X.,W..................XX.......,...,.........:.....,...............,...X
X...,...............,..............,....,......XXX.,...................XX.......,...,...............,...............,...X
X...,...............,..............,....,......X-X.,...................,,.......,.H.,...............,...............,...X
X...,...............,.............,.....,......X-X.,...................XX.......,...,...............,...............,...X
X...,...............,.............,.....,......X-XE,.............:.....:X.......,.E.,...............,...............,...X
X...,...............,.............,.H...,......X-X.,,,.................XX.......,...,...............,...............,...X
X...,...............,............,.....,.......X-XE,,,..............,,,XX.......,...,...............,...............,...X
X...,...............,............,.....,.......X-X.,,,..............,,,XX........,..,...............,...............,...X
X...,...............,............,.....,.......X:XE,,,..............,E,XX........,..,...............,...............,...X
X...,...............,...........,......,.......XXX.,,,H..:..........,,,XX........,.H.,..............,...............,...X
X...,...............,...........,.....,.......,X-X,,,,.............W,,,XX........,...,..............,...............,...X
X...,...............,...........,.....,.....,,,XXX,,,XXXXXXXX,,XXXXXX,,XX+X......,...,..............,...............,...X
X...,...............,..........,...H..,....,,,:,.....XXXXXXXXH,XXXXXX,,XXtX......,...,..............,...............,...X
X...,...............,..........,..H..,.....,...,.....XXE,EW,,H,A,W.XX,XXX.,.......,H..,.............,...............,...X
X...,...............,..........,.....,....,,A..,......XXXE.,,H,,,..XX.XXXXX,,.....,...,.............,...............,...X
X...,...............,..........,.....,...,,:...,......X-XE.,,,,,,..XX.XX,,:,,.....,....,............,...............,...X
X...,.............:.,..........,.....,...,,....,......AXX..,....,..XX.XX...,,......,...,............,.:.............,...X
X...,..............,...........,..E..,...,,....,.....A.XX..,....,..XX:,,...,,......,...,.............,..............,...X
X...,.............,............,...H.,...,,...:,.....AWXX...,,,,...XX:XX...,,.......,.H.,.............,.............,...X
X...,.............,............,.....,...,,....,.....A.XX..........XX,XX...,,.......,...,............H,.............,...X
X...,.............,.............,.....,..,,....,......AXX.........:XX:XXX..,,........,...,............,.............,...X
X...,.............,.............,.....,..,,.:..,.......X:........::XXWXXX..,,........,.E.,............,.............,...X
X...,.............,.............,.....,..,,:A..,....:..X:......HH.:XX..XX..,,.........,..,............,.............,...X
X...,.............,.............,..H..,...,,...,......X-X......HH..XX.HXX..,,.........,..,............,.............,...X
X...,.............,W.............,.....,..,,...,....E.X-X:.....HH.AXX..XX..,,.........,..,...........W,.............,...X
X...,.............,..............,.....,...,,,:,....,X--XXXXXXXXXXXXXE.XX..,,.........,.H,............,.............,...X
X...,.............,..............,......,...,,,XX,,,.XXXXXX>>>XX:XXXXE.XX,,,,.........,..,............,.............,...X
X...,.............,...............,.....,.....,XX......HXX.....XX......XX..,,.........,..,............,.............,...X
X...,.............,...............,.....,.....HXX.......XX..H..XX...EEEXX,,,,.........,..,............,.............,...X
X...,.............,................,....,......XX.......XX.....XX......XX..,,.........,..,............,.............,...X
X...,.............,................,....,......XX..:....XX.....XX......XX,,,,.........,.H,............,.............,...X
X...,..............,...............,.H..,......XX.......XXX+++XXX......,,..,,.........,..,...........,..............,...X
X...,.............:.,..............,....,......XX.......X:X,,,X:X...:..XX,,,,........,...,..........,.:.............,...X
X...,...............,..............,....,......XX:.....................XX..,,........,...,..........,...............,...X
X...,...............,..............,....,......XX......................XX,,,,.......,....,..........,...............,...X
X...,...............,..............,....,......XX......................XX..,,......,....,...........,...............,...X
X...,...............,..............,....,......XX....:.................XX,,,,.....,...H.,...........,...............,...X
X...,...............,..............,....,......XX:..........:..........XX..,,.....,....,............,...............,...X
X...,...............,..............,..H.,......XX.......:..............XX,,,,....,....,.............,...............,...X
X...,...............,..............,....,......XX,.....................XX..,,....,....,.............,...............,...X
X...,...............,..............,H...,.....,XX,,,...................XX,,,,....,...,..............,...............,...X
X...,...............,..............,....,....,,XX,,.,................:.XX..,,...,....,..............,...............,...X
X...,...............,..............,....,...,,.:.,,,.,:................XX.......,...,...............,...............,...X
X...,...............,..............,....,..,,.....XXXXXXXXXXXX.........XX.......,.H.,...............,...............,...X
X...,...............,..............,....,..,,:.W.:XXXXXXXXXXXX,,,,,,,,,XX.......,...,...............,...............,...X
X...,...............,..............,....,..,,.E...,......E.E,,.........,........,...,...............,...............,...X
X...,...............,..............,.H..,...,,.:.,......E.E.,,.........,........,...,...............,...............,...X
X...,...............,.............,.....,.....,,,...........,,....H....,........,...,...............,...............,...X
X...,...............,.............,.....,...................,,:.......:,........,...,...............,...............,...X
X...,...............,.............,.....,....,..............,,.........,........,.H.,...............,...............,...X
X...,...............,.............,.....,....,,,.............,,..AWA..,.........,...,...............,...............,...X
X...,...............,............,......,...,...,,............,:....:.,.........,...,...............,...............,...X
X...,...............,............,......,,,,.,....,............,,,,,,,..........,.E.,...............,...............,...X
X...,...............,............,.H....,.,..,...,..............................,...,...............,...............,...X
X...,...............,............,......,..,..,.,...............................,...,...............,...............,...X
X...,...............,............,......,..,..,,................................,...,...............,...............,...X
X...,...............,............,......,..,,,..................................,...,...............,...............,...X
X...,...............,............,......,,,....................................,....,...............,...............,...X
X...,...............,............,...E..,,....................................,...H.,...............,...............,...X
X...,...............,............,........,,,...............................,,......,...............,...............,...X
X...,...............,............,...........,,,,,,,,,,,,,,,,,,,,,,,,,,,,,,,.......,................,...............,...X
X...,...............,.............,................................................,................,...............,...X
X...,...............,..............,........................H...........H.........,.................,...............,...X
X...,...............,..............,.................H......................H....,..................,...............,...X
X...,...............,...............,...H.....H................................,,...................,...............,...X
X...,...............,................,...................H......E....H........,.....................,...............,...X
X...,...............,.................,,,....................................,......................,...............,...X
X...,...............,....................,,,,..............................,,.......................,...............,...X
X...,...............,........................,,,,,,,,,,,,,,,,,,,,,,,,,,,,,,.........................,...............,...X
X...,...............,...............................................................................,...............,...X
X...,...............,...............................................................................,...............,...X
X...,...............,.....................................,,,,,.....................................,...............,...X
X...,...............,....................................,....,,....................................,...............,...X
X...,................,..................................,......,,...................................,...............,...X
X...,................,..................................,.A.W.A,,...................................,...............,...X
X...,.................,.................................,......,,H..................................,...............,...X
X...,..................,..........:.....................,...T.E,,.......................:...........,...............,...X
X...,.................:,................................,,.....,,..................................,................,...X
X...,...................XX...............................,,,,,,,...................................,...............,....X
X...,.................XXX.,W..............................,,,,,...................................X..:.............,....X
X...,...............XXXX..,......................................................................X-XX.............,.....X
X....,..............XX.....X....................................................................,.XX-X............,.....X
X.....,............X-X..H..XX...................................................................,...X-X..........,......X
X......,...........XX..E..X-X,.................................................................X.W...XX..........,......X
X.......,.........X-X.T...XX..,...............................................................XX..A.AX-X........,.......X
X........,.........X-X..XX-X.:.,.........................................................W...,X-X..A..XX........,.......X
X.........,.........X-XX--X.....,,,,........................................................,..XX.A.T:X-X.......,.......X
X..........,.........X--XX..........,,,,,,.................................................,.:.X-XX.:X-X.......,........X
X...........,.........XX..................,,,...............................,,,,,,,,,,,,,,,.....XX-XX-X........,........X
X............,...............................,.............................,......................XX-X........,.........X
X.............,.............................:.,...........................,.:.......................X.........,.........X
X..............,...............................,.........................,...................................,..........X
X...............,...............................,.......................,....................................,..........X
X................,...............................,.....................,....................................,...........X
X.................,...............................,...H...A.W.A...H...,...................................,,,...........X
X..................,...............................,.................,..............................,,,,,,..............X
X...................,,,,,,,,,,,,,,,,,,,,,,,,,.......,,,,,,,,,,,,,,,,,.......,,,,,,,,,,,,,,,,,,,,,,,,....................X
X............................................,.............................,............................................X
X.............................................,...........................,.............................................X
X..............................................,.........................,..............................................X
X...............................................,.......................,...............................................X
X................................................,.....................,................................................X
X.................................................,...................,.................................................X
X..................................................,.................,..................................................X
X...................................................,,,,,,,,,,,,,,,,,...................................................X
X.......................................................................................................................X
X.......................................................................................................................X
X.......................................................................................................................X
X.......................................................................................................................X
X.......................................................................................................................X
X.......................................................................................................................X
X.......................................................................................................................X
X.......................................................................................................................X
X.......................................................................................................................X
X.......................................................................................................................X
X.......................................................................................................................X
XXXXXXXXXXXXXXXXXXXXXXXXXXXXXXXXXXXXXXXXXXXXXXXXXXXXXXXXXXXXXXXXXXXXXXXXXXXXXXXXXXXXXXXXXXXXXXXXXXXXXXXXXXXXXXXXXXXXXXXXX
