XXXXXXXXXXXXXXX-----------------------------------------------
>E,+H,+H,+H,L.X-----------------------------------------------
XXXXXXXXXXXXX.X-----------------------------------------------
XXXXXXXXXXXXX,XXXXXXXXX---XXXXXXXXXXXXXXX---------------------
XA.A.A.W.,,,,H,,,,.E..XX-X.....E.........XXXXXXXXXXXXXXXXXX---
X.,,,,,,,.,:,,,.,,,...,X-X...............XXHH.HH.HH.HH.HH.X---
X.,,,.,...,.,.,.:,,..E,X-X.A...,,,.......XXHH.HH.HH.HH.HH.X---
X.,,,,,,,.,,,.,,,.,...,X-X.....,H,...A...+,HH.HH.HH.HH.HH.X---
X.,.,....,.......,....,X-X....XX,X.......XXXXXXXXXXXXXXXXXXXX-
X.,,,.....,,,,,,,.....,X-X...X-X.XX..............X..........X-
X.,.,......E..........,X-XE..XX...X.......A...E.WX.........AX-
X.,,,...E.............,X-X...XX...XA.............X..........X-
X.,.,.................,X-X...XXH..XXXXXXXXXXXXXXXX...XXXX...X-
X.,,,.................,X-X...XX...XXXXXXXXXXXXXX-X,,,X-XX...X-
X.,.,.................,X-X..EXX...,H,H,H,H,H,H,.XX,,,XXXX...X-
X.,,,.................,X-XtttXX...,,,,,,,,,,,,,.......AXX...X-
X.,.,.................XX-XXXXXX...,H,..........E.......XX...X-
X.,,,.............,,,,XXXXXXXXX...,,,..................,,...X-
X.,.,.............,.,.,,,...........,,,,,,,,,..........,,...X-
X.,,,.E...........,,,,,,,.E................,.,.........,,...X-
X.,.,.............,.,.XX,........XX,XX....,...,........XX...X-
X.,,,.............,,,,XXX.......X-X,X-X...,..,.,..E....XX...X-
X.,.,.............,.,.X-X......XXXX,XXXX.,..,..,........X...X-
X.,,,.............,,,.XXX.....XX..E....XX.,,....,...XXXXX...X-
X.,.,.............,.,.XX,.....XX.......XX,....,,.,.X....,,,,X-
X.,,,,,,,,,,,,,,,,,,,.XX,.....XXE......XX...,,...,X.H...,...X-
X.,,,.,.,.,.,.,.,.,,,.XX,.....XX.......XX.,,...,,..XX.E.,..EX-
X.,,,,,,,,,,,,,,,,,,,.XX,.....XX.......XX,..,,,.....XX..,...X-
XE...................EXX,.....XX.......XX.,,.......EXX..,,,,X-
XXXXXXXXXXXXXXXXXXXXXXXX,.E...XX.......XX,..........XX..,H..X-
-----------------------X,.....XX.......XX..E,,,,....XX..,...X-
-----------------------XX.....XX,,,,,,,XX...,,,,....XXE.,...X-
------------------------X:...XX.........X...,,,,,,..XX..,,,,X-
------------------------XXXXXX.,,,,,...,X...,,,,,,H.XX..,...X-
------XXXXXXXXXXXXXXXXX----XX..,,,,,..W+X.......,,,,XX..,...X-
------X,,,,,,,,,,,,,,,X----X..,,,,,....,X.......,,,,XX..,...X-
----XX...H.............X---X.E,,,.....E.X:........,,XX..,,,,X-
--XX....................X--X.,,,...XXXXXXXXXXXXXX,,,XX..,...X-
--XW...<.................X-X.,,,.XXXXXXXXXXXXXXXX+++XXX.,.E.X-
-X.......................X-X.,,H.XXX.....,,,,,,,......X.,...X-
-X........................XX.,,,,,+,..E..,,,,,,,..E...X.,,,,X-
X.............H...........X-X,,,,,+,E....,.,.,.,......X.,...X-
X..<...<...................XX.E,,,+,....XX,,,,,XXX...EX.,..HX-
X..........................X-X.,,XXX...XX.,.T.,..X....X.,...X-
X...........................XX,,,XXX,,,X.E.,,,...XX,,,X.,,,,X-
X.........:.......E.........XX,,,XXX,,.,....E.E..,,..,X.,...X-
X............................X,,,XXX,,,,.........,,,,,X,,..EX-
X...H.......E................X,H,XXX,,.,...H..H..,,..,XW,...X-
X.............................XXX-XX,,,,.........,,,,,XXXLLLX-
X.............,,,,,,,,,,,,,,,,X---XX,,EX..H......XX.E,X-X,,,X-
X.............,T,.............X----XXXXX.........XX,,,X-X.E.X-
X.............,,,.............X-XXXXXXX-X..XX.H.XXX...XXX,,,X-
X.............,......H........XX,.,.,.,X-X.XXLLLXX....,,.,HAX-
X.........E...,...............X,,,,,,,,,XX,XX+++X.....,,K.,.X-
X..H..........,..............XX.,.,.,.,E,.WXX.........,,.AE++-
X.............,......W.....,,XX,,,,,,,,,XXXXX.........XXXXXXX-
X.............,.......XX,,,..+,.,.,.,E,.X---XXXXXXXXXXX-------
X.............,.......XX,...A+,,,,,,,,,,X-XXXXXXXXXXXXXXXXXXX-
-X............,.......,,.,,,.+,.,.,.,.,EXXX....E,,,,,,,,..tHX-
--XX..........,......,.,....,XX,,,,,,,,,XX.:....,,,,,,,,..tXX-
----XX........,......,.,.....XX.,.,.,E,.XX......,....A.....X--
------XX......,......,..,.....X,,,,,,,,,XX......XXXE......EX--
--------XX....,......,..,.....XX,.,.,.,X-X....A.XXX,,,,,,,,X--
----------XX..,.....,.A.,.....X-XXXXXXX--XE.....,+,,.......X--
------------XX,....XX+++XX...AX----------X..A...XXX.,,,.....X-
--------------XXXXX-X,,,X-XXXXX----------X......X-X,,..,,...X-
--------------------X.,.X-------XXXXXXXXX-XXX,,,X-X,.,...,,,.X
------XXXXXXXXXXXXXXX,,,XAXXXXXXX,,,,,,,XXXXX,,,XXX.,.,.....,X
------XE..,.,.,.,.,.,E,.,,....,.........E...XA......,..,,..E.X
------X,,,,.,.,.,.,.,,,,,A....,.............X........,...,...X
------X...,.,.,.,.,.,.,.,AH...,......E.....,.X........,...,..X
------X,,,,,,,,,,,,XX,,,XX,,,,XXX..........,.XE........,...,,X
------X...,........XX.W.XXE...X-X..........,.,.XX,,,X...,....X
------X,,,,........XXXXXXX....X-X.........,.,..XX,,,X...,...X-
------X...,........XXXXXXX....X-X.........,.,..,..,E,....,.X--
------X,,,,..E.............E..X-X........,.,...,.W,.,.....X---
------XE..,...................X-X......E.,.,...,..,.,...XX----
------X,,,,...................X--X.......,.,...XX,,,XXXX------
------X...,.....H.............X--X......,.,....,...,X---------
------X,,,,...................X--XE....,,.,...,...,.X---------
------X...,............E......X--X.,,,,..,....,..,..X---------
------X,,,,,,.............H...X--X,.....,,...,...,..X---------
------X...,.,.......E.........X--X....,,..E.,,..,...X---------
------X,,,,.,...........H.....X--X.,,,...,,,...,....X---------
------X..E,.,.....E..........X---X,...,,,.....,.....X---------
------XXXXXXX,,,,,,,,,,,,,,,X----X.,,,......,,......X---------
------------X.....XXX:...HXXX----X,......,,,........X---------
------------X,,..,X-X,XXX.X------X..E.,,,...........X---------
------------XHXXXHX-XWX-XXX------X.,,,..............X---------
------------XXX-XXX-XXX----------X,.................X---------
---------------------------------X..................X---------
---------------------------------X..................X---------
---------------------------------X..................X---------
---------------------------------X..................X---------
---------------------------------X..................X---------
---------------------------------X..................X---------
---------------------------------X..................X---------
---------------------------------XXXXXXXXXXXXXXXXXXXX---------
