--------------------------------------------XXXXXXX------------------------------------------
--------------------------------------------XA.A.AX------------------------------------------
--------------------------------------------X.....X------------------------------------------
--------------------------------------------X.....X------------------------------------------
--------------------------------------------X<<<.<X------------------------------------------
--------------------------------------------X.....X------------------------------------------
--------------------------------------------X.T.W.X------------------------------------------
--------------------------------------------X.....X------------------------------------------
--------------------------------------------X..:..X------------------------------------------
------------XXXXXXXXXXXXXXXXXXXXX-----------X+++++X------------------------------------------
------------XW.H....HH.HH.HH...HX-----------X+++++X------------------------------------------
------------X.....H..........H..X-----------XH...HX------------------------------------------
------------X.......HH.HH.HH...AX-----------XH.:..X------------------------------------------
------------XH....XXXXXXXXXXXH..X-----------XXX...X------------------------------------------
------------X.....X---------XH.AX-------------X.A.X------------------------------------------
------------X+++++XXXXXXXXXXX..AXXXXXXXX------X...X------------------------------------------
------------XH.........:.HXH.H..XXAA.+.X------X.E.X------------------------------------------
------------X....E....,,,.X..H.AXX.W.+AXXXXXXXX...X------------------------------------------
------------X.......E.,W,.XH....XXA.AXAXX.......H.X------------------------------------------
------------X.,,,.,,,.,.,.X...H.XX.A.XAXXH.EE.H...XXXXXXX------------------------------------
------------X.,A,.,A,.,A,.X....:.....X.XX.......H.X.....X------------------------------------
------------X.,,,.,,,.,,,.X..........XAXXHXXXXXXXXX.H..HX------------------------------------
------------XH...A...H.E..XE.........XAXX.XXXXXXXXX.....X------------------------------------
------------X.,,,.,,,.,,,.X..:...E.H.X.XXHXXttt...X...A.X------------------------------------
------------X.,A,.,.,.,A,.X..........XEXX.XXt.t.H.X.....X---------------------XXXXXXXXXXXXXXX
------------X.,,,.,,,.,,,.X.E...E....X.XXEXXttt...X..T..X---------------------X.............X
------------XH...E...E...AX..........XKXX.XX...E..X.....X---------------------XE...E...E..H.X
------XXXXXXX.,,,.,,,.,,,.X:..E.....XX.XXHXXH.....X.....X---------------------X.,,,.,,,,,,,.X
------X.HH.+,.,H,.,.,.+.,.X....XXXXX-X.XX.XX....E.X....WXXXXXXXXXXXXXXXXXXXXXXX.,.,.,.....,.X
------XHXXXXX.,,,.,W,.,,,.XXXXXXXXXXXX,XXHXX......X+++++XX......,...T..E..E..++.,,,.,.,,,,,.X
------X.X---XE....,.,H....+H.E..E.H.H.H.H.,,....E.X+++++XXtXXXXXX.XX,XXXXXXXXXX....A,.,..E..X
------XHX---X.,,,,,.,.,,,.XXXXXXXXXXXXXXXXXXXXXXXXX.A.A.XX.X----X.XX.X--------X.,,,.,.,.,,,.X
------XHX---X.,.A..A,.,.,.XXXXXXXXXXXXXXXXXXXXXXXXX.....XX,X----X.XX.X--------X.,H,.,.,.+.,.X
------XHX---X:,,,,,,,.,,,.,.....H.+.T.,.,,.,.,tA.WXXXXA.XX.X----X.XXHXXXXXXXX-X.,,,.,,,.,,,.X
------X.X---X............H,.......+..,..,,,..,t.AXXXXX..XX.X----XEXX.XXA....X-X......E...E..X
------XHX---XXXXXXXXXXXXXXX++XXXXXX,,,..ttt.,.+t.XXW,,..XX.X----X.XXAXX.....XXX.ttt.ttt.ttt.X
------XHX-----------X.......E.....X.H.....,.,.++.:XA,,A.XX.X----X.XX.XX.....,.,.t.t.t.t.t.t.X
------XHX-----------X.E.......,,,.X......,..,:XXXXXXXX..XXXX----X.XXEXX...T.XXX.ttt.ttt.ttt.X
------X.X-------XXX-X.....E...,.,.X....E.,..,,XXXXXXXXA.XXXXXXXXX.XXAXXA....X-X....E.....E..X
------X.XXXXXXXXX.X-X.,,,.,,,.,.,.XX....,..,,+XX........XX........XX.XX.....X-X.,,,.,,,.,,,.X
------X.,tH.E.A.+.X-X.,.,.,.,.,.,.XX.,,,,,,XX.XX.E......XX.E......XXWXXA....X-X.,.,.,.,.,.,.X
------X.XXXXXXXXX.X-X.,,,.,,,.,,,.XXE,..,.:XX.XX.XXXXXXXXX......E.XX.XX.....X-X.,.,.,,,.,,,.X
------XHHH..X---X.X-XH...H...H....XX.,..,E.XX.XX.X-------XW.XXXXXXXX+XXH....X-X.,.,.........X
------XXXXXHX---X.X-X.,,,.,,,.,,,.XT.H.,,,,XXAXX.X-------X..X---X...HXX+++++X-X.++,.:.E...H.X
----------X.X---X.X-X.,.,.,.,.,.,.+,,,,..,HXX.XX.X-------X..X---XEXXXXX.....X-XE........E...X
----------XHX---X.X-X.,,,.,,,.,,,.XHt.....,XXAXX.X-------XE.X---X.X---X.....X-XXXXXXXXXXXXXXX
----------XHX---XTX-XH...H...A....X.t......XX.XX.X-------X..XXXXX.X---XH..H.X----------------
----------XHX---X.X-X.,,,.++,.,,,.XXt,...E.XXKXX.X-------XH...HXX.X---XXXX..X----------------
----------X.X---X.X-X.,.,.,.,.,.,.XX.,.....XX.XX.X-------X.....XX.X------X..X----------------
----------XHXXXXX.X-X.,,,.,W,.,,,.XXXXXXXXXXX,XX.XXXXXXXXX.....XX,X------X..X----------------
----------XHXXH...X-XE....,.,H....+..E.......E...,......+X+++++XXEX------X..X----------------
----------X.XXXXXXX-X.,,,,,.,.,,,.XXXXXXXXXXXXXXXXXXXXXX+XH..H.XX,X------X..X----------------
----------XHX-------X.,A..E.,.,.,.X------------XXX-------X.....XX.XXXXXXXXE.X----------------
----------XAX-------X.,,,,,,,.,,,.XXXXXXXXXXXXXXtXXXXXXXXX.T...XX,XX..L.....X----------------
----------X.X-------X........E....,...E..........,....t.XX.....XX.XX..LW....X----------------
----------X,XXXXXX--XE............XXXXXXXXXXXXXXXXXXXXXXXX....EXX,XXE.L.....X----------------
----------X.....HX--XXXXXXXXXXXXXXX----------------------X..E..XX.XX..XXXXXXX----------------
----------X...tttXXXXXXXXXXXXXXXXXXXXXXXXXXXXXXXXXXXXXXXXX...A.XX,XX..X----------------------
----------X.H.t.tXXH.:..H.HH.HH.HHH.HH.HHH.HH.H..,,.....+,.....XXEXX..X----------------------
----------X...tttXX.............................A,,E.H.A+,A.AA.XX,XXE.X----------------------
----------X......XX...E.H.HH.HH.HHH.HH.HHH.HH.H..XXXXXXXXXXXXXXXX.XX...X---------------------
----------X......XX.......HH..H.H.H.H..HH..HH.H..XXXXXXXX-------X,XX...X---------------------
----------X..E.E.X+.E............................XX.....X-------X.XX.E.X---------------------
----------XH.....,,...:...A...A..A..A...E..HH.H..XXW..A.X-------X.XX...X---------------------
----------X......,,.E.,,,,,,,,,,,,,,,,,,,,..H.H.HXX.....X-------X,X-X+++X--------------------
----------X..E...,,...,,,,,,,,:.A.:.AA..:,E.H.H..XX.....X-XXXXXXX,XXX+++XXXXXXXXXXX----------
----------XA...E.,,...,,,H,,,+...E......W,.......XX..T..X-XH.......H,...,H......H.X----------
----------X..E...,,H..,,,,,,,H.....E.,,,.,A...H..XX.....X-X...,,,,,,,...,,,+,,,...X----------
----------XW...E.,,H..,H,,,:,+...H...,H,H,EA.H.T.XX.....X-X...,.,.,...E...,.,.,...X----------
----------X..E...,,...,,,H,,,+.E..H..,,,.,....H..XX.....X-X...,,,,,,,...,,,,,,,...X----------
----------XA...E.,,...,,,,,,,,......A..E.,A.H....XX...H.X-X...,.,...,...,...,.,...X----------
----------X..E...,,E..,,,,,,,,:.A.:..A..:,....H.HXX.....X-X...,,,...,...,...,,,...X----------
----------XH.....,,...,,,,,,,,,,,,,,,,,,,,..H.H..XX+++++X-X...,.,...,.E.,...,.,...X----------
----------X..E.E.++E..:...A...A..A..A...E...H.H..XX.....X-X...,,,...,++++...,,,...X----------
----------X......XX.............................HXXH..H.X-X...,.,...........,.,...X----------
----------X...tttXX...E.HH.HH.HH.HHH.HH.HH.HH.H..XX,,...X-X...,,,,,,,,,,,,,,,,,...X----------
----------X.:.t.tXXHH...HH.HHH.H.HHH.HH.HH.HH.H..,+.,.A.X-X...,.,.,E....E.,.,.,...X----------
----------X...tttXXXXXXXXXXXXXXXXXX,,,,,,,,XXXXXXXX.,...X-X...,,,,,,,,,,,,,,,,,...X----------
----------X.....HX--X.............X,AE.E.A,XXXXXXXX.,...X-X.......................X----------
----------X,XXXXXX--XH..E..A..,,H.X,,,,,,,,XXELL....,.E.X-X.......................X----------
----------X.X-------X.........,A,.X,:,,,,:,XX.XX,,,,,...X-X.......................X----------
----------X.X-------X.,,,.,,,.,.,.X,,,,,,,,XX.XX......H.X-X.......................X----------
----------XHX-------X.,A,.,H,.,A,.X,,,,,,,,XXAXXH.H.E...X-X.......................X----------
----------X.X-------X.,,,.,,,.,,,.X,:,,,,:,XX.XX.XXXXXXXX-X.......................X----------
----------X.X-------XA...A...E....X,,,,,,,,XXAXXHX--------X...................E...X----------
----------X.X-------X.ttt.ttt.ttt.XE,.E.,E.XX.XX.X--------X.....,,,,,,,,,,,.......X----------
----------X.X-------X.t.t.t.t.t.t.X.,...,..XXAXX.X--------X.....,.........,.......X----------
----------X.X-------X.++t.ttt.ttt.XK,,,,,K.XX.XXHXXXXXXXXXX.....,.........,.......X----------
----------XAX-------XH...E...H.A..X.,,,+,..XX.XX.,.W..H..XX.....,....A....,.......X----------
----------X.XXXXXXXXX.,,,.,,,.,,,.X.,,,,,..XXKXXHXXXXXXXXXX.....,...+++...,.......X----------
----------X....A..H+,.,W,.,:,.,A,.X:,,,,,.:XX.XX.X--------X..E..,A..,H,..A,....E..X----------
----------XXXXXXXXXXX.,,,.,.,.,,,.XXXXXXXXXXX,XX.X--------X.....,...,,,...,.......X----------
--------------------XE....,A,...E.+H..E.H.H..H..HX--------X.....,.H..H.H..,.......X----------
--------------------X.,,,,,.,.,,,.XXXXXXXXXXXXXXXX--------X.....,.........,.......X----------
--------------------X.,H.E.A,.,W,.X-----------------------X.....,A...A...A,.......X----------
--------------------X.,,,,,,,.,,,.X-----------XXXXXXX-----X.....,,,,,,,,,,,.......X----------
--------------------XA.H.H.H....H.X-----------X.....X-----X..E...............E....X----------
--------------------XXXXXXXXXXXXXXX-----------XA.A..XXXXX-X.......................X----------
----------------------------------------------X.....+.,.X-X.......................X----------
----------------------------------------------X.....XXX,X-X...........E...........X----------
----------------------------------------------X.....X-XEX-X.......................X----------
XXXXXXXXXXXXXXXXXXXXXXXXXXXXXXXXXXX-----------X.T...X-X,X-X,,,,,,,,,,,,,,,,,,,,,,,X----------
X.t...tA..E.E.E.............T.....X-----------X.....X-X.X-X.......................X----------
XXXXXXXXXXXXXXXXXXXXXXXXXXXXXXXXXXX---XX>>XXX-X.....X-X,X-X,,,,,,,,,,,,,,,,,,,,,,,X----------
--------------------------------------X.....X-XH..H.X-X.X-X.......................X----------
--------------------------------------X.....X-X+++++X-X,X-XE......................X----------
--------------------------------------XHH.H.X-X+++++X-X.X-X.....E.....E.....E...E.X----------
--------------------------------------XHH.H.X-X.....X-X,X-X.......................X----------
--------------------------------------X.....X-XA.A..X-XHX-X..E.....E....E.....E...X----------
--------------XXXXXXXXXXXXXXX---------XHH.H.X-XXX...X-X,X-X.......................X----------
--------------X.....A......:X---------X.....X---X...X-X.X-X.....E..........E......X----------
--------------X..E....E.,,,.X---------X.....X---X.E.X-X+X-X.E.......E.............X----------
--------------X.........,.,.X---------XH...HX---X...X-XHX-X............E........E.X----------
--------------X.,,,.ttt.,.,.X---------XXXX+XXXXXX...X-X.XXX.....E.................X----------
--------------X.,.,.t.t.,.,.X------------X.XX.......X-X.H,,.................E.....X----------
--------------X.,,,.ttt.,,,.X------------X.XX.A..A..X-XXXXXE..E.......E..E.....E..X----------
--------------XE...E.....H..X------------X.XXEXXXXXXX-----X.......E...............X----------
--------------X.ttt.ttt.ttt.X------------XEXX.X-----------XXXXXXXXXXXXXXXXXXXXXXXXX----------
--------------X.t.t.t.t.t.tAX------------X.XX.X----------------------------------------------
--------------X.ttt.ttt.ttt.X------------X.XX.X----------------------------------------------
--------------X..H.E...E....X------------X.XXAX----------------------------------------------
--------------X.ttt.,,,.ttt.X------------XTXX.X----------------------------------------------
--------------X.t.t.,.,.t.t.X------------X.XX.X----------------------------------------------
--------------X.ttt.,.,.ttt.XXXXXXXXXXXXXX,XX.X----------------------------------------------
--------------XE....,.,.....+.E..A...A....A...X----------------------------------------------
--------------X.,,,,,.,.ttt.XXXXXXXXXXXXXXXXXXX----------------------------------------------
--------------X.,.....,Ht.t.X----------------------------------------------------------------
--------------X.,,,,,,,.ttt.X----------------------------------------------------------------
--------------XA....E......HX----------------------------------------------------------------
--------------XXXXXXXXXXXXXXX----------------------------------------------------------------
---------------------------------------------------------------------------------------------
------------------------------------------------XXXXXXXXXXXXXXXXXXXXXXXXXXXXXXXXXXX----------
------------------------------------------------X.t...tA.E...................T....X----------
------------------------------------------------XXXXXXXXXXXXXXXXXXXXXXXXXXXXXXXXXXX----------
---------------------------------------------------------------------------------------------
---------------------------------------------------------------------------------------------
---------------------------------------------------------------------------------------------
------------------------------------------------XXXXXXXXXXXXXXXXXXXXXXXXXXXXXXXXXXX----------
------------------------------------------------X.t...tA.E.E.................T....X----------
------------------------------------------------XXXXXXXXXXXXXXXXXXXXXXXXXXXXXXXXXXX----------
---------------------------------------------------------------------------------------------
---------------------------------------------------------------------------------------------
---------------------------------------------------------------------------------------------
------------------------------------------------XXXXXXXXXXXXXXXXXXXXXXXXXXXXXXXXXXX----------
------------------------------------------------X.t...tA.E..E................T....X----------
------------------------------------------------XXXXXXXXXXXXXXXXXXXXXXXXXXXXXXXXXXX----------
