------XXXXXXXX-------------------------------XXXXXXXXXXXX-------------------------------------
----XX,.,..,,.X------------------------XXXXXX..,....,....XXXXXX-------------------------------
---X..,.,.,E..,XX------------------XXXX..t.....,....,.......t..XX-----------------------------
--X.,.,,..,,.,...XXX-------------XX.,....t..E..,....,.......t....XX---------------------------
-X,.,.,XXX,..,......XXXX-------XX,..,..T.tt...,..E..,...E...t......X--------------------------
-X.E,XXXXXXX,....T...,..XXXXXXX..,..,....tt...,....,.......t...E..,.X-------------------------
X....X......XXX......,...,....t..,...,...XXXX.,....,.......t......,..X------------------------
X,,.XXttt......XXXX.,..E.,...t.E..,..,.,XXXXXXXXX..,T......t.....,....X-----------------------
X..,X.t.t..........XXXXXXXXXXX....,.,,,K,,.......XXX.......t.....,.....X----------------------
X...X.ttt................XXXXXXX..,,....,.X.......tXXX.....t.....,......X---------------------
X..,XX.......E..E...E.........XXX,......,XX.......ttX-X....t.....,..E....X--------------------
X,,..XXX........................XX......,XX.......tt.X-X.E.t..E.,.........X-------------------
-X.E..XXXXX.................E...X-X..E..,XXT.....tt...XX..t.....,.........X-------------------
-X..,,.AXXXXXX.......,,,,,.......X,.....,,X......tt....XX+t.....tt......E..X------------------
--X,.:.,A.,..XX...E..,...,.......,,...T.,.X......tt.....X.X....,,.ttt.......X-----------------
---XX.,W..E.,.XX.....,.E.,........,,...tt,X,,....tt......XX,,,,.,...ttttt...EXXX--------------
-----XX..,A.,..XX....,...,........,,.tt..,XX,....t.......:XT.,..,......ttttt.,,,X-------------
-------XXX.,..,X-X...,,,,,.........Xt....,XXE,...t..E...WX...,..,.........tttXXXEX------------
----------XX.,..XX...............,,X.....,,X.T,.tt....A..X...,..,.E.........tX-X,X------------
------------X.E,XX..........E...,.LX.....,.XXX,.tt......X,...,...,...........X-XX,X-----------
------------X.,,XX.............,.LLX......,.XXXXt..A.AXX.,...,...,..........X---X,X-----------
-------------X,..X..A...E......,LL.XX......,,.X-X...XX....,...,..,...T......X---X,X-----------
-------------X..,XX..........,X.L.,XX.....,,,,X--XXXXt....,....,,:,,.......X----XEX-----------
-------------X.,.XXA.A.....X,,XXX.,.XX....,.,.XXXXX...t.E.,...,,..W.,,,,...X----X,X-----------
--------------X.,XX.......XX,.,XXXXE,XX...,,..........t...,..,.A,,..A,..,XX-----X,X-----------
--------------X,EXXX:.W.XXX,E,.,.X-X..XXXXX,....E.....tt...,,...A.,,...,,X-----X,.X-----------
--------------X..XXXXXXXXXt.,,,.,.X-X.T,.XXXX.........tt...XX,.......,,T,XXXX--X,X------------
--------------X.,,.,.XX.,,.tX.,.E,.X-XX.tE..XXXXX......ttXXX,.,,,,t,,...,,E,tXE,.X------------
---------------X,.,.,,.,,.XX-X.,.,,.X--X.,.,,,XXXXXXXXXXXX,E,.....t...E.,XXXXXXXX-------------
--------------XX..,.,.,,.X----XXX.,,TXX-XX.,T,,.Et.E,.T,..,.X....Et....,,XXXXXX---------------
--------------Xt.T.,.,E.X--------X.,t,XXX-XX,,.,tt,,.,.,.XXX-X....t....,,.,,.,,XX-------------
--------------X,t..,.XXX----------XX.E,.,X--XXXXXXXXXXXXX-----X....t..E.,,,XXX,,EX------------
-------------X.,XXXXX---------------X,.,,.XXX------------------X..Et....,.X---XXX,X-----------
-----------XX,.XX--------------------X.,,,T..XXX-------------XXX,..t....XXXXXX---X,XX---------
----------X.,.X-----------------------XX.,,,,t,XX----------XX...,,,t,,XXXX,.,.X---Xt.XXX------
----------X,EX--------------------------XXX.t.E,,XXX-------X..E..tt,,,XX,.,,T,X----X.E,.X-----
----------X.X------------------------------XXX,,.,,,XXXXXXXX.....tt......XXX.,.X----X,.,.X----
---------X.,XXXXXXXXXXXXXXXXXXXXXXXXXXXXXXXXXXXX,,.T,,,,,,,t.....tt.....X---X.tX-----X.,,.X---
---------XttXXE.E,E.E,E.E,E.E,E.E,.E.,E.E,E.EX--X,,.,,,E,,,tT....tt.E...X---X.t.X-----X.,,X---
--------X,,.XX...,...,...,...,...,...,...,...X--X.XXXXXXXX,t.....tt....X-----X,,X------X.,EX--
--------X.T,XXttt,ttttttt,ttttttt,ttttttt,tttX--X.X-------XX....tt.....X-----X..X-------X.tX--
--------X,,.XX...............................X--X.X---------X...tt....X------X.,AXX------X.,X-
--------X,.X-Xttt,ttttttt,ttttttt,ttttttt,tttX--X,X----------XX.Et..XX--------XAE..X-----X,.X-
-------X,E,X-X.E.,E.E,.E.,E.E,E.E,E.E,E.E,E.EX-X...X-----------Xtt.X----------X.,:tW-----X..X-
-------X.,,X-X...,...,...,...,...,...,...,...XX.....X-----------XXX------------XXX..X-----X,X-
-------X,,.X-XXXXXXXXXXXXXXXXXXXXXXXXXXXXXXXXXX....:X-----------------------------XAX-----X,X-
-------X..,X----------------------------------X.....X-----------------------------X,,X----XTX-
-------XttX--------------------------------XXXX.....XXXX--------------------------X..X----XtX-
-------X..X-------------------------------X....,...,....X-------------------------X,X---XXt.X-
-------X,,X------------------------------X......,,,......X------------------------X.XXXXE,.X--
-------X.TX------------------------------X..T...,E,......X------------------------XE,,.,.,.X--
-------X,,,X---------------------------XXX......,,,...T..XXX----------------------X,XXXXXXX---
-------XttX---------------------------X...,....,...,....,...X---------------------X.X---------
-------X..X--------------------------X.....,,,,.....,,,,.....X-------------------XttX---------
-------X,EX--------------------------X.....,..,.....,..,.....X-------------------X,..X--------
-------X,,X--------------------------X.....,.E,.....,E.,.....X-------------------X.,,X--------
-------X,,,X----------------------XXXX.....,,,,.....,,,,.....XXXX-----------------XttX--------
-------X...X---------------------X....t...,....,...,....,...,....X----------------X,E.X-------
-------X,,,X--------------------X......t,,......,,,......,,,......X---------------X.,,X-------
-------X..tX--------------------X...T..,E,...T..,E,..T...,E,..T...X----------------X.,X-------
--------XtE,X-----------------XXX......,,,......,,t......,,,......XXX--------------X,.X-------
---------X,.X----------------X...,....,...,....,...t....,...,....t...X-------------X,,X-------
---------X,,X---------------X.....,,,,.....,,,,.....t,,,.....,,,t.....X------------X,.X-------
---------X.T.X--------------X.....,.E,.....,..,.....,..,.....,..,.....X-----------X.T,X-------
---------X.,,X--------------X.....,..,.....,.E,.....,.E,.....,E.,.....X----------X.tt.X-------
----------X.E.X----------XXXX.....,,,,.....,,,,.....,,,,.....,,,,.....XXXX-----XX.,E.X--------
-----------X.t.X--------X....,...,....,...,....,...,....,...,....,...,....X--XX.,..,.X--------
------------X.,.XXXXXXXX......,,,......,,,......,,,......,,,......,,,......XX,.,.,..X---------
-------------XX.,E,,.,.,...T..,E,...T..,E,...T..,E,......,E,...T..,E,......,.,E,..XX----------
---------------XX,.T,,.X......,,,......,,,......,,,......,,t......,,,......XX,.XXX------------
-----------------XXXXXX-X....,...,....,...,....,...,....,...t....,...,....X--XX---------------
-------------------------XXXX.....,,,,.....,,,,.....,,,,.....t,,,.....,,,X--------------------
----------------------------X.....,E.,.....,.E,.....,.E,.....,E.,.....,..X--------------------
----------------------------X.....,..,.....,..,.....,..,..T..,..,.....,..X--------------------
----------------------------X.....,,,,.....,,,,.....,,,,.....,,,,.....X,,X--------------------
-----------------------------X...,....,...,....,...,....,...,....,...XX..X--------------------
------------------------------XXX......,,,......,,,......,,,......XXX-X..X--------------------
--------------------------------X..<...,E,..T...,T,......,E,..T...X---X..X--------------------
--------------------------------X....T.,,,......t,,......,,,......X---X..X--------------------
---------------------------------X....,...,....t...,....,...,....X----X..X--------------------
----------------------------------XXXX.....,,,t.....,,,,.....XXXX-----X,,X--------------------
-------------------------------------X..<..,..,.....,..,.....X--------X..X--------------------
-------------------------------------X.....,..,.....,.E,.....X--------X..X--------------------
-------------------------------------X.....,,,,.....,,,,.....X--------X..X--------------------
--------------------------------------X...,....,...,....,...X---------X..X--------------------
---------------------------------------XXX......,,,......XXX----------X..X--------------------
-----------------------------------------X..<...,.,.T....X------------X..X--------------------
-----------------------------------------X......,,,......X------------X,,X--------------------
------------------------------------------X....,K.H,....X-------------X..X--------------------
-------------------------------------------XXXX.....tttXXXXXXXXXXXXXXXX,,X--------------------
----------------------------------------------X....At..........,,........X--------------------
----------------------------------------------XA.<.At..........,,.......KX--------------------
----------------------------------------------X.:.W.XXXXXXXXXXXXXXXXXXXXXX--------------------
-----------------------------------------------X...X------------------------------------------
------------------------------------------------XLX-------------------------------------------
------------------------------------------------X+X-------------------------------------------
-----------------------------------------------X...X------------------------------------------
----------------------------------------------X.>>>.X-----------------------------------------
----------------------------------------------X.>.>.X-----------------------------------------
----------------------------------------------X.>>>.X-----------------------------------------
-----------------------------------------------X.,,X------------------------------------------
------------------------------------------------X,X-------------------------------------------
----------------------------------------------XXX+XXXX----------------------------------------
--------------------------------------------XX,AA:,A,.X---------------------------------------
-------------------------------------------X.AA,,,,,AA.X--------------------------------------
-------------------------------------------X,,,AAA,A,,,X--------------------------------------
-------------------------------------------XA,A,,W,.A,AX--------------------------------------
-------------------------------------------XA,,,W.W,,,AX--------------------------------------
-------------------------------------------XA,A,WWW,A,AX--------------------------------------
-------------------------------------------XA,A,.W.,A,AX--------------------------------------
-------------------------------------------X,A,A,,,,A,,X--------------------------------------
-------------------------------------------X,A,,AH,A,A,X--------------------------------------
--------------------------------------------XXA,AAAAA,X---------------------------------------
----------------------------------------------XXXXXXXX----------------------------------------
