------------------------------------------------------------------------------XXXXXXXXXXXXXXXXXXXXXXX
------------------------------------------------------------------------------X.....................X
------------------------------------------------------------------------------X.:.................:.X
------------------------------------------------------------------------------X.....................X
------------------------------------------------------------------------------X.....................X
------------------------------------------------------------------------------X.....................X
------------------------------------------------------------------------------X.....XXXXXXXXXXX.....X
------------------------------------------------------------------------------X.....X---------X.....X
------------------------------------------------------------------------------X.....X---------X.....X
------------------------------------------------------------------------------X.....X---------X.....X
------------------------------------------------------------------------------X.....X---------X.....X
------------------------------------------------------------------------------X.....X---------X.....X
------------------------------------------------------------------------------X.....X---------X.....X
------------------------------------------------------------------------------X.....X---------X.....X
------------------------------------------------------------------------------X.....X---------X.....X
------------------------------------------------------------------------------X.....X---------X.....X
------------------------------------------------------------------------------X.H.H.X---------X.A.A.X
------------------------------------------------------------------------------X.....X---------X.....X
------------------------------------------------------------------------------X.H.H.X---------X.A.A.X
------------------------------------------------------------------------------X.....X---------X.....X
------------------------------------------------------------------------------X.H.H.X---------X.A.A.X
------------------------------------------------------------------------------X.....X---------X.....X
------------------------------------------------------------------------------X.H.H.X---------X.A.A.X
------------------------------------------------------------------------------X.....X---------X.....X
------------------------------------------------------------------------------X.H.H.X---------X.A.A.X
------------------------------------------------------------------------------X.....X---------X.....X
------------------------------------------------------------------------------X.....X---------X.A.A.X
------------------------------------------------------------------------------X.....X---------X.....X
------------------------------------------------------------------------------X.....X---------X.A.A.X
------------------------------------------------------------------------------X.....X---------X.....X
------------------------------------------------------------------------------X.H.H.X---------X.....X
------------------------------------------------------------------------------X.....X---------X.....X
------------------------------------------------------------------------------X.E.E.X---------X.....X
------------------------------------------------------------------------------X.....X---------X.....X
------------------------------------------------------------------------------XXXXXXX---------X.....X
----------------------------------------------------------------------------------------------X.....X
----------------------------------------------------------------------------------------------X.....X
----------------------------------------------------------------------------------------------X.....X
------------------------------XXXXXXXXXXXXXXXXXXXXXXXXXXXXXXXXXXXXXXXXXXXXXXXXXXXXX-----------X.....X
------------------------------X...................................................X-----------X.....X
------------------------------X...................................................X-----------X.....X
------------------------------X.........................H.........................X-----------X.....X
------------------------------X.E.......E...............................E.......E.X-----------X.....X
------------------------------X...................................................X-----------X.....X
------------------------------X...................................................X-----------X.....X
------------------------------X...................................................X-----------X.....X
------------------------XXXXXXX...................................................X-----------X.....X
------------------------XE..E.,...................................................X-----------X.....X
------------------------X.....,...................................................X-----------X.....X
------------------------X.....,...............E............................E......X-----------X.....X
------------------------XE..E.,...........................E.......................X-----------X.....X
------------------------X.....,...................................................X-----------X.....X
------------------------XXXXXXX...................................................X-----------X.....X
------------------------------X...................................................X-----------X.....X
------------------------------X.......................E...:...E...................X-----------X.....X
------------------------------X...................................................X-----------X.....X
------------------------------X...................................................X-----------X.....X
------------------------------X...........H.......................................X-----------X.....X
------------------------------X............................................H......X-----------X.....X
------------------------------X...................................................X-----------X.....X
------------------------------X...................................................X-----------X.....X
------------------------------X...................E...............E...............X-----------X.....X
------------------------------X...................................................X-----------X.....X
------------------------------X...................................................X-----------X.....X
------------------------XXXXXXX...................................................X-----------X.....X
------------------------XE....,.......A...........................................X-----------X.....X
------------------------X...E.,.............A.......A.............A.....A...A.....X-----------X.....X
------------------------X.....,.............................A.....................X-----------X.....X
------------------------XE..E.,...................................................X-----------X.....X
------------------------X.....,...................................................X-----------X.....X
------------------------XXXXXXX...................................................X-----------X.....X
------------------------------X............................................A......X-----------X.....X
------------------------------X.....................A............A.....A..........XXXXXXXXXXXXX.....X
------------------------------X......A......A..............A......................,.................X
------------------------------X...................................................XXXXX.............X
------------------------------X...................................................X---X.............X
------------------------------X...................................................X---X.:.........:.X
------------------------------X.............................................A.....X---X.............X
------------------------------X...................................................X---XXXXXXXXXXXXXXX
------------------------------X...................................A....A..........X------------------
------------------------------X........A.....A.....A.....A........................X------------------
------------------------------X...................................................X------------------
------------------------XXXXXXX...................................................X------------------
------------------------X.....,...................................................X------------------
------------------------X..E..,...................................................X------------------
------------------------X.....,.........A....A.....A...................A....A.....X------------------
------------------------XXXXXXX..........................A.......A................X------------------
------------------------------X...................................................X------------------
------------------------------X...................................................X------------------
------------------------------X...................................................X------------------
------------------------------X...................................................X------------------
------------------------------X...................................................X------------------
------------------------------X...................................................X------------------
------------------------------X...................................................X------------------
------------------------------X.......................H....H.....H....H...........X------------------
------------------------------X.........H......H..................................X------------------
------------------------------X...................................................X------------------
------------------------------X...................................................X------------------
------------------XXXXXXXXXXXXX.............................H.....................X------------------
------------------X........,,,,.........H.....H...H.....H........H....H...........X------------------
------------------X...E....,.,,...................................................X------------------
------------------X........,,,,................H.....H....H.......................X------------------
------------------XXXXXXXXXXXXX.............H..................H....H.............X------------------
------------------------------X...................................................X------------------
------------------------------X...................................................X------------------
------------------------------X...................................................X------------------
------------------------------XXXXXXXXXXXXXXXXXXXXXXX.......XXXXXXXXXXXXXXXXXXXXXXX------------------
----------------------------------------------------X.......X----------------------------------------
----------------------------------------------------X.......X----------------------------------------
----------------------------------------------------X.......X----------------------------------------
----------------------------------------------------X.......X----------------------------------------
----------------------------------------------------X.......X----------------------------------------
----------------------------------------------------X.......X----------------------------------------
----------------------------------------------------X.......X----------------------------------------
----------------------------------------------------X.......X----------------------------------------
----------------------------------------------------X.......X----------------------------------------
----------------------------------------------------X.......X----------------------------------------
----------------------------------------------------X.......X----------------------------------------
----------------------------------------------------X...E...X----------------------------------------
----------------------------------------------------X.......X----------------------------------------
----------------------------------------------------X,,,,,,,X----------------------------------------
----------------------------------------------------X.......X----------------------------------------
----------------------------------------------------X.......X----------------------------------------
----------------------------------------------------X.......X----------------------------------------
----------------------------------------------------X,,,,,,,X----------------------------------------
----------------------------------------------------X..,,,..X----------------------------------------
----------------------------------------------------X..,.,..X----------------------------------------
----------------------------------------------------X..,++..X----------------------------------------
XXXXXXXXXXXXXXXXXXXXXXXXXXXXXXXXXXXXXXXXXXXXXXXXX---X.......X----------------------------------------
X...............................................X---X.......X----------------------------------------
X...........A.A.A.A.A.A.........................X---X.......X----------------------------------------
X...............................................X---X.......X----------------------------------------
X.:.........A.A.A.A.A.A...............W.W.W.W...X---X.......X----------------------------------------
X...............................................X---X.......X----------------------------------------
X...............A.A.A.A.........................X---X.......X----------------------------------------
X...............................................X---X.......X----------------------------------------
X...............................................X---X.......X----------------------------------------
X...............................................X---X.......X----------------------------------------
X.......................:.H.H.H.H.H.:.:.:.:.:.:.X---X.......X----------------------------------------
X...............................................X---X.......X----------------------------------------
X.................H.............................XXXXX.......X----------------------------------------
X...............................................,...,.......X----------------------------------------
X.................H.............................XXXXX.......X----------------------------------------
X...............................................X---X.......X----------------------------------------
X.......................:.H.H.H.H.H.:.:.:.:.:.:.X---X.......X----------------------------------------
X...............................................X---X.......X----------------------------------------
X...............................................X---X.......X----------------------------------------
X...............................................X---X.......X----------------------------------------
X...............A.A.A.A.........................X---X.......X----------------------------------------
X...............................................X---X.......X----------------------------------------
X.:.........A.A.A.A.A.A...............:.W.W.W...X---X.......X----------------------------------------
X...............................................X---X.......X----------------------------------------
X...........A.A.A.A.A.A.........................X---X.......X----------------------------------------
X...............................................X---X.......X----------------------------------------
XXXXXXXXXXXXXXXXXXXXXXXXXXXXXXXXXXXXXXXXXXXXXXXXX---X.......X----------------------------------------
----------------------------------------------------X.......X----------------------------------------
----------------------------------------------------X.......X----------------------------------------
----------------------------------------------------X.......X----------------------------------------
----------------------------------------------------X.......X----------------------------------------
----------------------------------------------------X.......X----------------------------------------
----------------------------------------------------X.......X----------------------------------------
----------------------------------------------------X.......X----------------------------------------
----------------------------------------------------X...<...X----------------------------------------
----------------------------------------------------X.......X----------------------------------------
----------------------------------------------------X.......X----------------------------------------
----------------------------------------------------X.......X----------------------------------------
----------------------------------------------------X.......X----------------------------------------
----------------------------------------------------X.......X----------------------------------------
----------------------------------------------------X.......X----------------------------------------
----------------------------------------------------X....,,,X----------------------------------------
----------------------------------------------------X....+.,X----------------------------------------
----------------------------------------------------X....+,,X----------------------------------------
----------------------------------------------------XXXXXXXXX----------------------------------------
