----------------------------------------------XX------------------------------------------------------------------------------------
--------------------------------------------XX..XX----------------------------------------------------------------------------------
--------------------------------------------X.....X---------------------------------------------------------------------------------
-------------------------------------------X......X---------------------------------------------------------------------------------
-------------------------------------------X..,,,..X--------------------------------------------------------------------------------
-------------------------------------------X..,.,..X--------------------------------------------------------------------------------
-------------------------------------------X.,..E,.X---------XX---------------------------------------------------------------------
-------------------------------------------X.,..T,..X-----XXX-X---------------------------------------------------------------------
--------------------------------------------X.,..,..X----X...X----------------------------------------------------------------------
---------------XXXX-------------------------X..,,,,,.XX-X....X-------------------------------------------XXXXXX---------------------
------------XXX....X---------XXXXX-----------X,..H.....X....X------------------------------------------XX.A.A..XXXXX----------------
----------XX..E...E.X--------XW...X---------X...........,...X----------------------------------------XX.......W.....XX--------------
---------X..E.......,XX------X.ttt.X--------X....,,,,...,.XX---------------------------------------XX.................X-------------
---------X.......,,,...X----X,.t.tAX-------X,..,,....,,..X----------------------------------------X..,.................XX-----------
--------X.......E,......XXXX..,ttt.X-------X.,,...E..E.,.X---------------------------------------X.,.,...................X----------
--------X.E..E..,.............,.A.AX------X,.,.........,.X------XXXX-----------------------------X..,,....................X---------
-------X........,............A.,...X-X----X,,,.E.H.H....,XXXXXXX.A..XXXXX-----------------------X,..,,....................X---------
-------X.E..E.E.,.............A,.AX-X.X---X.,........H..,,.,.HH.A..A.....XXXX------------------X..,.,,.....................X--------
--------X......,...............,.X-X...X--X,,..H.ttt...E,.,..................XXXXX-------------X,.,,,.......................X-------
--------X.....,.................,X-X....XXX.,....t.t....,.,.......................XXXXX-------X..,.,,.......................X-------
---------X.E..,........ttt......,X-X...t..,.,E...ttt.....,.............................XXXXXXX,,,,,..........................X------
---------X..,,.........t.t......,X--X.t...,.,..H.........,...........................E..,..XXXX,,,,,XXXXX,,,,,XXXXX,,,,,XXXX.X------
----------X,...........ttt.......,X--XXXXX,,.,...E.......,.......................E.E.....,.XXXX,,,,,XXXXX,,,,,XXXXX,,,,,XXXX.X------
---------X.......................,X-------XX,.,..........,...........................E...,.,LL...........................HXX.X------
--------X..................H......,X--------X,,..........,...................E...E.E......,,LL....................E.E..E.EXX.X------
--------X...........................XX-------X,..........,.....................E.....E....,,LL...........................XXX.X------
--------X.............................XX-----X.,,.........,,...............E.E...E.E......,,LL.W.H................E.E..E.E-X.X------
-------X...............................,X----X,E.,,.......A.,,,................E..........,,LL...........................XXX..X-----
------XX...............................,.XXXXE.....,........A..,,..........E.E...E.E......,,LL....................E.E..E.EXX..X-----
----XX........,.........,..............,E.......E.E.,...........,..............E..........,,LL............................XX..X-----
--XX.........,.,,,,,,,,,.,.............,..E.E.E......,.A.........,.........E.E...E........,XXXX,,,,,XXXXX,,,,,XXXXX,,,,,XHXX...X----
--X.........,HXXX.....XXH.,............,..............,..........,....A........E..........,XXXX,,,,,XXXXX,,,,,XXXXX,,,,,XXXX...X----
---X,,,,.....,X-X..E..X-X,..............,E.E.E.E......,A.........,...A.....E.E.............,.................................XX-----
---X...,.....,XXX.....XXX,..............,.............,...........,.A..XXXXXXX.............,................................X-------
---X...,.....,.....E...E.,,,,,,,,,,,,,...,E.E..........,..........,...X-------XX...........,...............................X--------
---X...,.....,,,.........,,..........,...,.............,...........,XX----------X...........,............................,X---------
---X.H.,.....,,,AE.H.:.E.,,..AA.AA.W.,....,............,...........X-------------X..........,,,.......................,,,X----------
---X...,.....,,,.........,,..........,....,............,..........X---------------X.......E,..,.......................,..X----------
---X...,.....,.....E...E.,,,,,,,,,,,,,.....,...........,..........X---------------X......,....,.......................,..X----------
---X...,.....,XXX.....XXX,.................,............,........X-----------------X.....,....,.......................,..X----------
---X,,,,.....,X-X..E..X-X,.................,............,........X-----------------X....,E..E.,..............ttt.....,...X----------
---X........,.XXX.....XXX.,...............,.............,........X------------------X.E.,.....,..............t.t.....,....X---------
---X.........H.,,,,,,,,,H,................,............A,........X-------------------X..,.,K..,..............ttt.....,.....XX-------
---X..........,.........,.................,.............,.......,.XX-----------------X..,....,..............H...H.....,..E...X------
---X......................................,............T.,.....,....X-----------------X.,....,.........................,......X-----
--X.......................................,..........A...,....,......XX---------------X.,E..,...........................,.E.E.X-----
-X.......................................,............XXXX....,........X---------------X,...,...........................,......X----
-X.....................................H.,...........X----X..,........WX---------------X.,,,.............................,E.E.E.X---
X...............................XXX..A.H.,..........X------XXX.........X---------------X.................................,......X---
X............................XXX---XXXX..,..........X---------X.........X-------------X..................................,E.E.E..X--
X.........................XXX----------XX..........X-----------X........X-------------X...................................,......X--
X......................XXX--------------X..........X------------XX......X-------------X...................................,.E.E.EX--
XXX..................XX-----------------X..........X--------------X.....X-------------X...................................,......X--
---XX...............X--------------------X.........X--------------X......X-------------X...................................,.....X--
-----X.............X---------------------X.........X--------------X......X-------------X.............,,,,,,,,..............,.....X--
-----X...........XX----------------------X......E...X--------------X......X-------------X........,,,,........,,............,....X---
------X.........X------------------------X.........E.X-------------W......X-------------X......,,..............,,..........,....X---
------X........X------------------------X......E......X-------------X......X-------------X....,..................,.........,....X---
------X........X------------------------X.........E..E.X-------------X......X------------X...,....................,........,....X---
-------X.......X-----------------------X,.E.E.E........X-------------X......X-------------X.,......................,.......,....X---
-------X.......X-----------------------X.,.......E..E.,.X------------X.......XX------------X.......................,.......,....X---
-------X..E.E.X-----------------------X...,,E.........,.X------------X.........XXX----------X.......................,......,....X---
-------X......X----------------------X.ttt..,.E...E..,.H.XX-----------X...........XX--------X........................,.....,....X---
--------XE.E.EX---------------------X..t.t...,,.E..,,..,,..XX---------X............X---------X.E......................,....,....X---
--------X.....X--------------------X...ttt.....,,,,..,,......X--------X.............X--------X.........................,...,.....X--
--------X......XX-----------------X.......,,,..,.,.,,.........X-------X.............X--------X...E......................,..,.....X--
--------X........XX--------------X,,,...,,...,,.,,,............X------X..............XX------X.E.........................,,,.....X--
--------X..........XXXXXXX-----XX....,,,.....,.,.,..............X----X.................XXX--X......E.......................,.....X--
--------X..........,.E.E..XXXXX..............,,...,........,,....XXXXX....................XX.E...E.........................,.....X--
--------X.E.......,...........,.............,.,...,......,,,,,,,.,.........................,.......E.......................,.....X--
-------X..........,.E.E.E.E.E,.............,.,....,....,,,,..,..,,.........................,...E.....XXX...................,......X-
------X.........E.,..........,............,..,...,.....,,.....,,..,.........................,,.....XX---XXX.................,.....X-
------X............,E.E.E.E.E,............,.,....,....,,........,.,..............,,,...,,,....,,,XX--------X................,.....X-
------X.....E.......,,,,,,,,,,.....A.....,..,....,....,,.........,.,..,,,........,.,..,...,.....X-----------X...............,.....X-
------X......................,...........,.,.....,...,,...........,.,,...,......,.H.,.,...,....X------------X...............,.....,X
------X......................,.....A....,..,..A..,...,,...........,.,,...,......,...,.,,..,....X-------------X..............,,..,,.X
------X......................,.....H....,..,....,....,.......A.....,.,,,,....,...,,,....,,,...X---------------X............,..,,,..X
------X......................,..........,..,..A.,...,,.............,.,.....,,.,...............X----------------X...........,.:..,..X
------X......................,.....A...,..,...A.,...,,.....A.K.A....,,....,.H.,..............X-----------------X...........,,,..,..X
------X.......................,....A...,..,.....,...,.,,............,,....,....,.............X-----------------X.........,,...,,..HX
------X..................E....,........,..,.....,...,..,.....A......,,.....,..,..............X-----------------X........,......,...X
------X........................,........,..,.....,..,..,............,,......,,..............X------------------X......,,........,,X-
------X................E...E....,.......,..,.....,,,,..,............,.......................X------------------X,...,,............X-
-------X.........................,,......,,.,....,..,..,...........,,......................X-------------------X.,,,.,...........X--
-------X.................E...E.....,.....XXX.,...,...,.,...........,,......................X------------------X......,...........X--
-------X............................,..XX---X.,,..,,,.,,..........,,......................X-------------------X.....,...........X---
-------X.......E...........E...E.....XX------X..,,,....,........,,,,..,,,,,,.............X-------------------X......,...........X---
-------X...........................XX--------X,,..,.....,,....,,,,....,W..:,.............X-------------------X......,..........X----
--------X..E.................E....X----------X....,......,,,,,,.......,.,,,,............X-------------------X......,...........X----
--------X.......................XX-----------X...,...........,........,A,..............X--------------------X.....,...........X-----
--------X........E.............X-------------X..,,...H.......,........,.,.........XXXXX--------------------X.....,............X-----
--------X.....................X--------------X,,.............,........,A,......XXX------------------------X.,....,...........X------
---------X...E.......E.......X--------------X,.........H.....,........,.,....XX---------------------------X.,...,...........X-------
---------X..................X-------------XX..,.............,.........,A,..XX----------------------------X...,.,....E.......X-------
---------X.......E.........X-------------X.....,............,.......,,,.,XX-----------------------------X,....,............X--------
----------XX...............X------------X.......,..........,........,,...XXXXX-------------------------X..,,.,.............X--------
------------XX.......E....X-----------XX........,.........,.........,....X..EX------------------------X.....,...E.........X---------
--------------X..........XX----------X.........XXX.......,..........,....LA.HX------------------------X,,..,...........E..X---------
---------------XX......XX-----------X.E.......X--X,,,,,,,...........,..E.L..WA-----------------------X,..,.XXX...........X----------
-----------------XX..XX------------X........XX----X.W.A.,...........,....LA..A----------------------X..,,.X---X.........X-----------
-------------------XX---XXX--------XE.E.E..X------X.....,...........,....X..EX----------------------X....,X---X...E....X------------
----------------------XXXXXXXX----X.....XXX--------XA...,...........,,...XXXXX---XXXX--------------X.....,X---X.......X-------------
------------------------XXX-XX----XE.E.X-----------X.:..,...........,,,,,,XX---XX....XXXXXXXXXXXXXX......,.X--X......X--------------
----------------------XXXXXXXX---X.....X-----------X...,....................XXX.........,....WA.AA......,...XX......X---------------
----------------------XXXXXXXX---XE.E.X------------X..,..................................,..............,.....,....X----------------
----------------------XXXXXXXX---X...X-------------X.,...................................,....T........,....H..,..X-----------------
----------------------XXXXXXXX---XLLLX------------XX,.....................................,............,.......,.X------------------
----------------------XXXXXX-X---X.H.X---------XXX........................................,...........,.........X-------------------
-------------------------XX------X...X------XXX............................................,.........,.........X--------------------
--------------------------X------XH.HX--XXXX...............................................,.....,,,,.........X---------------------
---------------------XXXXXXXXX---X,,,XXX...............XXX.....XXX..........................,,,,,............X----------------------
---------------------X.....XXXXXXX,,,XXX...............X-H.,,,HX-X..........................................X-----------------------
--------------------X.....HXXXXXXX,,,XXX...ttt.........XXX,,,,,XXX..........................................X-----------------------
--------------------X......X...E......,,...t.t..H......,:,.,H,.,T,.........................................X------------------------
--------------------X......X.....E....,,...ttt.........XXX,,,,,XXX........XXXX.............................X------------------------
-------------------X.......X.E.E......X,...............X-X.,,,.X-X.......X----XX..........................X-------------------------
-------------------X.......X.......A..,,...............XXX.....XXX......X-------X.........................X-------------------------
------------------X........X.E.E..E.K.,,.......XX.......................X--------X.....................XXX--------------------------
------------------X........X.......A..X,.....XX--X.....................X----------X.....,,,,,,,......XX-----------------------------
------------------X........X.E.E......X,.A.XX-----X....................X----------X...,,.....E.,,....X------------------------------
------------------X........X.....E....,,W.X--------X...................X----------X.,,.........E.,..X-------------------------------
------------------X........X...E......,,.X---------X.................,,.X---------X,.......E.E....,.X-------------------------------
------------------X........XXXXXXXXXXXXXX---------X.,,.............,,..,X--------X,............E...,X-------------------------------
------------------X........XX,,,,,,,,,XXX---------X...,,,,,,,,,,,,,......X-------X.,...E.E.E.E......X-------------------------------
------------------X....................X----------X.........E.............XX---XX..,...............H.X------------------------------
-----------------X.....................X----------X.........,,,,,...........XXX....,...E.E.E.......,,.XX----------------------------
-----------------X.....................X----------X......,,,.....,,,,,,,...........,.............,,.....X---------------------------
-----------------X....................X------------X.....,..............,..........,...E.E......,.......X---------------------------
-----------------X....................X------------X....,................,.........,...........,.......X----------------------------
-----------------X....................X-------------X...,.......H.H.......,........,...........,.......X----------------------------
-----------------X...................X--------------X...,..................,,......,...AA.AA..,........X----------------------------
-----------------X...................X--------------X..,.....................,,.....,..W.W.W.,........X-----------------------------
------------------X..................X--------------X..,.....A.A.W.A.A.........XX...,..<A<A<,.........X-----------------------------
------------------X...................X-------------X..,......................X-X....,.:.:.:,........X------------------------------
-------------------X..................X-------------X..,.....................X---X....,....,........XX------------------------------
-------------------X...................X------------X.,.........H.H.........X----X.....,,,,......XXX--------------------------------
--------------------X..................X------------X.,.....................X-----X...........XXX-----------------------------------
--------------------X...................X-----------X.,....................X------XXXXXXXXXXXX--------------------------------------
---------------------X..................X----------X.,.......XXXX......XXXX---------------------------------------------------------
---------------------X...................XX--------X,......XX----XXXXXX-------------------------------------------------------------
----------------------XXX............XXXXXXXX----XXX...T...X------------------------------------------------------------------------
-------------------------XXXX.......X------X-XXXX..,......X-------------------------------------------------------------------------
-----------------------------XXX...X--------X.......,.....X----XXX------------------------------------------------------------------
--------------------------------X..X---------X......,,.....X-XX...X-----------------------------------------------------------------
---------------------------------XX----------X........,,....X..ttW.X----------------------------------------------------------------
----------------------------------XX---------X..........,,.....t.t.X----------------------------------------------------------------
-----------------------------------XXX------X.............,....tttX-----------------------------------------------------------------
------------------------------------X-XX--XX..............,.......X-----------------------------------------------------------------
-------------------------------------X--XX.................,.....X------------------------------------------------------------------
--------------------------------------XX....................,....X------------------------------------------------------------------
----------------------------------------XXX..................,,,X-------------------------------------------------------------------
-------------------------------------------XX................,..X-------------------------------------------------------------------
---------------------------------------------X...............,,..XX-----------------------------------------------------------------
----------------------------------------------X................,,..X----------------------------------------------------------------
----------------------------------------------X.....................X---------------------------------------------------------------
-----------------------------------------------X.....................X--------------------------------------------------------------
------------------------------------------------X....................X--------------------------------------------------------------
-------------------------------------------------X....................X-------------------------------------------------------------
--------------------------------------------------X....................X------------------------------------------------------------
---------------------------------------------------X...................X------------------------------------------------------------
---------------------------------------------------X...................X------------------------------------------------------------
----------------------------------------------------X..................X------------------------------------------------------------
-----------------------------------------------------X................X-------------------------------------------------------------
------------------------------------------------------XX..............X-------------------------------------------------------------
--------------------------------------------------------X.............X-------------------------------------------------------------
---------------------------------------------------------X............X-------------------------------------------------------------
----------------------------------------------------------XX........XX--------------------------------------------------------------
------------------------------------------------------------X....XXX----------------------------------------------------------------
-------------------------------------------------------------XXXX-------------------------------------------------------------------
