XXXXXXXXXXXXXXXXXXXXXXXXXXXXXXXXXXXXXXXXXXXXXXXXXXXXXXXXXXXXXXXXXXXXXXXXXXX------------------------------------
X...................................,,..........,..,,E,...................X------------------------------------
X...................................,,..........,,,XX,,...................X-------XXXXXXXXX--------------------
X...................................,,.............XX........,,,,,........X-------X-------X--------------------
X...................................,,.............XX........,..,.,.......HXHHXXXXX-----,,X--------------------
X...................................,,.............XX.......,.,,,,,,......XXXXXXX+XXXXXXXXX--------------------
X..........,,,,,,,,,,,,,,,,,,,,,,,,,,,.............XX.......,,.,,.,.,.....X-----X,XXXXXXXXXX-------------------
X..........,,,,,,,,,,,,,,,,,,,,,,,,,,,.......:.....XX......,,,.,.,.,,..A.XX-----X.....E....X-------------------
X..........,,.......................,,.............XX......,,.,.,,.,.,...XXXXXXXXW...:......X------------------
X..........,,..................XX...,,.............XX......,,,,.,,..,,...XX<<.,H,...........X------------------
X..........,,.................XX.,..,,.............XX......,,,,,.,...XXXXXX...XXXXXXXXXX....X------------------
X.....,,,,XXXXXXXXXXXXX......XXX,.X.,,.............XX......,,.,,,,,..XX---X<<.X---------X...X------------------
X.....,...XXXXXXXXXXXXX......,E.+XX.,,.............XX......,,,,,,XX,,XXXXXX...XXXXXXXXXXX...X------------------
X.....,...,.,.....E.:,,.....XXHH.X..,,.............XX......,,....XX.....................X,,,X-----+X-----------
X.....XX,,,.,........,,......,X.X...,,.............XX......,,....XX..A......:.........W.X,,,XXXXXXXXX----------
X.....XX....,......XXXX.......XX....,,.............XX......,,....XX.....................X........,E.X----------
X.....XX....,......X--X.............,,.............XX......,,....XX..XX,XXX,XXX,XXX,X...X.........,,X----------
X.....XX....,......X--X.............,,.............XX.XXXXXX,....XX..XX,X:X,X:X,X:X,X...X...........X----------
X.....XXE.K.,......X--X...E.........,,.............XX.XXXXXX,....XX..XX,XXX,XXX,XXX,X...X...........X----------
X...E.XX....,......XXXX.............,,.............XX.XX.LL,.....XX..EX,,,,,,,,,,,,,X...X...........X----------
X.....XX....,....E.,,...............,,.............XX.XX.LL,.....XX,,XX,,,,,,E,,,,,,XE..X,,,,,,.....X----------
X.....XX.,..,.....:,,...E...........,,.............XX.XXXXXX,.E..,,E.XX.E..,...,.E..X...X.....,.....X----------
X.....XX.,,,,......,,.........E.....,,.............XX......:,....XX,.XX,,,,,,,,,,,,,X..EX,,,,,,.....X----------
X.....XX.,,,......XXX.E.............,,,,XXXX,,,,,,XXXX,,,,,,,.:..XX.,XX...,..H..,...X,,.X....,,.....X----------
X.....XX.,,,......X-X...............+,,,XXXX,,,,,,XXXX,,,,,,,....XX..XX...,.....,.:.X..,X.H.H,,.....X----------
X.....XX.,,,......XXX...............+...,,,+......+,,,.....,,....XX.,XX...,....,....X,,.,..E.,,.....X----------
X.....XX.,,,.....E,+,...............+...,,,+......+,,,.....,,....XX,.XX....,,,,.....X..,X....,,.....X----------
X.....XXH,,,.....E,+,.E.............+...,,,+......+,,,.....,,....,,.,XX.............X...X....,,.....X----------
X.....XX.,,,......,+,...............+...,,,+......+,,,.....,,....XX,.XX.............X...X....,,.....X----------
X.....XX.,,,......XXX...............+...,,,+......+,,,.....,,....XX..XX......H......X,,.X....,,.....X----------
X.....XX.,,,......X-X..........E....+,,,XXXX,,,,,,XXXX,,,,,+,....XX,,XX,,,XXX,XXX,,XX..,X....,,.....X----------
X.....XX.,,,......XXX...............,,,,XXXX,,,,,,XXXX,,,,,:,.E..,,..,,,,X--XEX-X,,,,...,..E.,,.....X----------
X.....XX.,,,,......,,..E............,,.............XX......,,....XX..,,,.X--XAX-X,,,,.E.X....,,.....X----------
X.....XX.,..,.....:,,...............,,.............XX......,,....XX,,,.X,X--XAX-X,X.,,..X....,,.....X----------
X.....XX...H,....E.,,...E...........,,.............XX......,,....XX,,XXX,XXXXXXXX,XXXX,XX....,,.....X----------
X.....XX....,......XXXX.......X,X...,,.............XX......,,................................,,.....X----------
X.....XX....,......X--X...E.X,..XX..,,.............XX......,,................................,,.....X----------
X...E.XXE...,......X--X.....XXE.XX..,,.............XX......,,................................,,.....X----------
X.....XX....,......X--X......X.++.X.,,.............XX......,,................................,,.....X----------
X.....XX....,......XXXX......XXX.,..,,.............XX......,,,,,,,,,,,,,,,,,,,,,,,,,,,,,,,,,,,,.....X----------
X.....XX,,,.,.....E.:,,.......X-X...,,.............XX......,,,,,,,,,,,,,++++++,,,,,,,,,,,,,,,,,.....X----------
X.....,...,.,........,,........X....,,.............XX..................,,....,,.....................X----------
X.....,...XXXXXXXXXXXXX.............,,.............XX..................,,....,,.....................X----------
X.....,,,,XXXXXXXXXXXXX,,,,,,,,,,,,,,,.............XX..................,,....,,.....................X----------
X....................,,,,,,,,,,,,,,,,,.............XX................,,,,....,,.,,..................XXXXXXXX---
X..................................................XX...............,E,XX,,,,XX,E,..................X......X---
X..........................................XXXX,,,,XXXXXXXXXXXXXXXXXXXXXX,,,,XX,,,XXXXXXXXXXXXXXXXXXX.E.W..XXXX
X..........................................XXXX,,,,XXXXXXXXXXXXXXXXXXXX:X,,,,,:,.,...................,.K.....,X
X..........................................XX..................E.......,,,,,,,,.,,....................,.E.E..,X
X..........................................XX.....................E....,,,,,,,,....E...................,....,.X
XXXXXXXXXXXXXXXXXXXXXXXXXXXXXXXXXXX........XX..........................,,,++,,,.........................XXXX..X
----------------------------------X........XX..........................,,,E,,,,.........................X--X..X
----------------------------------X........XX..........................,,,++,,,.........................X--X.EX
----------------------------------X........XX..........................,,,E,,,,..E......................X--X..X
----------------------------------X........XX.....................E....,,,,,,,,.....E...................XXXX..X
----------------------------------X........XX..........................,,,,,,,,.........................,EH,..X
----------------------------------X,,,XXXXXXX......,,,,XXXXXXXXXXXXXXXX:X,,,,X:XXXXXXXXXXXXXXXXXX.......XXXX..X
----------------------------------X...XXXXXXX......,,,,XXXXXXXXXXXXXXXXXX,,,,XXXXXXXXXXXXXXXXXXXX.......X--X..X
----------------------------------X.......,+,......E,EE,...............XX,,,,XX................XX.......X--XE.X
----------------------------------X.......,+,......XX.,,...............,,....,,................XX.......X--X..X
----------------------------------X.......XXX+,,,,,XX,.................,,....,,................XX.......XXXX..X
----------------------------------X.......X-X+.....XX..................,,....,,................XX.......,EA,..X
----------------------------------XXXXXXXXX-X+.....XX.......,,,,,,,,,,,,,++++,,,,,,,,,,,,......XX.......XXXX..X
--------------------------------------------X+.....XX.......,,,,,,,,,,,,,,,,,,,,,,,,,,,,,......XX.......X--X..X
--------------------------------------------X+.....XX.......,..........................,,......XX.......X--X..X
--------------------------------------------X+.....XX.......,..................H.......,,......XX.......X--X..X
--------------------------------------------X+.....XX.......,..........................,,......XX.......XXXX,,X
--------------------------------------------X,,,,,,XX.......,..........................,,......XX.......XX....X
--------------------------------------------XX,,,,,XX.......,.....XXXXX,,,XXX,,,XXX....,,......XX.......XX....X
--------------------------------------------XX,,,,,XX.......,....X.HXXX.E.XXX.E.XXXX...,,......XX.......,,E...X
--------------------------------------------X......XX.......,...X...,.,...,.,...,,.XX..:,......XX.......XX....X
--------------------------------------------X.E.E..XX.......,.E.XXXH,.,E..,.,...,,.XXE.,,......XX.......XX....X
--------------------------------------------X,,,,,,XX.......,...X:X.,,,...,.,.E.,,.XX..,,......XX,.....,XX....X
--------------------------------------------X,,,,,,XX.......,...XHXXXXX...,.,...,,.,,..,,.,,,,,X:,,,,,,:XX....X
--------------------------------------------X,,,,,,XX.......,...X,,,..X...,.,...,,.,,..,,.,....,,.......,,....X
--------------------------------------------X......XX.......,...,,,,E.+...,.,...,,.,,..,,.,.E..,,.......,,.:..X
--------------------------------------------X......XX.......,...,,,,..+...,W,...,,.,,..,,.,,,,,XX,,,,,,,XX....X
--------------------------------------------X..H...,,.......,...,,,,E.+...,.,...,,.,,..,,......X:,.....:XX....X
--------------------------------------------X......XX.......,...XXXXXXX...,.,...,,.XX..,,......XX.......XX....X
--------------------------------------------XXXXXXXXX.......,...X:X.,.,...,.,...,,.XX..:,......XX.......XX....X
----------------------------------------------------X.......,...XXXH,.,E..,.,.E.,,X-X..,,......XX.......XXE...X
----------------------------------------------------X.......,....XXXXXX,,,XXX,,,XX-X...,,......XX.......XX..E.X
----------------------------------------------------X.......,.....XXXXX,,,XXX,,,XXX....,,......XX.......XX....X
----------------------------------------------------X.......,..........................,,......XX.......XX....X
----------------------------------------------------X.......,..........................,,......XX.......XX,,XXX
----------------------------------------------------X......,,,,,,,,,,,,,,,,,,,,,,,,,,,,,,......XX.......XX..X--
----------------------------------------------------X.....,E.,,,,,,,,,,,,,,,,,,,,,,,,,,,,......XX.......XX..X--
----------------------------------------------------X......,.,.................................XX.......XX..X--
----------------------------------------------------X.......,..................................XX.......XX..X--
----------------------------------------------------X,,........................................XX.......XX..X--
----------------------------------------------------XE.,..........,,,,.........,,,.............XX.,,,,,.,...X--
----------------------------------------------------X.E.,.........,.E.,.......,E.E.............XX.,...,.,...X--
----------------------------------------------------X,,,XXXXXXXXXXX,,,XXXXXXXXX,,,XXXXX,XXXXXXXXXXX,,,XXXXXXX--
----------------------------------------------------X...,.........,...,.......,..,...XX.............E...X------
----------------------------------------------------X,,,..........,...,........,,,...XXE..E.............X------
----------------------------------------------------X.............,...,..............XX.................X------
----------------------------------------------------X.............,...,..............XX.................X------
----------------------------------------------------X..XXXXXXXXXXXX,,,XXXXXXX........XX.................X------
----------------------------------------------------X..X---XXXXXXXX,,,XXXXXXX........XX..XXXXXXXXXXXXXXXX------
----------------------------------------------------X..X---X.....,.........X:........XX.HX---------------------
----------------------------------------------------X..XXXXX.....,.........XX,,,.....XX..XX--------------------
----------------------------------------------------X..XX.XX.....,........E,,..,.....XX...X--------------------
----------------------------------------------XXXX--X..XE.,X.....,,........XX..,.....XX...X--------------------
----------------------------------------------X..X--X..XX,,,......,,,......::..,.....XX...X--------------------
----------------------------------------------X..X--X..XX,,,,......,,,,..XXXX..,.....XX...X--------------------
---------------------------------------------XX..XXXX..,,,,,,......,,,,..X,,,..,,,,,,XX...X--------------------
--------------------------------------------->..,++W,..,,.,,,.:....,,,,..L,,,.......,,,...X--------------------
---------------------------------------------XX.,++.,..,,,,,,......,,,,..X,,,.......,,,...X--------------------
----------------------------------------------X.XXXXX..XX,,,,......,,,,..XXXX..,,,,,,XX...X--------------------
----------------------------------------------X.X---X..XX,,,,.E...,,,....XX::..,.....XX...X--------------------
----------------------------------------------X.X---X..XE,,,.....,,........XX..,.....XX...X--------------------
----------------------------------------------XXX---X..XXWXX.....,........E,,..,.....XX...X--------------------
----------------------------------------------------X..XX.XX.....,.........XX..,.....XX...X--------------------
----------------------------------------------------X..XXHXX.....,.........X:..,.....XX...X--------------------
----------------------------------------------------X..XX+XX.....,.........XX..,.....XXE.EX--------------------
----------------------------------------------------X..XX,XXXXX,XXX,XXX,XXXXX..,.....XXXXXX--------------------
----------------------------------------------------X...,A.....E...E...E.......,.....X-------------------------
----------------------------------------------------X...,......................,.....X-------------------------
----------------------------------------------------X...,,,,,,,,,,,,,,,,,,,,,,,,.....X-------------------------
----------------------------------------------------X................................X-------------------------
----------------------------------------------------X................................X-------------------------
----------------------------------------------------X................................X-------------------------
----------------------------------------------------XXXXXXXXXXXXXXXXXXXXXXXXXXXXXXXXXX-------------------------
