---------------------------------------------XXXXX------------------------------------------------------------------------------------------------------------
---------------------------------------------X.H.X------------------------------------------------------------------------------------------------------------
--------------------------------------XXXXXXXX,,,XXXX---------------------------------------------------------------------------------------------------------
--------------------------------------X..,..........X---------------------------------------------------------------------------------------------------------
--------------------------------------XE.,..........X---------------------------------------------------------------------------------------------------------
--------------------------------------X..,..........X---------------------------------------------------------------------------------------------------------
--------------------------------------X..,..........X---------------------------------------------------------------------------------------------------------
--------------------------------------XE.,..........X---------------------------------------------------------------------------------------------------------
------------------------------XX------X..,.,,,......X---------------------------------------------------------------------------------------------------------
-----------------------------X..XX----XXXX.,E,.....HX---------------------------------------------------------------------------------------------------------
----------------------------X.....XX-----X.,,,......X---------------------------------------------------------------------------------------------------------
---------------------------X..>>....X--XX..........HX---------------------------------------------------------------------------------------------------------
--------------------------X>.>..>...XXX.............X---------------------------------------------------------------------------------------------------------
--------------------------X.>...>..,X..............HX----------------------XXXXXXXXX--------------------------------------------------------------------------
--------------------------X.....>..,L.,,............X--------------------XX.......H.X-------------------------------------------------------------------------
--------------------------X.>...>..,X..............HX-------------------X.....,,....X----------XXXXXXXXXXXXXXX------------------------------------------------
--------------------------X>.>.>....XXX....,,,......X-----------------XX.....,..,,,..X-------XX...............XX----------------------------------------------
---------------------------X..>.....X--XX..,E,.....HX----------------X......,......,.X------X...................XXX-------------------------------------------
----------------------------X.....XX-----X.,,,......X----------------X..A...,......,..X---XX.......................XX-----------------------------------------
-----------------------------X..XX-------X.........HX----------------X.......,.....,..X-XX...........................XX---------------------------------------
------------------------------XX---------X..........X---------------X.E.X.....,....,...X................E...E..........XX-------------------------------------
-----------------------------------------X.........HX---------------X.XX-XX....,,,..,..,..............E..................XX-----------------------------------
-----------------------------------------X.,,,......XXXX+++XXXX-----XX-----X.....,..,..,............................:......XX---------------------------------
-----------------------------------------X.,E,.....A,.,.......X-------------X.....,.,.,......................................X--------------------------------
-----------------------------------------X.,,,......,.,.......X--------------X....,.,.,...........:.E.....E..................X--------------------------------
-----------------------------------------X..........,.,.......XXXXXXXXXXXXXX--X...,.,.,:......................................X-------------------------------
-----------------------------------------XXXXXXXXXXXXXX.,,,...,....,.......X--X..,..,.,...............E.......................X-------------------------------
------------------------------------------------------+.,W,...,...,.........X-X.,,..,.,........................................X------------------------------
------------------------XXXXXXXXXXXXXXXXXXXXXXXXXXXXXXX.,,,...,...,...E.H.E.X-X.,...,..,............A...E...E..................X------------------------------
------------------------X...,........................+,.......XX.,...........XX.,,,,...,........................................X-----------------------------
------------------------W.E.,.................:......+,.......X-XX..E...E....XX........,:...:...................................X-----------------------------
------------------------X...,........................+,.......X--X...........XX........,.....................,,,,,,,,......A.....X----------------------------
------------------------XXXXX...XXXXXXX,,,,,XXXXXXXXXXXX++++XXX--X.H..A.....HX-X........,....W.......:......,........,X.......:..X----------------------------
----------------------------X...X-----X.....X-------------XXX----X....E..A...X-X........,.................,,.........,XXX.........X---------------------------
----------------------------X...X-----X.H.H.X------------X...X---X..........AX-X........,.:..............X,,,,,,,,,,,.X--X........X---------------------------
----------------------------X...X-----X.....X-----------X....X---X.H.XXX.....X-X.........,...............X...E.E.E.E.EX---X........X--------------------------
----------------------------X...X-----XEHEHEX----------X......X--X..X--X..A..X-X.........,...............XX...........X---X........X--------------------------
----------------------------X...X-----X.....X----------X.....,.XX-XXX--X....X--X..........,.............X-X..E.E.E.E.EX----X.......X--------------------------
----------------------------X...X-----X.A.A.X---------X.....,....X--XXX.,...X--X...........,.:..........X--X..........X----X.......X--------------------------
----------------------------X...X-----X.....X---------X....,.....X---X..,..EX--X............,........H..X--X.E.E.E.E.EX-----X......X--------------------------
----------------------------X...X-----XEEEEEX--------X....,.......XXX....E..X-X.......:.....,...........X---XXXXXXXXXXX-----X.....X---------------------------
----------------------------X...X-----X.....X--------X...,................,X--X....,,........,,..:...:..X-------------------X.....X---------------------------
----------------------------X...X-----XXXXXXX--------X...,............E.E.,X--X....,.,.......,.,,.......X-------------------X.....X---------------------------
----------------------------X...X--------------------X..,....:..........XXXX--X....,..,......,...,,...,,.X------------------X....X----------------------------
----------------------------X...X-------------------X...,...........XXXX-----X......,.,.....,......,,,...X-----------------X....X-----------------------------
----------------------------X...X-------------------X..,............X--------X......,.,.....,......,......X----------------X....X-----------------------------
----------------------------X...X-------------------X..,.........E..XX-------X......,.,......,....,........X---------------X...X------------------------------
----------------------------X...X-------------------X,,...............XXX--XX.......,.,..A...,..,,.........X-----------XXXXX,,X-------------------------------
----------------------------X...X--------------------X,........XX........XX......:.,..,.......,,....H......X----------X..:....X-------------------------------
----------------------------X...X--------------------X,....,.XX-X..................,..,...................X----------X........:X------------------------------
----------------------------X...X---------------------X,..E,.XXX-X................,..,................E...X----------X:........X------------------------------
----------------------------X...X---------------------X,...,,XXX-XX............A..,..,........XX.........X----------X.......W..X------------------------------
--------XXX-----------------X...X---------------------X,...,,XX.X--XX............,..,..:......X-XX......X-----------:...........X-----------------------------
--------X.X-----------------X...X----------------------X,,,,....XX--X............,.,..........X---XXX..X-----XX----X...<.<.....:X-----------------------------
--------XHX----------------X....X----------------------XX,,,...E..XX-X....,,...,,.,...........X------XX----XX..XX--X............,X----------------------------
--------XEX----------------X....X----------------------XX..,,,,..EAX-X...,..,,,..,.:..........X-----------X.....X--X...<.<.....,..XX--------------------------
-------X...X--------------X....X-------------------------X..,.,.....X-X.,,,,,,.:.,.............X--------XX.,....X---X:......:.XX....X-----XXXXXXXXX-----------
-------X,,,X--------------X....X-------------------------X..,..,..XXXX..,,....,..,..............XXXXXXXX..H,....X---X....:...X-X.....X----XE.EHE.EX-----------
------X.....X------------X.....X-------------------------X...,,..H.X....,,....,.,...........................,...X---XX.....XX---X.....XX--XEE.EE.EX-----------
-----X.......X-----------X.....X--------------------------X..,,..........,....,.,........................EE.,...X-----X,XXX-----X.......X-X.......X-----------
----X.A..:..A.X---------X,,,..X---------------------------X..,,................,,.....XXX................E.,....X-----X,X--------X.......XX,,,,,,,XXXWX-------
---X...........X--------X...,,X--XXXXXXX------------------X..,.,........XX.....,,....X---XX........,....,,,,...X------X..X-------X.......XX........,,.X-------
--X....,,,,.....X-------X.....X--X......XXXXXX------------X...,,......XX--X....,,...X------X.....,,,...,..,,...X----XX++++X-------X......XX........,,,X-------
-X.....,,.,......X------X,,...X-X.............XX-----------X..,.,.....X----X...,,....X------X..,,...,,,.,,.,...X---X,.,K,,,XX-----X......XX...........X-------
X......,,,,.......X-----X..,..X-X...............XX---------X...,,.....X-----X..,,.....X---X--X.,....,,,,..XX.XX---X.,,,,,,,..X-----X..W..XX...........X-------
X,,.............,,X----X.,..,,X-X.................X--------X...,.,...X------X.,.,...E.X--X.X-X..,,,,.....X--X----X............XX---X.....XX......W....X-------
X..,..A.....A..,..XXXXX..,....XX...................XX-------X...,.,..X------X.,.,....X--X,A,X...........X-------X...............X---X....XX...........X-------
X...,,.......,,...,.,.,...,...XX.....................XX----XX....,,...X----X..,.,....X--X..............X--------X..E.H.E.E.H.E..X---X....++......W....X-------
X.....,,,,,,,.....,K,.,....,.X-X.......................X----X....,.,..AX-XX...,.,...X---X............XX----------X.............X----X,XXXXX...........X-------
X.....,.....,.....,.,.,....,.XX........................X----XX....,.,...X....,..,..X---X..EH........X------------X...E.E.E.E...X----X.X---X........B..X-------
X.....,.....,.....XXXXXXXXXXX-X.........................X-----X....,.E,......,.,...X---X...........X--------------XXXXXXXXXXXXX-----X.X---X...........X-------
X.....,.....,.....X-----------X.........................X-----X,...,...,....,.,...X----XXX..E...XXX---------------------------------X.X---A...........X-------
X.,,,.,.....,.,,,.X----------X..........................X------XX...,,..,,,,.,...X--------XXXXXX------------------------------------X.X---XXXXXXX,XXX,X-------
X.,A,.,.....,.,A,.X----------X...........................X-------XX...,,.....,....XX------------------------------------------------X.X---------XEX-XEX-------
X.,,,.,.....,.,,,.X----------X...........................X---------XX...,,..,.....E.X-----------------------------------------------X.X---------XXX-XXX-------
X.....,.....,.....X---------X.............................X----------X....,,,.....XX------------------------------------------------X.X-----------------------
X.....,.,,,.,.....X---------X.............................X-----------XX..,.,....X----------------------------------XEEEXXXXXXXXXXXXX+XXXXXXXXXXXXXXXXXXX-----
X.....,,..,.,.....X---------X.............................X---------XXX-X,,.,...,.X---------------------------------XEEE+..........++.+.................A-----
X.....,....,,.....X--------X..............E................X------XX...X..,,,,,,,X---XXXXX--------------------------XEEE+............+..................X-----
X.....+....,,.....X--------X...............................X------X.H..........,.X---X...X--------------------------XEEE+...............................X-----
X.....+,...,,.....X--------X...............................X------X..XXX.......XX---X...E.X-------------------------X,,XX..XXX........XXX........XXX....X-----
X.....,.,,,.,.....X-------X................................X------X..X--XXXXXXX-----X.....X-------------------------X.HXX..X-X........X-X........X-X....X-----
X.....,.....,.....X-------X................................X-------XX-XXXXX--------X......W-------------------------XXXXX...XX.........XX.........XX....X-----
X.....,.....,.....X-------X................................X-------X.XX....X-----XX........X----------------------------X...A..........A..........A.....X-----
X.,,,.,.....,.,,,.X--------X...............................X------X,,.......XXXXX.......E..X----------------------------X...............................X-----
X.,A,.,.....,.,A,.X--------X...............................X-----X.........................X----------------------------X...............................X-----
X.,,,.,.....,.,,,.X---------X..............................XXX--X...................XXXX..X-----------------------------X.......XXXX.......XXXX.........X-----
X.....,.....,.....X---------X..............................,..XX....................X---XX------------------------------X.......X--X.......X--X.........X-----
X.....,.....,.....X---------X..............................,...,....................X-----------------------------------X........XX.........XX..........X-----
X.....,.....,.....X----------X..............................,...,...................X-----------------------------------X....................A..........X-----
X.....,.....,.....XX---------X..............................,...,..........X.....,,,X-----------------------------------X...............................X-----
-X....,.....,....,..XX-------X..............................,.H..,,......XXX....,...X-----------------------------------X...............................X-----
--XXXXX,,,,,XXXXXX.,,.X-------X.............................,......,,..,,X--X..,...EX-----------------------------------X...............................XXXXX-
------XH...HX-----X....X------X.............................,........,,...X-X..,E...X-----------------------------------X...............................+,..X-
-------X.T.X-------X....X------X...........................,..............XX-XX,...X------------------------------------X...............................+,E.X-
-------XXXXX-------X..++.X-----X...........................,................X--XXXX-------------------------------------XA..............................A,:.X-
--------------------X+....X----X...........................,......E..........XXXX---------------------------------------X,,,,,XXXXXXXXXXXXXXXXXXXXXXXXXXXX,,X-
--------------------X.....,X--X...........................,.................,....XXX------------------------------------XE.E.E,:.:X----------------------X..X-
--------------------X.,,,,.X--X...........................,..H............H.,.......X-----------------------------------X....:,HE.X----------------------XE.X-
--------------------X,.....X-X.........,,................,.................,.........X----------------------------------XE.E.E,:.:X----------------------XH.X-
--------------------X......X-X.........,,............,,,,.............H....,..........X---------------------------------XXXXXXXXXXX----------------------XXXX-
-------------------X....+++XX..........,.XXXXXXXXX,,,....H.............,,,,............XX---------------------------------------------------------------------
-------------------X++++..............,.LX-------X.................,,,,.............E....X--------------------------------------------------------------------
-------------------X...............,.,LL,.X------X..............H..,....................A.X-------------------------------------------------------------------
-------------------X...............,,L,,.H.X------X...XXX..........,............E.....A....X------------------------------------------------------------------
-------------------X................XX.....X------X...X-X.........,....................A.A..X-----------------------------------------------------------------
-------------------X................X-X...,.XXXXXXX...X-X...H.....,.........................X-----------------------------------------------------------------
--------------------X...............X--XH.,.,.H,A.+...HX.......,,,,....................A.A..X-----------------------------------------------------------------
--------------------X...............X--X..,A,.A,.A+,......,,,,,.......................E..A.X------------------------------------------------------------------
--------------------X...............X---X,.H,...,..+.....,.................................X------------------------------------------------------------------
--------------------X...............X----XX..,.A,.HXX....,................E.......E........X------------------------------------------------------------------
--------------------X...............X------XX,..XXX--XX.,..................................X------------------------------------------------------------------
--------------------X...............X--------XXX-------X...................................X------------------------------------------------------------------
--------------------X...............X------------------X..................................X-------------------------------------------------------------------
--------------------X................XX---------------X.............E.....................X-------------------------------------------------------------------
--------------------X..................X--------------X...................................X-------------------------------------------------------------------
---------------------X........H.........X------------X....................E....E....E....X--------------------------------------------------------------------
---------------------X...................XX----------X..................................X---------------------------------------------------------------------
---------------------X.....................X--------X...................................X---------------------------------------------------------------------
---------------------X......................XXXXXXXXX..................................X----------------------------------------------------------------------
---------------------X................................................................X-----------------------------------------------------------------------
---------------------X...............................................................X------------------------------------------------------------------------
---------------------X................................................E.......E......X------------------------------------------------------------------------
---------------------X..............................................................X-------------------------------------------------------------------------
---------------------X............E........H.......................................X--------------------------------------------------------------------------
----------------------X...........................................................X---------------------------------------------------------------------------
----------------------X..........................................................X----------------------------------------------------------------------------
----------------------X..........................................................X----------------------------------------------------------------------------
----------------------X.........................................................X-----------------------------------------------------------------------------
----------------------X......................................................XXX------------------------------------------------------------------------------
-----------------------XX...............................................XXXXX---------------------------------------------------------------------------------
-------------------------XX........................................XXXXX--------------------------------------------------------------------------------------
---------------------------XX...................................XXX-------------------------------------------------------------------------------------------
-----------------------------XX................................X----------------------------------------------------------------------------------------------
-------------------------------X.............................XX-----------------------------------------------------------------------------------------------
--------------------------------XX..........................X-------------------------------------------------------------------------------------------------
----------------------------------XX.......................X--------------------------------------------------------------------------------------------------
------------------------------------XX...................XX---------------------------------------------------------------------------------------------------
--------------------------------------XX................X-----------------------------------------------------------------------------------------------------
----------------------------------------XXXXXXXXXXXXXXXX------------------------------------------------------------------------------------------------------
