--------------------------------------------------------------XXXXX----------------------------------------------------------
--------------------------------------------------------------X...X----------------------------------------------------------
--------------------------------------------XXXXXXXXXXXXXXXXXXX,,,XXXXXXXXXXXXXXXXX------------------------------------------
--------------------------------------------X................:....:...............X------------------------------------------
--------------------------------------------X.............................,,,.,,,.X------------------------------------------
--------------------------------------------X.............................,.,.,T,.X------------------------------------------
--------------------------------------------X.............................,T,.,,,.X------------------------------------------
--------------------------------------------X.....................................X------------------------------------------
--------------------------------------------X.,,,,,,,,,,,,,.........,,,,,,,,,,,,,.X---XXXXX----------------------------------
--------------------------------------------X.,...........,.........,...........,.X--X.....X---------------------------------
--------------------------------------------XH,............,.......,............,.X-X.,,,,,.X--------------------------------
--------------------------------------------X.,..H.........,.......,........A..,..X-:.,...,:X--------------------------------
------------------------------------XXXXXXXXX,,.............,,HH,,,.H.........,...X-X.,...,.X--------------------------------
-----------------------------------X..........,............................A.,....X-X.,.T.,.X--------------------------------
----------------------------------X...........,.............................,.....X-X.,,,,,.X--------------------------------
----------------------------------X,,..........,.........................A..,.....X--X.....X---------------------------------
----------------------------------X:,...........,.............ttt...........,.....X---X...X----------------------------------
----------------------------------X,,...........,.............t.t............,....X---X...X----------------------------------
----------------------------------X.............,.............ttt.............,...X---X..:X----------------------------------
-----------------------------------X...........,..............................,...X---X...X----------------------------------
------------------------------------XXXXXXX...,.........,,,....................,..X---X+++X---XXXXXXX------------------------
------------------------------------------X...,.........,.,.....................,.X---X...X---X....AX------------------------
------------------------------------XXXXXXX...,,,,,,,,,,,,,,,,,,,,,,,,,,,,,,,,,,,.XXXXX...XXXXX.ttt.X------------------------
------------------------------------X.....,...,.........,.............,.........,.,...,...LL....t.tAX------------------------
------------------------------------X,K...,...,.........,.............,.........,.,...,...LL....tttAX------------------------
------------------------------------X,,...,...,.........,.............,.........,.,...,...LL........X------------------------
------------------------------------XXXXXXX...,,,,,,,,,,,,,,,,,,,,,,,,,,,,,,,,,,,.XXXXXXXXXXXXXXX.XAX------------------------
------------------------------------------X...,.......................,.,.......,.X--------------X---------------------------
------------------------------------XXXXXXX...,.......................,,,.......,.X-XXXXXXXXXXXXXXX--------------------------
-----------------------------------X...........,...............................,..X-X............KX--------------------------
----------------------------------X.............,.............ttt.............,...X-K....E....E...X--------------------------
----------------------------------X.............,.............t.t............,....X-X...........E.X--------------------------
----------------------------------X,,...........,.............ttt...........,.....X-X,............X--------------------------
----------------------------------X:,...E......,............................,.....X-X,,,..E.:.....X--------------------------
----------------------------------X,,.........,.............................,.....X-X,,,XXXXXXX...X--------------------------
-----------------------------------X..........,...........................H..,....X-X,,,X-----X...X--------------------------
------------------------------------XXXXXXXXX,,.............,,,,,,,........H..,...X-X,,,X-----X...X--------------------------
--------------------------------------------X.,..........H..,.HH..,.........H..,..X-X,,,X-----X...X--------------------------
----------------------------------XXXXXXXXXXX,,............,.......,.........HH.,.X-X,,,X-----X...X--------------------------
----------------------------------H....++.....,............,.......,...........H,.X-X,,,X-----X...X--------------------------
----------------------------------X....++.....,..H.........,.......,............,.X-X,,,X-----X,,,X--------------------------
----------------------------------H....++.....,...........,.........,.........E.,.X-X,,,X-----X,,,X--------------------------
----------------------------------HXXXXXXXXXX.,,,,,,,,,,,,,.........,,,,,,,,,,,,,.X-X,,,X-----X,,,X--------------------------
--------------------XXXXXXXXXXXXXXXXXXXXXXX-X.....................................X-X,,,X-----X,,,X--------------------------
--------------------X......,,,,,,,,,......X-X.....................................X-X,,,X-----X,,,X--------------------------
--------------------XE.....:,,,,W,,,:.E.E.X-X....................................HX-X,,,X-----X,,,X--------------------------
--------------------X...,,,,,,,,,,,,,,,E..X-XXXXXXXXXXXXXXXXXXXXXXXXXXXXXXXXXXXXXXX-X,,,X-----X,,,X--------------------------
--------------------X.E.,,,,,,,,,,,,,,,..EX-----------------------------------------X,,,X-----X,,,X--------------------------
----------XXX-------X...,............,,...X---XXXXXXXXXXXXXXXXXXXXXXXXXXXXXXXXXXXXXXX,,,XXX-XXX,,,XXXXXXXXXXXXXXXXXXX--------
----------XKX-------X...,............,,E..X---:.....,..E..................................X-X..................++...X--------
--------XXX,XXX-----X...,,:........,:,,...X---X...E.,.........................E..E........X-X.......E..........++...X--------
--------X.....X-----X...,,,........,,,,E..X---X.E...,...........E.......................E.X-X..................++...X--------
------XXX,,,,,XXX---X...,............,,...X---X.....,.......E.............................X-X..................++.:.X--------
------XH......E.X---X...,............,,.E.X---X.....,.....E..................E............X-X..................++...X--------
XXXXXXX,,,,,,,,,XXXXX...,,,,,,,,,,,,,,,...X---X.....XXXXXXXXXXX:X,,,,,,,:AX:X,,,,,,,:XXXXXX-X:X,,,,,,,:XXXXXXXXXX...X-XXXXX--
XA.................XX...................E.X---X.....X-----XXXXXXX.......X---X.......X-XXXXXXX-X.......X---------X...X-X....X-
X.................EXXXX,,,XXXXX+++XXXXXXXXX---X...:.X-----X,,,,XX,,,,,,,XXXXX,,,,,,,XXX,,,,,XXX,,,,,,,XXX-------X...XXX.ttt.X
XA.................X--X...X---X+++X-----------X.....X-----X.............................................XXXXXXX-X...L.,.t.t.X
X..................X--X...X---X...X-----------X.....X-XXXXX...............,,,,,,,,,.....................,.....X-X...L.,.t.t.X
X..,,,,,,,,,,,,,,,EX--X...X---X...X-----------X.....X-X...,...............,......A,.....................,.....X-X...L.,.t.t.X
X..,............,,.XXX....X-XXX,,,XXX---------X.....X-X...,...............,.......,.....................,H....X-X...XXX.ttt.X
X..,:.....W....:,,.XX:....XX........X---------X.....X-X...,...............,.E....A,.....................,H....X-X...X-X....X-
X..,,,,,,,,,,,,,,,.XXX....X.......:..X--------X.....X-X...,...............,.......,...............,,,,,,XXX,,,X-X...X-XXXXX--
X..,,,,,,,,,,,,,,,HX--X...X:.........:--------X.....X-X...,...............,......A,...............,,,,,,X-X..HX-X...X--------
X..................X--X...X..........X--------X.....X-XXXXX...............,.......,...............,,,,,.X-X..HX-X...X--------
XE................AX--X:..XX.........X--------X.....X-----X...............,.......,...................,,X-X..HX-X...X--------
XXX,,,XXX,,,,,,,,,XX--X...X-X+++++++X---XXXXXXX,,,,,XXXXXXX...............,,,,,,,,,...................,,X-XXXHX-X...X--------
--X...X-E.EE.EEE.EX-XX....X-:......:X---W....:......:....XX...........................................,.X-------X...X--------
--X+E+X-XE..E.....X-X:....X-X.,,,,,.X---X................XX.....,,,,,,,,,,,,,,,,,,,,,,,,,,,,,,,.......,,X-------X,,,X--------
--X...X-X..AAE.AE.X-XX....X-X.,,,,,.X---X................,,.....,.............................,.......,,X-------X,,,X--------
--X...X-AXXXXXXXXHX---X...X-X.,..,,.X---X................,,.....,:..........................:.,.......,.X-------X...X--------
--X...X-XE..,..X------X...X-X.,..,,HX---X................,,.....,.............................,.....,.,,X-------X...X--------
-XX...X-X,,XXE.XXXXXXXX,,,X-X.,..,,HX---X....:...........XX.....,.............................,...,,.,,,X-------X,,,X--------
-X,...X-X..XX..XX........EX-X.,..,,.X---X................XX.....,.............................,...,.....X-------X,,,X--------
-X,...X-X..XX..XXE,,,,,,,,X-X.,..,,HX---XXX.XXX,,,XXX.XXXXX.....,.....,,,,,,,,,,,,,,,,,,,,,...,..,......X-------X,,,X--------
-X,...X-X..XX..XX,,,,,,E,,X-X.,..,,HX-----X.X-X...X-XEX---X.....,.....,...................+...,..,......X-------X,,,X--------
-X,...X-X,,XX..XX,,,XXXXXXX-X.,..,,HX-----XEX-XLLLX-XXX---X.....,.....,...................+...,.,.......XXXXXXXXX,,,X--------
-X,...X-X,,XX..XX...XXXXXXXXX.,..,,.X---------XLLLX-XXX---X.....,.....,...................+...,.,:......,.......,...X--------
-X,...X-X,,XX..XX...XHHE.EE+,.,..,,.X-----XXX-X...X-XWX---X.....,.....,...................+...,.,.......,.......,...X--------
-X,...X-X,,XX..XX...XHHE.EE+,.,..,,.X-----X.X-X...X-XHX---X.....,.....,...................+...,.,.......,.......,...X--------
-X,...X-X,,XX..XX...XHHE...+,.,..,,.X----X.<X-X,,,X-X+X---X.....,.....,...+++++++++++++...+...,..,......XXXXXXXXX...X--------
-X,...X-X,,XX..XX...XH...EE+,.,..,,.X----X...XX...X-X.X---X.....,.....,...+H..........,...+...,..,......X-------X...X--------
-XX...X-X,,XX..XX...XAE.EEE+,.,..,,.X-XXX....XX,,,XXX.XXX-X.....,.....,...+.........A.,...+...,,,,......X-------X...X--------
--X...X-X,,XX..XX...XAE.EEE+,.,..,,.X-:................:X-X.....,.....,...+...........,...+...,..,......X-------X...X--------
--X...X-X,,XX..XX,,,XXXXXXXXX.,..,,.X-XXX.............XXX-X.....,.....,...+...........,...+...,..,......X-------X...X--------
--X...X-X,,XX..XX.......E.X-X.,..,,.X---X...........XX----X.....,.....,...+...........,...+...,..,......X-------X...X--------
--X,,,XXX,,XX..XX,,,,,,,,,X-X.,..,,.XXXXX..........XXXXXXXX.....,.....,...+.,.,,......,...+...,..,......XXXXXXXXX,,,XXXXXXX--
--XE....,,,XX..XX,,,,,,,,,X-X.,..,,.,.,.,...,,,,...<X...LL,.....,.....,...+.,.,.,,....,...+...,..,......,...,.,.....L.,...>--
--X.....,.:XX..XXXXXXXX,,,X-X.,..,,.,.,.,...,..,...XX...LL,.....,.....,...+.,..,K,....,...+...,..,......,...,.,.....L.,...>--
--X.....,..XX..X------X...X-X.,..,,.,.,.,...,T.,...XX...LL,.....,.....,...+....,,.,...,...+...,..,......,...,.,.....L.,...X--
--XXXXXXXXXXX,,XXXXXX-X...X-X.,..,,.XXXXX...,,,,...<XXXXXXX.....,.....,...+......,,...,...+...,..,......XXXXXXXXX,,,XXXXXXX--
---X..HHHHH.....HHHH.XX....XX.,..,,.X---X..........XX-----X.....,.....,...+...........,...+...,..,......X-------X...X--------
---:.E,,,,,,,,,,,,,.:XX...:XX.,..,,.X-XXX............XXXX-XA....,.....,...+...........,...+...,..,......X-------X...X--------
---X..,,,,,,,,,,,,E..XX....XX.,..,,.X-:................:X-X.....,.....,...+...........,...+...,..,......X-------X.:.X--------
----AXXEXXX,,XXXXXXXX-X...X-X.,..,,.X-XXX....XX,,,XXX.XXX-X.....,.....,...+...........,...+...,..,....W.X-------X...X--------
------X+X-X..X--------X...X-X.,..,,.X---X....XX...X-X.X---X.....,.....,...+...........,...+...,,,,......X-------X...X--------
------XHX-XE.XXXXXXXXXX,,,X-X.,..,,AX----X...XX,,,X-X+X---X.....,.....,...+,,,,,,,,,,,,...+...,..,......XXXXXXXXX...X--------
------XHX-X..XX...........X-X.,..,,.X----X.<X-X...X-X+X---X.....,.....,...................+...,..,......,.......,...X--------
------XHX-X..XX,,E,,,,,,,,X-X.,..,,AX-----XXX-X...X-XHX---X.....,.....,...................+...,.,.......,.......,...X--------
------XAX-X..XXE,,,,,,,,E,X-X.,..,,.X---------X...X-XAX---X.....,.....,...................+...,.,.......,.......,...X--------
----XXXXXXX..XX,,,XXXXXXXXX-X.,..,,.X-----XXX-XLLLX-XXX---X.....,.....,...................+...,.,:......XXXXXXXXX,,,X--------
----A.EEE,,..XX...X-XXXXXXXXX.,..,,.X-----X.X-XLLLX-X.X---X.....,.....,...................+...,.,.......X-------X,,,X--------
----X....,,..XX...X-HH.E.EE+,.,..,,.X---XXX.XXX,,,XXX.XXXXX.....,.....,++++++++++++++++++H+...,.,.......X-------X,,,X--------
----H.EEE,,..XX...X-HH.....+,.,..,,.X---X................XX.....,.............................,.,.......X-------X,,,X--------
----H.EEE,,..XX...HXA..E.EE+,.,..,,.X---X................XX.....,.............................,.,.......X-------X,,,X--------
----X...E,,..XX....:A.E.EEE+,.,..,,.X---X.........:......,,.....,.............................,..,......X-------X...X--------
----HXEEXXX..XX....XX......+,.,..,,.X---X................,,.....,.............................,...,...,,X-------X...X--------
----------X..XX...HXA.E.EEE+,.,..,,.X---X................,,.....,:..........................:.,....,,,,.X-------X...X--------
----------X..XX...X-A......+,.,,,,,.X---X................XX.....,,,,,,,,,,,,,,,,,,,,,,,,,,,,,,,.......,,X-------X...X--------
----------X..XX...X-A.E.E.E+,.......X---X................XX...........................................,,X-------X...X--------
------XXXXX,,XX,,,XXXXXXXXXX:,,,,,,:X---XXXXX:X,,,,,:XXXXXX...........................................,,X-------X...X--------
------X......XX...........XX.........X--------X.....X-----X...........................................,.X-------X...X--------
------X,,,,,,XX,,,,,,,,,E,X.....E.....XXXXXXXXX.....X-XXXXX...............,,,,,,,,,...................,,X-XXXXX-X...X--------
------X,,,,,EXX,E,,,,,,,,,:...........,.E.+H.XX.....X-X...,...............,.......,...................,,X-X.HHX-X...X--------
------X,,,XXXXXXXXXXXXX,,,X...........,...+..XX.....X-X...,...............,.......,...............,,,,,,X-X...X-X...X--------
------X...X-----------X...XX.....:....XXXXXXXXX.....X-X...,...............,.......,...............,,,,,,X-X..HX-X...X--------
------X....X--XXXXXXXXX...X-XXX,,,XXXX--------X.....X-X...,...............,.......,...............,,,,,,X-X..HX-X...X--------
------X....:X-X.......,...X---X...X-----------X.....X-X...,...............,..E....,.....................XXX,,,X-X...X--------
-----XX.....X-XE......,...X---X...X-----------X.....X-X...,...............,......A,.....................,.....X-X...X--------
-----X,.....X-X.......,...X---X...X-----------X.....X-X...,...............,......A,.....................,.....X-X...X--------
-----XH....,,XX,,,XXXXXXXXXXXXX+++XXXXXXX-----X.....X-XXXXX...............,,,,,,,A,.....................,.....X-X...X--------
-----XH....,:XX...XXXXX.................X-----X.....X-----X.............................................,.....X-X...X--------
-----XH....,,XX,,,,EEXX.E..........E.E..X-----X.....X-----X,,,,XX,,,,,,,XXXXX,,,,,,,XXX,,,,,XXX,,,,,,,XXXXXXXXX-X...X--------
-----X,......XX,.,,.EXX.................X-----X..:..X-----X....XX.......X---X.......X-X.....X-X.......X---------X...X--------
-----XH..:..X-X,.,E..XXE+++++++++++++++.X-----X.....XXXXXXXXXXXXX,,,,,,,XXXXX,,,,,,,XXXXXXXXXXX,,,,,,,XXXXXXXXXXX...X--------
-----X,.....X-X,.,,..AX.,,,,,,,,,,,,,,,.X-----X.....,..........:........:.A:........:.....X-:.........:........++...X--------
-----XX....:X-X,.,E..XX.,............,,.X-----X.....,.....................................X-X..................++...X--------
------X.....X-X,.,,E.HX.,.........E..,,EX-----X.....,.....................................X-X..................++...X--------
------X...XXXXX,.,,..XX.,,:........,,,,.X-----X.....,.....................................X-X..................++...X--------
------X...,...,,.,E..HX.,,,........,:,,.X-----X.....,.....................................X-X..................++...X--------
------X...,..E,,.,,E.HX.,............,,.X-----X.....XXXXXXXXXXXXXXXXXXXXXXXXXXXXXXXXX,,,XXX-XXX,,,XXXXXXXXXXXXXXXXXXX--------
------X...,E..,,.,,..XX.,............,,.X-----X.....X-------------------------------X,,,X-----X,,,X--------------------------
------XXXXX...,,.,XEXEX.,,,,,,,,,,,,,,E.X-----:XXXX:X-------------------------------X,,,X-----X,,,X--------------------------
----------X...,E,,X---X.............E...X-------------------------------------------X,,,X-----X,,,X--------------------------
----------XXXXXXXXX---X....,,.....,,....X-------------------------------------------X,,,X-----X,,,X--------------------------
----------------------XE..:,,,,W,,,:..E.X-------------------------------------------X,,,X-----X,,,X--------------------------
----------------------XXXXXXXXXXXXXXXXXXX-------------------------------------------X,,,X-----X,,,X--------------------------
------------------------------------------------------------------------------------X,,,X-----X,,,X--------------------------
------------------------------------------------------------------------------------X,,,X-----X,,,X--------------------------
------------------------------------------------------------------------------------X,,,X-----X...X--------------------------
------------------------------------------------------------------------------------X,,,X-----X...X--------------------------
------------------------------------------------------------------------------------X,,,X-----X...X--------------------------
------------------------------------------------------------------------------------X,,,X-----X...X--------------------------
------------------------------------------------------------------------------------X,,,X-----X...X--------------------------
------------------------------------------------------------------------------------X,,,XXXXXXX...X--------------------------
------------------------------------------------------------------------------------X,,,..........X--------------------------
------------------------------------------------------------------------------------X,............X--------------------------
------------------------------------------------------------------------------------X.............X--------------------------
------------------------------------------------------------------------------------X.....:.......X--------------------------
------------------------------------------------------------------------------------X.............X--------------------------
------------------------------------------------------------------------------------KXXXXXXXXXXXXKX--------------------------
-----------------------------------------------------------------------------------------------------------------------------
