--------------------------------------------------------X>X-----------------------------------------------------------------------
--------------------------------------------------------X-X-----------------------------------------------------------------------
--------------------------------------------------------X-X-----------------------------------------------------------------------
--------------------------------------------------XXXXXXX-,XXXXXX-----------------------------------------------------------------
--------------------------------------------------X-----,-,,----X-----------------------------------------------------------------
--------------------------------------------------X-----,-,,----X-----------------------------------------------------------------
--------------------------------------------------X-----,-,,----X-----------------------------------------------------------------
--------------------------------------------------X-----,-,XX---X-----------------------------------------------------------------
--------------------------------------------------X-----,-XXXX--X-----------------------------------------------------------------
--------------------------------------------------X-----,-,-XX--X-----------------------------------------------------------------
--------------------------------------------------X-----,-XXXX--X-----------------------------------------------------------------
--------------------------------------------------X-----,-,,----X-----------------------------------------------------------------
--------------------------------------------------X-----,-,,----X-----------------------------------------------------------------
--------------------------------------------------X-----,-,,----X-----------------------------------------------------------------
--------------------------------------------------X-----,-,,----X-----------------------------------------------------------------
--------------------------------------------------X-----X-,,----X-----------------------------------------------------------------
--------------------------------------------------X---XXX-,,----X-----------------------------------------------------------------
--------------------------------------------------X---XX,-,,----X-----------------------------------------------------------------
--------------------------------------------------X---XXX-,,----X-----------------------------------------------------------------
--------------------------------------------------X-----,-,,----X-----------------------------------------------------------------
--------------------------------------------------X-----,-,,----X-----------------------------------------------------------------
--------------------------------------------------X-----,-,,----X-----------------------------------------------------------------
--------------------------------------------------X-----,-,,----X-----------------------------------------------------------------
--------------------------------------------------XXXXXXX-,XXXXXX-----------------------------------------------------------------
--------------------------------------------------------X-XXX---------------------------------------------------------------------
--------------------------------------------------------X-,-X---------------------------------------------------------------------
--------------------------------------------------------X+XX----------------------------------------------------------------------
--------------------------------------------------------X-X-----------------------------------------------------------------------
----------------------------------------XXXXXXXXX-------X-X-----------------------------------------------------------------------
----------------------------------------X-------X-------X-X-----------------------------------------------------------------------
----------------------------XXXXX-------X-------X-------X-X-----------------------------------------------------------------------
----------------------------X---X-------X-------X-------X-X-----------------------------------------------------------------------
----------------------------X---X-------X-------X-------X,X-----------------------------------------------------------------------
----------------------------X+++X-------X+++++++X-------X+X-----------------------------------------------------------------------
--------------------------XXX,,,XXXXX-XXX,,,,,,,XXX-XXXXX,XXXXX-XXXXX-------------------------------------------------------------
--------------------------X---------XXX-----------XXX---------XXX---X-------------------------------------------------------------
--------------------------X-----------------------------------------X-------------------------------------------------------------
--------------------------X-----------------------------------------X-------------------------------------------------------------
--------------------------X---,,,,,,,,,,,,,,,,,,,,,,,,,,,,,,,,,,,---X-------------------------------------------------------------
XXXXXXXXXXXXXXX-----------X---,,,,,,,,,-----------------,,,,,,,,,---X-------------------------------------------------------------
Xtt-----,---XX-X----------XX--,,-----,,,,,,,,,,,,,,,,,,,,,------,---X-------------------------------------------------------------
X-t-----,--X-XX-XX---------X--,,----,,-------------------,,-----,---X-------------------------------------------------------------
Xtt-----,XX-X-ttt-X-------XX--,,---,,---------------------,,,---,---X-------------------------------------------------------------
X-------X-XX--t-t--XX-----X---,,--,,-----------------------,-,--,---X-------------------------------------------------------------
X-----XX-X----ttt----X----X---,,-,,-------------------,++++-,-,-,--XX-------------------------------------------------------------
X----X-XX-------------XX--X---,,,,--------------------,+--+--,-,,--X--------------------------------------------------------------
X---X-X,,,,,,,,,,,,,,,,,X-X---,,,---------,++++-------,+--+---,-,--XX-------------------------------------------------------------
X---XX,,----------------X-X---,-,---------,+--+-------,+--+---,-,---X-------------------------------------------------------------
X--X-X,,------,,,-------X-X---,-,---------,+--+-------,++++---,-,---X-------------------------------------------------------------
X--XX-,,------,-,-------X-X---,-,---------,+--+---------------,-,---X-------------------------------------------------------------
X-XX--,,------,,,-------X-X---,-,---------,++++---------------,-,---X-------------------------------------------------------------
X-XX--,,----------------X-X---,-,-----------------------------,-,---X-------------------------------------------------------------
XXX---,,----------------X-X---,-,-----------------------------,-,---X-------------------------------------------------------------
XX,,,,,,------------,,,,X-X---,-,-----------------------------,-,---X-------------------------------------------------------------
XXttt,,,,,,---------,,,,XXXL--,-,---------------,,,,,,,-------,-,---X-------------------------------------------------------------
X-t-t,,,,-,---------,-----,L--,-,---------------,,----,-------,-,---X-------------------------------------------------------------
XX,,,,,,,,,---------,,,,XXXL--,-,-,+,---,-------,,----,-------,-,--XX-------------------------------------------------------------
XX,,,-,,----------------X-X---,-,-,+,---,-------,,----,-------,-,--X--------------------------------------------------------------
XXX---,,----------------X-X---,-,-,+,---,-------,,----,-------,-,--XX-------------------------------------------------------------
X-XX--,,----------------X-X---,-,---------------,,----,-------,-,---X-------------------------------------------------------------
X-XX--,,------,,,-------X-X---,-,---------------,,,,,,,-------,-,---X-------------------------------------------------------------
X--XX-,,------,-,-------X-X---,-,-----------------------------,-,---X-------------------------------------------------------------
X--X-X,,------,,,-------X-X---,-,-----------------------------,-,-,,X-------------------------------------------------------------
X---XX,,,,,,,,,,,,,,,,,,X-X---,-,-----------------------------,-,-,,X-------------------------------------------------------------
X---X-X,,,,,,,,,,,,,,,,,X-X---,-,---------,++++---------------,-,-,,X-------------------------------------------------------------
X----X-XX-------------XX--X---,-,---------,+--+---------------,-,-,,X-------------------------------------------------------------
X-----XX-X----ttt----X----X---,-,---------,+--+-------,,,,,---,-,-,,X-------------------------------------------------------------
X-------X-XX--t-t--XX-----X---,-,---------,+--+-------,,--+---,-,-,,X-------------------------------------------------------------
Xtt-----+XX-X-ttt-X-------XX--,,,---------,++++-------,,--+---,-,-,,X-------------------------------------------------------------
X-t-----+--X-XX-XX---------X--,,,,--------------------,,,,,--,-,,-,,X-------------------------------------------------------------
Xtt-----+---XX-X----------XX--,,-,,-------------------,,,,,-,-,-,-,,X-------------------------------------------------------------
XXXXXXXXXXXXXXX-----------X---,,--,,-----------------------,-,--,-,,X-------------------------------------------------------------
--------------------------X---,,---,,---------------------,,,---,-,,X-------------------------------------------------------------
--------------------------X---,,----,,-------------------,,-----,-,,X-------------------------------------------------------------
--------------------------X---,,-----,,,,,,,,,,,,,,,,,,,,,------,-,,X-----------XXXXXXX-------------------------------------------
--------------------------X---,,,,,,,,,-----------------,,,,,,,,,-,,X-----------X-----X-------------------------------------------
--------------------------X---,,,,,,,,,,,,,,,,,,,,,,,,,,,,,,,,,,,-,,X-----------X-----X-------------------------------------------
--------------------------X---------------------------------------,,X-----------X-----X-------------------------------------------
--------------------------X--------------------------------------,,,XXXXX-------X-----X-------------------------------------------
--------------------------X-----XXX---------XXX-------XXX-------,,,-,,t-X-------X-----X-------------------------------------------
--------------------------XXXXXXX-XXX,,,,,XXX-XXX,,,XXX-XXXXXXXXX,XXXXXXX-------XtttttX-------------------------------------------
------------------------------------X+++++X-----X+++X-----------X+X-------------X-----X-------------------------------------------
------------------------------------X-----X-----X---X---------XXX,XXX-----------X-----X-------------------XXX---------------------
------------------------------------X-----X-----X---X-----XXXX--,-,,-XX---------X-----X-------------------X-X---------------------
------------------------------------X-----X-----XXXXX---XX------,-,,---XX-------X-----X-----------XXXXX-XXX,XXX-XXXXX-------------
------------------------------------X-----X-----------XX--------,-,,-----XX-----X-----X----------X-----XX-,-,--XX----X------------
------------------------------------XXXXXXX---------XX--XXX-----,-,,XXX----XX---XtttttX---------X----------,,---------X-----------
----------------------------------------------------X---X-X-----,-,,X-X-----X---X-----X--------X-----------,-,---------X----------
---------------------------------------------------X----XXX-----,-,,XXX------X--X-----X-------X------------,-,----------X---------
---------------------------------------------------X------------,-,,---------X--X-----X------X-------------,-,-----------X--------
---------------------------------------------------X------------,-,,---------X--X-----X-----X-------------,--,--------XXX-X-------
---------------------------------------------------X--,,,,,,,,,,,-,,---------X--XtttttX----X--------------,-,---------X-X--X------
--------------------------------------------------X---,,,,,,,,,,,-,,----------X-XXX,XXX---X---XXX---------,-,---------XXX---X-----
--------------------------------------------------X---,-----------,,----------X---X-X----X----X-X--------,--,----------------X----
--------------------------------------------------X---,,,,,,,,,,,,,,----------X---X-X---X-----XXX--------,--,-----------------X---
--------------------------------------------------X---,,,,,,,,,,,,,,----------X---X-X---X--------------,,--,------------------X---
-------------------------------------------------X----XXX-------------XXX------X--X-X---X------------,,--,,-------------------X---
-------------------------------------------------X----X-X-------------X-X------X--X-X---X----------,,---,---------------------X---
-------------------------------------------------X----XXX-------------XXX------X--X-X--X-------,,,,---,,----------------------X---
--------------------------------------------------X---------------------------X---X-X--X-,,,,,,-----,,-------------------------X--
--------------------------------------------------X-----------XXX-------------X---X-XXXX,-------,,,,---------------------------X--
--------------------------------------------------X-----------X-X-------------X---X----,--,,,,,,-------------------------------X--
--------------------------------------------------X-----------XXX-------------X---XXXXXX,,----------,,,------------------------X--
---------------------------------------------------X-------------------------X---------X------------,-,------------------------X--
---------------------------------------------------X-------------------------X---------X------------,,,------------------------X--
---------------------------------------------------X-------------------------X---------X---------------------------------------X--
---------------------------------------------------X-------------------------X---------X---------------------------------------X--
----------------------------------------------------X-----------------------X---------X------------------------------------,,,,,X-
----------------------------------------------------XX------,,,,--,,,,------X---------X---------------------------,,,,,,,--,,,,,X-
------------------------------------------------------XX----,-,,--,-,,----XX----------X---------------------------,,----,--,--,,X-
--------------------------------------------------------XX--,,,,--,,,,--XX--XXXXXXXXXXX-----------------,,,-------,,----,--,--,,X-
----------------------------------------------------------XX----------XX---X----------,-----------------,-,-------,,----,--,--,,X-
------------------------------------------------------------XXX,,,XXXX----X---XXXXXXXXX-----------------,,,-------,,----,--,--,,X-
--------------------------------------------------------------X+++X------X---,,-X-----X---------------------------,,,,,,,--,--,,X-
--------------------------------------------------------------X,,,X-----X---,,--X-----X---------------------------,,,,,,,--,,,,,X-
--------------------------------------------------------------X---X----X-+-,-,---X----X-----------------------------------------X-
--------------------------------------------------------------X---XX--X---X-,---X-----X----------------------------------------X--
--------------------------------------------------------------X---,X--X--X-X---X-------X---------------------------------------X--
-------------------------------------------------------------XX---XX--X-X---X-X--------X------------,,,------------------------X--
-------------------------------------------------------------X,---X---X-X----X---------X------------,-,------------------------X--
-------------------------------------------------------------XX---X---X-X--------------X------------,,,------------------------X--
--------------------------------------------------------------X---X---X-X--------------X---------------------------------------X--
----------------------------------------------------------X+X-X---X---X-X--------------X---------------------------------------X--
----------------------------------------------------------X-X-X,,,X---X-X--------------X---------------------------------------X--
----------------------------------------------------------X-X-X+++X---X-X--------------X--------------------------------------X---
----------------------------------------------------------X-X-X,,,X---X,X---------------X-------------------------------------X---
----------------------------------------------------------X-X-X---X---X,XX--------------X-------------------------------------X---
----------------------------------------------------------X-X-X---X-XX----XX------------X-------------------------------------X---
----------------------------------------------------------X-X-X---XX--------XXXXXXX-----X-----XXX-----------------------------X---
----------------------------------------------------------X-X-X---,,--------,,----X------X----X-X----------------------------X----
----------------------------------------------------------X-XXX---XXXXXXXXXXXXXXX-X-------X---XXX---------------------,,,---X-----
----------------------------------------------------------X-------X-------------X-X--------X--------------------------,-,--X------
----------------------------------------------------------XXXXXXXXX-------------X-X---------X-------------------------,,,-X-------
--------------------------------------------------------------------------------X-X----------X---------------------------X--------
--------------------------------------------------------------------------------X-X-----------X-------------------------X---------
--------------------------------------------------------------------------------X-X------------X-----------------------X----------
----------------------------------------------------------------XXXXXXXXXXXXXXXXX-XXXXX---------X---------------------X-----------
----------------------------------------------------------------X---,,--,-+,,,,,,-,,--X----------X-----XX------XX----X------------
----------------------------------------------------------------X---,,--,-XXXXXXXXXXXXX-----------XXXXX-XXXXXXX-XXXXX-------------
----------------------------------------------------------------X,--,,,,,-X-------------------------------------------------------
------------------------------------------------------------+XXXX-,-,,,,,-XXXXX---------------------------------------------------
------------------------------------------------------------+---+-,-------,,---X--------------------------------------------------
------------------------------------------------------------XXXXX-,-,,,,,-XXXX--X-------------------------------------------------
----------------------------------------------------------------X,--,,--,-X---X-X-------------------------------------------------
----------------------------------------------------------------X---,,--,-X---X-X-------------------------------------------------
----------------------------------------------------------------X---,,--,-X---X-X-------------------------------------------------
----------------------------------------------------------------XXXXXXXXXXX---X-X-------------------------------------------------
------------------------------------------------------------------------------X-X-------------------------------------------------
----------------------------------------------------------------------------XXX-X-------------------------------------------------
----------------------------------------------------------------------------+---X-------------------------------------------------
----------------------------------------------------------------------------+XXXX-------------------------------------------------
