-----------------------------------------------------------------------------XXXXXXXXXXXXXXXXXXXXXXXXXXXXXXXXXXXXXXXXXXXXXXXXXXXXXXXXXXXXXXXXXXXX
-----------------------------------------------------------------------------X..................................................................X
-----------------------------------------------------------------------------X.............................................................,,,..X
-----------------------------------------------------------------------------X.............................................................,,,..X
-----------------------------------------------------------------------------X..................................................................X
-----------------------------------------------------------------------------X..................................................................X
-----------------------------------------------------------------------------X..................................................................X
-----------------------------------------------------------------------------X..................E............................:..................X
-----------------------------------------------------------------------------X......................................W...........................X
-----------------------------------------------------------------------------X..................................................................X
-----------------------------------------------------------------------------X..................................................................X
-----------------------------------------------------------------------------X..................................................................X
-----------------------------------------------------------------------------X..................................................................X
-----------------------------------------------------------------------------X..................................................................X
-----------------------------------------------------------------------------X..................................................................X
-----------------------------------------------------------------------------X..................................................................X
-----------------------------------------------------------------------------X..................................................................X
-----------------------------------------------------------------------------X...............,,,,,,,,,,,,,,,,,,,,,,,,,,,,,,,,,,,,,,,,...........X
-----------------------------------------------------------------------------X...............,......................................,...........X
XXXXXXXXXXXXXXXXXXXXXXXXXXXXXXXXXXXXXXXXXXXXXXXXXXXXXXXXXXXXXXXXXXXXXXXXXXXX-X...............,,,,,,,,,,,,,,,,,,,,,,,,,,,,,,,,,,,,,,,,...........X
X...................................<......................................X-X...............,,....................................,,...........X
X.............:............................................................X-X...............,,....................................,,...........X
X.................................<.....<..................................X-X...............,,....................................,,...........X
X..........................................................................X-X...............,,....................................,,...........X
X..........................:........<................................:.....X-X...............,,....................................,,...........X
X..................................AAA:.........................:..........X-X...............,,....................................,,...........X
X....:...............................A.....................................X-X...............,,.................E..................,,...........X
X..........................................................................X-X...........H...,,....................................,,...........X
X...........:..............................................................X-X...............,,....................................,,...........X
X..........................................................................X-X...............,,....................................,,...........X
X......:....................................................:..............X-X...............,,....................................,,...........X
X.:........................................................................X-X...........H...,,....................................,,...........X
X..........................................................................X-X...............,,..............,,,,,,................,,...........X
X......:...................................................................X-X...............,,..............,....,................,,...........X
X...........:..............................................................X-X...............,,..............,....,................,,...........X
X.:........................................................................X-X...........H...,,..............,....,................,,......,,,,,X
X..........................................................................X-X...............,,..............,..E.,................,,......,..A,X
X......:...................................................................X-X...............,,..............,....,................,,......,.K.,X
X..............:...........................................................X-X...............,,..............,....,................,,......,,,,,X
X..........................................................................X-X...........H...,,..............,....,................,,...........X
X..........................................................................X-X...............,,..............,,,,,,................,,...........X
X..........................................................................XXX...............,,....................................,,...........X
X..........................................................................,+,...............,,....................................,,...........X
X..........................................................................XXX...........H...,,....................................,,...........X
X..........................................W...............................X-X...............,,....................................,,...........X
X..........................................................................X-X...............,,....................................,,...........X
X.....................................A....................................X-X...............,,.................E..................,,...........X
X..........................................................................X-X...............,,....................................,,...........X
X..........................................................................X-X...............,,....................................,,...........X
X..........................................................................X-X...............,,....................................,,...........X
X..........................................................................X-X...............,,....................................,,...........X
X...........................................W..............................X-X...............,,....................................,,...........X
X..........................................................................X-X...............,,....................................,,...........X
X.............................................W............................X-X...............,,,,,,,,,,,,,,,,,,,,,,,,,,,,,,,,,,,,,,,,...........X
X..........................................................................X-X...............,,,,,,,,,,,,,,,,,,,,,,,,,,,,,,,,,,,,,,,,...........X
X..........................................................................X-X..................................................................X
X..........................................................................X-X..................................................................X
X.....................................E....................................X-X...............................................................:..X
X.................E.......................................E................X-X..................................................................X
X..........................................................................X-X..................................................................X
X..........................................................................X-X..................................................................X
X..........................................................................X-X..........................................................:....:..X
X....................................................................:.....X-X..................................................................X
X..........................................................................X-X....................................:.............................X
X...............................................................:..........X-X......................E...........................:...............X
X.................................,,,,,,,,.................................X-X......................................................:...:.....:.X
X................................,,.......,,.................:......:......X-X..................................................................X
X..............................,,..,,,,,,,.,,..............................X-X..................................................................X
X.............................,,.,,......,,..,...........:.................X-X.............................................................:....X
X.............................,.,,.........,,,,....................:.......X-X..................................................................X
X............................,.,,...........,,,................:...........X-XXXXXXXXXXXXXXXXXXXXXXXXXXXXXXXXXXXXXXXXXXXXXXXXXXXXXXXXXXXXXXXXXXXX
X............................,.,.............,.,...........................X---------------------------------------------------------------------
X...........................,,,..............,.,..........:................X---------------------------------------------------------------------
X...........................,.,.....,,,,,.....,,...........................X---------------------------------------------------------------------
X...........................,.,.....,,,.,.....,,.................:.........X---------------------------------------------------------------------
X...........................,.,.....,,:.,.....,,...........................X---------------------------------------------------------------------
X....:......................,.,.....,...,.....,,...........................X---------------------------------------------------------------------
X............................,,.....,,,,,....,,,...........................X---------------------------------------------------------------------
X............................,,,.............,,,...........................X---------------------------------------------------------------------
X..........:.................,,,............,,,............................X---------------------------------------------------------------------
X.............................,.,...........,,.............................X---------------------------------------------------------------------
X..............................,,,........,,,,.............................X---------------------------------------------------------------------
X......:........................,,,,,...,,,,,..............................X---------------------------------------------------------------------
X..............:.................,,,,,,,,,,................................X-XXXXXXXXXXXXXXXXXXXXXXXXXXXXXXXXXXXXXXXXXXXXXXXXXXXXXXXXXXXX--------
X...................................,,,,,..................................X-X..........................................................X--------
X..........................................................................X-X..........................................................X--------
X.........:................................................................X-X..........................................................X--------
X..........................................................................X-X......................................E...............,,..X--------
X..........................................................................X-X...........:..........................................,,..X--------
X..........................................................................X-X.................................E....................,,..X--------
XXXXXXXXXXXXXXXXXXXXXXXXXLXXXXXXXXXXXXXXX..................................X-X..........................................................X--------
X-----------------------XLX-------------X..................................X-X..........................................................X--------
XXXXXXXXXXXXXXXXXXXXXXXXX,XXXXXXXXXXXXXXX..................................X-X.......................................E..................X--------
X......................................XX..................................X-X.H................................E.......................X--------
X......................................XX..................................X-X..........................................................X--------
X......................................XX..................................X-X.H..............:.........................................X--------
X......................................XX..................................XXX..........................................................X--------
X......................................XX..................................,L,.H....................................................H...X--------
X...................................H..XX..................................XXX..........................................................X--------
X...................................H..XX..................................X-X.H....................................................H...X--------
X,,,,,,,,,,............................XX..................................X-X...............................:......................H...X--------
X.........,.........................H..XX..................................X-X..........................................................X--------
X.........,.........................H..XX..................................X-X..........................................................X--------
X.........,............................XX..................................X-X..........................................................X--------
X.......:.,............................XX..................................X-X..........................................................X--------
X.........,............................XX..................................X-X..........................................................X--------
X..E......,............................XX..................................X-X......................:...............:...................X--------
X.........,............................XX..................................X-X..........................................................X--------
X.........,.........W..................XX..................................X-X..........................................................X--------
X.........,............................XX..................................X-X..........................................................X--------
X..E......,............................XX..................................X-X..........................................................X--------
X......E..,................:...........XX..................................X-X..........................................................X--------
X.........,............................XX..................................X-X..........................................................X--------
X.........,............................XX..................................X-X..........................................................X--------
X.........,...................,,,,,,,,,XX.......................:..........X-X..........................................................X--------
X.........,...................,........XX..................................X-X..........................................................X--------
X.........,..........E........,.AA.,,..XX..................................X-X..........................................................X--------
X.........,...................,....,,..XX..................................X-X..........................................................X--------
X,,,,,,,,,,...................,.AA.,,..XX..................................X-X..........................................................X--------
X.............................,........XX..................................X-X..........................................................X--------
X.............................,........XX..................................X-X..........................................................X--------
X.............................,........XX..................................X-X..........................................................XXXXXXX--
X.............................,.....E..XX..................................X-X..........................................................XX....X--
X.............................,..E.....XX..................................X-X..........................................................XX....X--
Xtt...........................,T.......XX..................................X-X..........................................................XX....X--
X.t.................,,........,........XX..................................X-X..........................................................XX....X--
XXXXXXXXXXXXXXXXXXXXWKXXXXXXXXXXXXXXXXXXX..................................X-X..........................................................XX....X--
----------------------------------------XXXXXXXXXXXXXXXXXXXXXXXXXXXXXXXXXXXX-X.........................,,,,,,,,,........................L,..E.X>-
-----------------------------------------------------------------------------X.........................,:.....:,........................XX....XX-
-----------------------------------------------------------------------------X.........................,...W...,............E...........XX....X--
-----------------------------------------------------------------------------X.........................,.......,........................XX....X--
-----------------------------------------------------------------------------X.........................,...K...,........................XX....X--
-----------------------------------------------------------------------------X.........................,.......,........................XX....X--
-----------------------------------------------------------------------------X.........................,.......,........................XX....X--
-----------------------------------------------------------------------------X.........................,:.....:,........................XXXXXXX--
-----------------------------------------------------------------------------X.........................,,,,,,,,,........................X--------
-----------------------------------------------------------------------------X..........................................................X--------
-----------------------------------------------------------------------------X..........................................................X--------
-----------------------------------------------------------------------------X..........................................................X--------
-----------------------------------------------------------------------------X..........................................................X--------
-----------------------------------------------------------------------------X..........................................................X--------
-----------------------------------------------------------------------------X..........................................................X--------
-----------------------------------------------------------------------------X..........................................................X--------
-----------------------------------------------------------------------------X..........................................................X--------
-----------------------------------------------------------------------------X..........................................................X--------
-----------------------------------------------------------------------------X..........................................................X--------
-----------------------------------------------------------------------------X..........................................................X--------
-----------------------------------------------------------------------------X..................:........................:..............X--------
-----------------------------------------------------------------------------X..........................................................X--------
-----------------------------------------------------------------------------X..................................E.......................X--------
-----------------------------------------------------------------------------X..........................................................X--------
-----------------------------------------------------------------------------X.....................................E....................X--------
-----------------------------------------------------------------------------X................................E.........................X--------
-----------------------------------------------------------------------------X........................:.................................X--------
-----------------------------------------------------------------------------X..........................................................X--------
-----------------------------------------------------------------------------X...................................E......................X--------
-----------------------------------------------------------------------------X..........................................................X--------
-----------------------------------------------------------------------------X..........................................................X--------
-----------------------------------------------------------------------------X..........................................................X--------
-----------------------------------------------------------------------------X..........................................................X--------
-----------------------------------------------------------------------------X..........................................................X--------
-----------------------------------------------------------------------------X............:..................:..........................X--------
-----------------------------------------------------------------------------X..........................................................X--------
-----------------------------------------------------------------------------X...............................................:..........X--------
-----------------------------------------------------------------------------X..........................................................X--------
-----------------------------------------------------------------------------X..........................................................X--------
-----------------------------------------------------------------------------X..........................................................X--------
-----------------------------------------------------------------------------X..........................................................X--------
-----------------------------------------------------------------------------X..........................................................X--------
-----------------------------------------------------------------------------X..........................................................X--------
-----------------------------------------------------------------------------X..........................................................X--------
-----------------------------------------------------------------------------X..........................................................X--------
-----------------------------------------------------------------------------X..........................................................X--------
-----------------------------------------------------------------------------XXXXXXXXXXXXXXXXXXXXXXXXXXXXXXXXXXXXXXXXXXXXXXXXXXXXXXXXXXXX--------
