----------------------------------------------------------------------------------XXXXXXXXXXX---------------------------------
------------------------------------------------------------XXXXXXXXXXXXXXXXXXXXXX..........X---------------------------------
-------------------------------------------------XXXXXXXXXXX...........,,,,,................X---------------------------------
-------------------------------------------------X.................,,,,.,..,,,,.............X---------------------------------
-------------------------------------------------X..............,,,..,,,,,,,..,,,...........X---------------------------------
-------------------------------------------------X............,,,,,,,.......,,,..,..........X---------------------------------
-------------------------------------------------X..........,,.,...............,,.,,........X---------------------------------
-------------------------------------------------X.........,..,.........E........,,.,.......X---------------------------------
-------------------------------------------------X.........,.,.....................,,.......X---------------------------------
-------------------------------------------------X........,..,.....................,.,......X---------------------------------
------------------------------------------------X.........,.,....E.............E....,,......X---------------------------------
------------------------------------------------X.........,.,.......................,,......X---------------------------------
------------------------------------------------X........,.,............A...........,,......X---------------------------------
------------------------------------------------X........,.,........................,.,.....X---------------------------------
------------------------------------------------X........,.,.........................,,.....X---------------------------------
------------------------------------------------X.......,.,..........................,,.....X---------------------------------
------------------------------------------------X.......,.,..........................,,.....X---------------------------------
------------------------------------------------X.......,,...............E............,,....X---------------------------------
------------------------------------------------X......,.,...E........................,,....X---------------------------------
------------------------------------------------X......,.,............................,,....X---------------------------------
------------------------------------------------X.....,.,..........................E..,,....X---------------------------------
------------------------------------------------X.....,.,..............................,,...X---------------------------------
------------------------------------------------X.....,,...............................,,...X---------------------------------
------------------------------------------------X....,.,...............................,,...X---------------------------------
------------------------------------------------X....,.,...............................,,...X---------------------------------
-----------------------------------------------X.....,,................................,,...X---------------------------------
-----------------------------------------------X....,.,................................,,...X---------------------------------
-----------------------------------------------X....,,.................................,,...X---------------------------------
-----------------------------------------------X....,,..................:..............,,...X---------------------------------
-----------------------------------------------X...,.,.................................,,...X---------------------------------
-----------------------------------------------X...,,..................................,,...X---------------------------------
-----------------------------------------------X...,,...............,,.................,,...X---------------------------------
-----------------------------------------------X..,,..............,,:.,................,,...X---------------------------------
-----------------------------------------------X..,,............,,.....,...............,,...X---------------------------------
-----------------------------------------------X..,,............,......,...............,,...X---------------------------------
-----------------------------------------------X..,,............,...H...,..............,,...X---------------------------------
-----------------------------------------------X..,,............,:....:.,..............,,...X---------------------------------
-----------------------------------------------X.,.,.E..........,,.....,...............,,...X---------------------------------
-----------------------------------------------X.,.,..............,,..,................,,...X---------------------------------
-----------------------------------------------X.,.XXX+XX...........,,...............E.,,...X---------------------------------
----------------------------------------------X..,.X:X.AX..............................,,...X---------------------------------
----------------------------------------------X..,.XXX..X......................,XXXXXXXX,...X---------------------------------
----------------------------------------------X..,EWXX,,X...........,,.......,,,X....AXX,...X---------------------------------
----------------------------------------------X..,..XX..XX........,,,,,,,..,,.,A+..E.KXX,...X---------------------------------
----------------------------------------------X..,XXXX.AXX.......,,,....,,,...,.X.A..AXX,...X---------------------------------
----------------------------------------------X.,.X-:XXXXX......,,.:.E..,,.W..,.XX,,,XXX,...X---------------------------------
----------------------------------------------X.,XX----XXX+++...,,A.....XXXXXXXXXX...XA.A...X---------------------------------
----------------------------------------------XXXXXXXXXX,,...++++....,XXXXXXXXXXXX,,,XXXXXXXXXXX------------------------------
---------------------------------------XXXXXXXX....,....,,......,,XX,........................,..XX----------------------------
------------------------------XXXXXXXXX............,..A.,,...E..,,XX..............,,.........,..HXXXXXXXXXXXXXXXXXX-----------
---------------------XXXXXXXXX................E..E..,...,,......,XX..............,..,,...:..,....XX...............X-----------
-------------XXXXXXXX....,............E...E.........,.XXXXXXLLLXX+X.............,,....,....,......XE.....E......E.X-----------
-----XXXXXXXX............,.......E.............XXXXXXXX..,.......XX......T........,,.,,...,.......X...XXXXXXE.....X-----------
XXXXX.....................,.E..........XXXXXXXXXX........,.......XX.................,..,..,......EX,XXXXXXAXXLXXXXX-----------
X.........................,....XXXXXXXXXX.,.,,,.,.....A..,.......XX.........E.......,..,.,........X.XXXX,X,XX,XXXXX-----------
X.H...................,,,,XXXXXX.,,.,,.,,E,.,,,.,........,.......XX............X.....,..,.........XEXX,,,,,,,,,...X-----------
X............,,,,,,,,,....XX..,,.,,.,.,,,..,.,,,.,.......,.......XX...........X-X....,.,,...W.....X,XX,E,,,,..,,,EX-----------
X.......,,,,,..............XX.,.,.,,.,,.,,.,.,,,.,.......,.......XX..........X---X....,.,........EX.XX,.,,,,..,,XXX-----------
X.......,..................XX..,,.,,.,.,,.,.,.,,,.,......,.......XX.....,....X---X..,,,.,.........X,XX,,.,.,..,,XXX-----------
X.......,..................X-X.,.,.,,.,,.,,.,.,,.,,......,.......XX....,.,....XXX.,,..,.,.........X.XX,,,,,...,,,:X-----------
X.......,...................XX..,,.,,.,.,,.,.,.,,,.,.....,,,.....XX...,..,.......,...E,.,.........XEXX,...,...,,,:X-----------
X.......,...........E.......XX..,.,.,,.,,.,.,,.,,.,,.....,..,....XX....,..,,.....,..ttt.,........EX,X+,.......,,,:X-----------
X.......,...................X-X..,,.,,..,,.,,.,.,,.,,...,,..,....XX....,.,..,,..,.EHt.,.,.H.......X.XX,.......,,XXX-----------
X.......,....................XX...,,.,,.,,.,.,,.,,.,,...,:..,....XX.....,,....,,,,,,t,,,,,,,,,,.XXX,XX,....:..,,XXX-----------
X.......,....................XX...,,.,,..,,.,.,,.,,.,,..,,..,....XX.......,,,..,......,.,.....,.,...XX,,,,,,,,,,,EX-----------
X,,,,,,,,.....,,,,,,,,,,,,,,,X-X...,,.,,.,,.,.,,.,,.,,...,..,....XX,,,,,,,,,,,,,,,,,,,,,,,,,,,,.XXXXXX..E...E.....XXXXXX------
X.......,.....,.,,..........,.XX...,,.,,..,,.,.,,.,,.,,..,,,.....XXXXXXXXXXXXXXXXXXXXX,.,.......XXXXXX...,,.......,..A.X------
X.......,...E.,..,,.......A.,.X-X...XX.,,.,,.,.,,.,,.,,..,.......XXXXXXXXXXX..........,,,.........X.,,,,,,,,,,,...,..E.X------
X.......,.....,..,,.........,.X-X.E.XX.,,.,,.,.,,.,,.,,..,.......XXA.E.............,,,,.,.........X.,XX.HH.HXX,...,....X------
X.......,...E.,..,,.........,..XX...XX.,,.,,.,.,,.,,.,,..,.......XXXXXX.........,,,,,.,,,.........X.,XX,,,,,XX,...X....X------
X.....E.,.....,..,.,........,..X-X.EXX.,,.,.,.,,.,,.,,.,.,.......XXXXAX.........,,,.,,,,.,,,......XXX,,,,,,,,,XX,XXXXXXX------
X.......,.....,..,,,........,..X-X..XX,,.,,.,E,,.,,.,,.,.,,......,,.EXX.........,.,,..,,.,.,,,,.XXXXX,,,,,,,,,XX,XX-----------
X.......,.....,...,,,.......,...XX..XX,,.,,.,.,,.,,.,,.,.,.,.....,,..AX.........,.,.H...,,,,,.,.,.,E.........A..A.+-----------
X.E.....,.....,...,.,.......,...X-X.XX,,.,,.,.,,.,,.,,.,.,..,....XXXXXX.........,,,..XXX....,,,.XXXXXXXXXXXXXXX...X-----------
X.......,...E.,....,,.......,...X-X.XX,.,,.,,.,.,,.,,.,,,,..,....XXA.........,,,,.,..XXXXXXX......X.........,.X,,,X-----------
X.......,.....,....,,.......,....X-XXX,.,,.,,.,.,,.,,.,,,:..,....XX.......,,,,,.,,,,.....XXXXXXX..X..XXXXXXXX.,,,,X-----------
X....E..,.....,E...,,.......,....XXXXX,.,,.,,.,.,,.,,.,,.,..,....XX.......,,,.,,,,..,,,,.......XXXX..XXXXXXXX,X.,,X-----------
X.......,.....,.....,,,.....,....,.,XX.,,.,,.,.,,.,,.,,.,,.,.....XX.......,.,,..,,.,..,.,,.XXXXXXXX..X.....XX.X...X-----------
X.......,..,+,,,,,,,,,,,.,,,,....,.,XX.,,.,,.,.,,.,,.,,.,,,......XX.<.....,.,.....,,,,,.,,.X.........XX....++EX.E.X-----------
X.......,..,+,,,,,,,,,,.,,,.,....,.,XX.,,.,,.,.,,.,,.,,.,,.......+L.,...,,,,,..++,.....,,,.,....,,,..,X....XXXXXXXX-----------
X.K.....,..E+,,,,,,,,H,,,,,,,....,.,XX.,,.,,.,.,,.,,.,,.,,.,.....+L.,.<.,W,.,..,A+..H.:....,.E..,H,.E,X....+XXXXXXXX----------
X.......,..,+,,,,,,,,,,,.,,,,....,.,XX.,,.,,.,.,,.,,.,,.,,,H.....+L<,...,,,,,..,,+.......,.,....,.,..,X..H.XXXX,..EX----------
X.......,.....,,,,,,,,,.....,....,.,XX.,,.,,.,.,,.,,.,,.,,.......XX.,.....,.,.......,,,,,,.X....,,,..XX....XX.X.,..X----------
X....E..,.....,.....,,......,....,.,XX,.,.,,.,.,,.,,.,,.,,,,.....XX.<.....,.,...,,,,.,.,.,.XXXXXXXX..XX....XXEX.,..X----------
X.......,.....,E...,,.......,....,.,XX,.,,.,,.,.,,.,,.,,.,..,....XX.......,,.,,.,,.,..,,,..XXXXXXXX..X.....XX.X.,.EX----------
X.......,.....,....,,.......,....XXXXX,.,,.,,.,.,,.,,.,,,,..,....XX.......,.,.,,,.,,,,.........XXXX..XXXXXXXX,X..,.X----------
X.......,...E.,...,.,.......,....X-XXX,.,,.,,.,.,,.,,.,,,:..,....XXA.......,,,.,,,,.....XXXXXXX...X...........XE.,.X----------
X.E.....,.....,...,.,.......,...X-X.XX,,.,,.,.,.,,.,,.,,,,..,....XXXXXX.......,,,,,.XXXX......,...XXXXXXXXXXXXXXXX+X----------
X.......,.....,..,,,,.......,...X-X.XX,,.,,.,E,,.,,.,,.,.,.,.....XXXXXX.........,.,.......,,,,,.XXXXXXXXXXXXXXXXXX,X----------
X.......,.....,..,,.,.......,...X-X.XX,,.,,.,.,,.,,.,,.,.,,......,,.EA,.........,.,.H.,,,,,.,.,.,:..A.E+X.,.+.,..,.X----------
X.......,.....,..,.,,.......,...X-XEXX.,,.,,..,,.,,.,,.,.,.......,,..XX.........,,.,,.,,,..,,,..XXXXXXXXX,,,,,,,,,,X----------
X.....E.,...E.,..,.,........,..X-X..XX.,,.,,.,.,,.,,.,,..,.......XXXXXX.........,.,.,,,.,,,.......X.,.....,,.......X----------
X.......,.....,..,,.........,..X-XE.XX.,,.,,.,.,,.,,.,,..,.......XXA.E...........,,,.,,,,.........XE,.E..E....E....X----------
X.......,...E.,..,,.........,..X-X..XX.,,.,,.,.,,.,,.,,..,.......XX.................,,,,,......E..X.,...........XXXX----------
X.......,.....,.,,........A.,.X-X...,,.,,.,,.,.,,.,,.,,..,,,.....XXXXXXXXXXXXXXXXXXXXX,.,.........XE,.,,,,,,,,,HXX+-----------
X,,,,,,,,.....,,,,,,,,,,,,,,,.X-X..,,.,,.,,..,.,,.,,.,,..,..,....XX,,,,,,,,,XXXXXXXXXX,,,,,,,,,.XXXXX.,.,,A,,.,.+E+-----------
X.......,.....................X-X..,,.,,.,,.,.,,.,,.,,..,,..,....XX.......,,,.,.......,.,.....,.,...X.,.,...,.,HXX+-----------
X.......,....................X-X..,,.,,.,.,.,.,,.,,.,,..,:..,....XX.....,,....,,,,,,t,,,,,,,,,,.XXX.X.,.,EA.,.,.XX+-----------
X.......,....................X-X..,,.,,.,,.,.,,.,.,,.,..,,..,....XX....,.,..,,..,..Ht.,.,.......XXX.X.,.,++.,.,.+E+-----------
X.......,...........E........X-X.,.,,.,,.,.,.,,.,,.,,....,.,.....XX....,..,,....,.E.ttt.,.H.......X.X.,.,,,,,.,HXX+-----------
X.......,....................X-X.,,.,,.,.,.,,.,,.,,.,....,,......XX...,..,.......,....,.,........EX.X.,..A.A..,...X-----------
X.......,...................X-X.,.,,.,,.,.,.,,.,.,,.,....,.......XX...,..,.....X..,..E,.,.........X.X.,,,,,,,,,...X-----------
X.......,,,,................X-X.,.,,.,,.,.,,.,.,,.,,.....,.......XX..,..,.....X-X..,,.,.,.........X.XE............XXXX--------
X...........,,,,,,..........X-X,.,,.,,.,..,,.,,.,,.,.....,.......XX...,.,....X---X...,,.,.........X.XXXXXXXXX+XXXXX,,,XXX-----
X.................,,,,,,...X-X.,.,,.,,.,.,,.,.,,.,,......,.......XX....,.....X---X....,,,...W....EX.........,,,..EXH.A,AX-----
X.......................,,,XXXXX,,.,,..,.,,.,,.,,.,......,.......XX...........XXX....,..,.........X,,,,,,,,,,,,,..XX....X-----
XXXX.......................,...XXXXXXX,.,,E,.,.,,.,......,.......XX....,....E........,..,,........X,,A,.,A,.,.,,..,,....X-----
XX--XXXXXX.................,.........XXXXXXX,.,,.,....A..,.......XX...,.,...........,..,.,........X,,.,.,.,.,.,,..,,..E.X-----
X.XXXXX---XXXXXXX.........,................XXXXXXXX......,.......XX.XXX,.,T.......,,.,.,..,......EX,,A,.,A,.,.,,..,,....X-----
X.,....XXXXXXXXX-XXXXXX...,...E....E.............XXXXXXXXXXX,,,XXXXX-X,.X,......,,....,....,......X,,,,.,,,.,,,,..XX.A.AX-----
X.,.......,.,,..XXXXXX-XXXXXX............E...E......+..XXXXX+++XXX-XX..XX........,..,,......,.....X,,,,,,,,,,,,,.,XX..XXX-----
X.,.......,.,,........XXXXX--XX,,,...............E.+.....X.,.....X-X.:.XX.........,,....:...,...HXXE,,,,,,,,,,,,,XXXXX--------
X.,.......,A,,.............XXX,,,.,,,,,,,..........+.EA..X.,......XX,..XX....................,..XX-X,,,,,,,,,,,,,X------------
X.,...E...,.,,...................,,,,,,,.,,,,,,...+.....X...,.....X..XX-XXXXXXXXXXXXXXXXXXXXXXXX---X.EH.E.E..EH.EX------------
X.,.......,.,,........E.................,,,,,,,,,,XXXXXXX:X.,.E..,.,,X-----------------------------XXXXXXXXXXXXXXX------------
X.,.......,.,,................E................,,,XXX------XXX..,....XXXXXXXXXXXXXXXXXXXXXXXXXXXXXXXXXXXXXXXXXXXXXXXXXXXXXXXXX
X.,......,..,,.......................................XXXXX----XXXXX..,...............................................,.....,.X
X.,......,..,,............................................XXXX-----XXXX..E........................E..................,.....,.X
X.,......,..,,................................................XXXXX---X.......................................E......,..E..,.X
X.,......,..,,.....................................................XXX...............................................,.....,.X
X.,......,..,,...,,,,,,,,,,,,,,,,,,,,,,,,,,,,,,,,,,,,,,,,,,,,,,,,,,..................................................,.....,.X
X.,,,,,,,,..,,...,.................................................,,,,,,,,,,,,,,,,,,,,,,,,,,,,,,,,,,,,,,,,,,,,,,,,,.,.....,.X
X.,.........,,...,..........................................................,,.....................................,.,.....,.X
X.,.........,,...,.........................................................,..,....................................,.,.....,.X
X.,.........,,...,.....,,,,,,,,,,,,,,,,,,,,,,,,,,..........................,..,....,,,,,,,,,,,,,,,,,,,,,,,,,,......,.,.....,.X
-X,.........,,...,.....,.........................,,,,,,,,,,,,,,,,,,,,,,,,,.,..,....,........................,......,.,.....,.X
-X,.........,,...,.....,.................................................,..,,.....,....XXX.................,......,.,.....,.X
-X,........,.,...,.....,.....XXXXXXXXXXXXXXXXXXXXXXXXXXXXXXXXXXX,,,......,..........,...X-X.........E.......,......,.,.....,.X
-X,........,,....,.....,.....X---------------------------------X+++,....,...........,...X-X.................,......,.,,,,,,,.X
-X,........,,....,.....,.....XXXXXXXXXXXXXXXXXXXXXXXXXXXXXXXXXXX,++,....,...,,,,,...,...X-X...E.............,......,.......,.X
-X,........,,....,......,........................................++,....,...,...,...,...X-X......A..........,......,.......,.X
-X.,.......,,....,......,.................................E....E.XXX..E.,...,.K.,...,...X-X.................,......,.......,.X
-X.,.......,,....,......,........................................X-X...,....,...,....,..X-X.................,......,.......,.X
-X.,.......,,...,...,,..,........................................X-X...,....,,,,,....,..XXX.E...............,......,.......,.X
-X.,.......,,...,.,,..,.,............................A...........X-X...,....+++++....,..,,,.................,......,.......,.X
-X.,...E...,,...,.,...,.,,,......................................X-X...,.............,..,+,,XXXXXXXXXXX.....,......,.......,.X
-X.,.......,,...,.,,..,....,,,,,,................................X-X...,.......,.....,..,++,X---------X.....,......,.......,.X
-X.,.......,,...,...,,.,,,.......,,,,,,..........................X-X..,.......,.,,....,..,+,XXXXXXXXX-X.....,......,.......,.X
-X.,.......,,...,......,..,,,,,,.......,,,,,...........E.........X-X..,.....,,....,...,.............X-X.....,......,.......,.X
-X.,.......,,...,......,........,,,,,,......,,,,,,...............X-X..,....,.......,..,,,,,,,,,,,,E.X-X.....,......,.......,.X
-X.,.......,,...,......,.....,..E.....,,,,,,......,,,,,..........XXX..,...,XX+++++XX,,............,.X-X.....,..,,..,.......,.X
-X.,.......,,...,......,...,,.,,............,,,,,,.....,,,,,,........,..,,.XX,,,,,XX..,...........,.X-X.....,,,..,.,.......,.X
-X.,.......,,...,......,..,.....,.................,,,........,,,,,,..,.,...X...E..XX...,..........,.X-X.....,,.H.,.,.......,.X
-X.,.......,,...,......,..,.....,...................,.....,,.......,,,.,...X..ttt.XX...,..........,.X-X.....,.,..,.,.......,.X
-X.,...E...,,...,......,..,..T..,.......:...........,...,,..,...........,..X..tHt.XX..,...........,.X-X.....,..,,..,.......,.X
-X.,........,...,......,..,.....,...................,...,...,...........,..XA.ttt.AX..,...........,.X-X......,.....,.......,.X
-X.,............,......,..,.....,...................,...,,H.,............,.X.XXXX.XX.,............,.X-X......,.....,.......,.X
-X.,............,......,...,,.,,....................,.....,,.............,.X.AXHX.AX.,............,.X-X......,.....,.......,.X
-X.,............,......,.....,..E...................,.....................,XXXX+XXXX,.............,.X-X......,.....,.......,.X
-X..,...........,......,........................,,,,,.............,,,,,...,.........,..,,,,,,,,,,,,.X-X......,.....,.......,.X
-X..,...........,......,..............,,,,,,,,,,.........,,,,,,,,,....,....,.......,...,............X-X......,.....,.......,.X
-X..,...........,...,,.,....,,,,,,,,,,..........,,,,,,,,,........XXX..,....,,,,,,,,,..,..,,,XXXXXXXXX-X...E..,.....,...E...,.X
-X..,...........,.,,..,,,,,,..........,,,,,,,,,,.................X-X..,...............,.,.+,X---------X......,.....,.......,.X
-X..,...........,.,...,......,,,,,,,,,...........................X-X..,...............,.++,,XXXXXXXXXXX......,.....,.......,.X
-X..,...........,.,,..,.,,,,,....................................X-X...,.............,..++,..................,.....,.......,.X
-X..,....E......,...,,..,...........................A............X-X...,.............,..XXX..................,.....,.......,.X
-X..,...........,......,.........................................X-X...,............,...X-X..E...............,.....,.......,.X
-X..,..........,.......,................E........................X-X...,.....,......,...X-X..................,.....,.......,.X
-X..,..........,......,....................................E...E.XXX...,...,,.,.....,...X-X.....E............,.....,.......,.X
-X..,..........,......,..........................................,+,...,...,..,....,....X-X.......A..........,.....,....E..,.X
-X..,..........,.....,.......XXXXXXXXXXXXXXXXXXXXXXXXXXXXXXXXXXX+,+,...,...,,.,....,....X-X..................,.....,.......,.X
--X.,..........,.....,.......X---------------------------------X++.,..E,.....,.....,....X-X..................,.....,.......,.X
--X.,..........,....,........XXXXXXXXXXXXXXXXXXXXXXXXXXXXXXXXXXX,,,.....,.........,.....X-X..................,.....,.......,.X
--X.,..........,....,...................................................,.........,.E...XXX..................,.....,.......,.X
--X.,..........,...,,,,,,,,,,,,,,,,,,,,,,,,,,,..........................,........,..............,,,,,,,,,,,,,,.....,.......,.X
--X.,..........,..............................,,,,,,,,,,,,,,,,,,,,,,,,,,,........,,,,,,,,,,,,,,,...................,.......,.X
--X.,..........,...................................................................................................,.......,.X
--X..,.........,..................................................,,,,,,,,,,,,,,,,,,,,,,,,,,,,,,,,,,,,,,,,,,,,,,,,,,.......,.X
--X..,.....E...,,,,,,,,,,,,,,,,,,,,,,,,,,,,,,,,,,,,,,,,,,,,,,,,,,,.........................................................,.X
--X..,.....................................................................................................................,.X
--X..,...................E..................................................................E.......E................E.....,.X
--X..,.....................................................................................................................,.X
--X..,......................................E...........E..................E.................................E.............,.X
--X..,..............................................................E..............E.......................................,.X
--X..,.....................................................................................................................,.X
--X..,...........................................................,,,,,,,,,,,,,,,,,,,,,,,,,,,,,,,,,,,,,,,,,,,,,,,,,,,,,,,,,,,.X
--X..,,,,,,,,,,,,,,,,,,,,,,,,,,,,,,,,,,,,,,,,,,,,,,,,,,,,,,,,,,,,............................................................X
--X.............................................................XXXXXXXXXXXXXXXXXXXXXXXXXXXXXXXXXXXXXXXXXXXXXXXXXXXXXXXXXXXXXX
--XXXXXXXXXXXXXXXXXXXXXXXXXXXXXXXXXXXXXXXXXXXXXXXXXXXXXXXXXXXXXX--------------------------------------------------------------
