-----------------------------------------------------------------------XXX------------------------------------
-----------------------------------------------------------------------X.X------------------------------------
-----------------------------------------------------------------------X.X------------------------------------
-----------------------------------------------------------------------X.X------------------------------------
-----------------------------------------------------------------------X.X------------------------------------
-----------------------------------------------------------------------X.X------------------------------------
-----------------------------------------------------------------------X.X------------------------------------
------------------------------XXXX-------------------------------------X.X------------------------------------
---------------------------XXX,,.,X------------------------------------X.X------------------------------------
-------------------------XX.,,,.,..XX----------------------------------X.X------------------------------------
-----------------------XX,.,.,,.,..,.XX--------------------------------X.X------------------------------------
----------------------X..,.,,,..,.,,.,X--------------------------------X.X------------------------------------
----------------------X,,.,,,XX,..,..,,X-------------------------------X.X------------------------------------
----------------------X.E,,XX--XX,,.,.,X-------------------------------X.X------------------------------------
----------------------X,..X------XX.,,.,X------------------------------X.X------------------------------------
----------------------X.,,X--------X.,.,.XX----------------------------X.X------------------------------------
----------------------X,,,X---------X,.,.,.XXXXXXXXXXXXXXXXXXXXXXXXXXXXX.XXXXXXXXXXXXXXXXXXXXXXXXXXXXXXX------
-----------------------X,.X----------XX,.,.,.,......,,,,,.,.....,......................,.,.............X------
-----------------------X.,,X-----------XX,.,.,......,,....,.....,......................,.,.............X------
-----------------------X,,,X---XXXXXXXX--XX,.,......,,,..H,.....,......................,.,............,X------
-----------------------X...X---XX----XX----XXXXXXXXXXXXXXXXXXXXXXXXXXXXXXXXXXXXXXXXXXXXXXX...E........,X------
-----------------------X...X----XXXXXX---------------------------------------------------X..,,,,,,,...,X------
-----------------------X...X-----XXXX----------------------------------------------------X..,.....,...,X------
-----------------------X...X---XXXXXXX-----------------XXXXXXXXXXXXXXXXXXXXXXXXXXXXXXX---X..,.....,..,.X------
-----------------------X...X---X-----XX--------------XX..............................X---X..,.....,..,.X------
-----------------------X...X---XXXXXXXX-------------X....,,,,,,,,,,..,,,,,,,,,,,,,,,.X---X..,.....,..,.X------
-----------------------X...X----XXXXXX------------XX.....,........,..,.............,AX---X..,.....,..,.X------
-----------------------X...X---XXXXXXX----------XX.......,.........,..,............,.X---X..,.....,..,.X------
-----------------------X...X---X-----XX--------X.........,.........,..,............,AX---X..,.....,.,..X------
-----------------------X...X---XXXXXXXX------XX..........,..........,..,...........,AX---X..,.....,.,..X------
-----------------------X...X----XXXXXX------X............,..........,..,...........,.X---XW.,.....,.,..X------
-----------------------X...X--XXXXXXXXX---XX,............,..........,...,..........,.X---X..,,,,,,,.,..X------
-----------------------X+++X-------XXX---X..,............,...........,..,..........,.X---X.........,...X------
-----------------------X...X------XX-----X..,............,...........,...,,,,,,,,,,,.X---XA........,...X------
-----------------------XE.EX-------XX---->..,............,............,..............X---XXXXXXXXXXX...X------
-----------------------X...X--XXXXXXXX--->..,....E.......,............,..............XXXXXXXXXXXXX-X...X------
------------XXXXXXXXXX-X...X--XXXXXXXXX-->..,............,............,..,,,,,,,,,,,.,...........X-X...X------
------------XXXXXX.<.X-X...X--XXXXXXXXX--X..,............,...........,..,..........,.,...........X-X...X------
------------XX--XX,,,X-X.E.X--XX--X--XX--XX.,............,...........,..,..........,.,...........X-X...X------
------------XXXXXX...X-X...X--XX--X--XX----XX............,..........,..,...........,.,...........X-X...X------
------------X----X...X-X...X--XX-----XX------XX..........,..........,..,...........,.,...........X-X...X------
------------XXXXXX...X-X...X--XXXXXXXXX--------X.........,.........,..,............,.,...........X-X...X------
------------XXXX-X...X-X...X--XXXXXXXXX---------X........,.........,..,............,.,...........X-X...X------
-------------XXXXX...X-XE.EX----XXXX-X-----------XX......,........,..,.............,.,...........X-X...X------
------------XXXXXX...X-X.H.X--XXX--XXX-------------X.....,........,..,.............,.,...........X-X...X------
-----------------X...X-X...X--XXX--XXX--------------X....,,,,,,,,,..,,,,,,,,,,,,,,,,.,...........X-X...X------
-----------------X...X-X+++X--XX--X-XXX--------------XX..............................,...........X-X...X------
-----------------X...X-X...X---XXX-XXX-----------------XXXXXXXXXXXXXXXXXXXXXXXXXXXXXXXXXXX.......X-X...X------
-----------------X...XXX...XXX-XXXX-XX---------------------------------------------------XXX+++XXX-X...X------
-----------------X...XX......X-------------------------------------------------------------X+++X--XX,,,XXX----
-----------------X...XX......XXXXXXXXXXXXXXXXXXXXXXXXXXXXXXXEXXXXXXXXXXXXXXXXXXXXXXXXXXXXXXX,,,XXXX......X----
-----------------X...XX......X...........E.......E.....................E...E.,..........,....H...XX......XX---
-----------------X...XX......X...E...........................................,..........,......E.XX,,,,,.,,X--
-----------------X...XX......X...............................................,..........,........XX,.A.,.,,X--
-----------------X...XX......X,,,,,,,,,,,,,,,,,,,,,,,,,,,,,,,,,,,,,,,,,,,,,,,,..........,........XX,,,,,.,,.X-
---------------XX....XX+XXX++X..........................................................,........XX......,,..X
-------------XX......XX+XXX++X........................,,................................,........XX......,,..X
------------X........XE.E..H.X....................,,.,..,.,,.,,,,,,,,,,,,,,,,,,,,,......,........XX,,,,,.,,..X
----------XX.........XX......X...............,,,.,..,,..,,..,,,,,,,,,,,,,,,,,,,,,,......,........XX,...,.,,.EX
---------X...........XX......X..............,...,,..,,..,,..,...................,,......,........XX,AAA,.,,..X
-------XX............XX......X..............,...,,..,.,,,.,,....................,,......,..E.....XX......,,..X
-----XX..............XX......X............,,.,,,..,,..,.........................,,......,........XX......,,..X
----X................XX......X...........,..,........,,.........................,,......,........XX......,,..X
---X,................XX......X...........,..,.........,,........................,,......,........XX,,,,,,,,..X
--X.,................XXX...XXX............,,.........,..........................,,......,........XX..A...,,..X
--X.,................X-X.E.X-X...........,,,.........,..........................,,......,....E...XX,,,,,,,,..X
-X..,................X-X...X-X..........,...,.......,...........................,,......,........XX......,,..X
X...,................X-X...X-X..........,...,.......,...........................,,......,........XX......,,..X
X...,................X-X+++X-X..........,...,..........,,,......................,,......,........XX,,,,,.,,..X
X.W.,................X-XE.EX-X...........,,,..........,...,.....................,,......,........XX,...,.,,E.X
X...,................X-X...X-X...........,,...........,..E,.....................,,......,........XX,,H,,.,,..X
X...,................X-X...X-X..........,..,...........,,,......................,,......,........XX......,,..X
X...,................X-X...X-X..........,..,....................................,,......,....E...XX......,,..X
-X..,................X-X...X-X...........,,.....................................,,......,........XX......,,..X
--X.,................X-X.E.X-X..................................................,,......,........XX,,,,,.,,..X
--X.,................X-X...X-X..........,,,.....................................,,......,........XX,.H.,.,,..X
---X,................X-X...X-X.........,...,....................................,,......,........XX,,,,,.,,..X
----X................X-X...X-X.........,...,....................................,,......,........XX......,,E.X
-----XX..............X-X...X-X..........,,,.....................XX..............,,......,........XX......,,..X
-------XX............X-X...X-X..........,,,....................X--X.............,,......,........XX,,,,,.XXXXX
---------X...........X-X...X-X.........,...,...................X--X.............,,......,........XX,.H.,.X----
----------XX.........X-X...X-X.........,...,...................X--X.............,,......,........XX,,,,,.X----
------------X........X-XE.EX-X.........,...,....................XX..............,,...,,,,........XX......X----
-------------XX......X-X...X-X..........,,,.....................................,,,,,,.........E.XX......X----
---------------XX....X-X...X-X...........,,.....................................,,,,,,....E......XX......X----
-----------------X...X-X...X-X..........,..,........................................,,...........XX,,,,,.X----
-----------------X...X-X+++X-X..........,..,......................................,,,,,,,,,,,,,,,XX,.A.,.X----
-----------------X...X-X...X-X...........,,.,,.....................................,.,...........XX,,,,,.X----
-----------------X...X-X...X--X............,..,.....,,,..,,..,,,.,,,............,,,,.,...........XX......X----
-----------------X...X-X...X--X............,..,.,,.,...,,..,,...,...,..........,.W.,,.,..........XX......X----
-----------------X...XXX...X--X............,..,,..,,...,,..,,...,.H.,..........,.E.,,.,..........XX,,,,,.X----
-----------------X...X.....X--X.............,,.,..,,...,,..,.,,,.,,,............,,,..,...........XX,...,.X----
-----------------X...XXX...X--X.................,,..,,,..,,.......,,.............................XX,,,,,.X----
-----------------X...X-X...X--X..................................,..,............................XX......X----
-----------------X...X-X...X---X.................................,..,............................XX......X----
-----------------X...X-X...X---X..................................,,.............................XX......X----
-----------------X...X-X...X---X.................................,..,............................XXX,H,XXX----
-----------------X...X-X...X---X.................................,..,............................X-X...X------
-----------------X...XXX...X---X.................................,..,............................X-X...X------
-----------------X...,:X...X----X.................................,,.............................X-X...X------
-----------------X...XXX...X----X.....,,........XXX..............,..,............................X-X...X------
-----------------X...X-X...X----X....,..,......X---X.............,..,............................X-X...X------
-----------------X...X-X...X----X....,.E,......X---X.............,..,............................X-X...X------
-----------------X...X-X.E.X----X.....,,........XXX...............,,,............................X-X...X------
-----------------X.H.X-X...X-----X...............................,...,...........................X-X...X------
-----------------X...X-X...X-----X...............................,...,...........................X-X...X------
-----------------X...X-X...X-----X...............................,...,...........................X-X...X------
-----------------X...X-X...X-----X................................,,,,...........................X-X...X------
-----------------X...X-X...X-----X................................,.A.,..........................X-X...X------
-----------------X...X-X...X-----X................................,...,..........................X-X...X------
-----------------X...X-X...XXXXXXXX................................,,,...........................X-X...X------
-----------------X...X-X........KXX.................................,,...........................X-X...X------
-----------------X...X-X...XXXXXXXXX...............................,..,..........................X-X...X------
-----------------X...X-X...X--------XXX............................,..,..........................X-X...X------
-----------------X...X-X...X-----------XXXX.........................,,...........................X-X...X------
-----------------X...X-XLLLX---------------XXX...................................................X-X...X------
-----------------X...X-X,,,X------------------XXXXXXXXXXXXXXXXXXXX,,,,H,,,,XXXXXXXXXXXXXXXXXXXXXXX-X...X------
-----------------X...X-X...X-------------------------------------X.........X-----------------------X...X------
-----------------X...XXX...XXXXXXXXXXXAXXXXXXXXXXXXXXXXXXXXXXXXX--X........X-----------------------X...X------
-----------------X...X:X........,,..E....E....E.......E.....E..X--X........X-----------------------X...X------
-----------------X...X-X.......,,,,............................X--X.......X------------------------X...X------
-----------------X...X-X.......,,,..E....E....E.......E........X---X......X------------------------X...X------
-----------------X...X-XXXXXXXXXXXXXXXXXXXXXXXXXXXXXXXXXXXXX,,,X---X......X------------------------X.A.X------
-----------------X...X-------------------------------------X...X---X......X------------------------X...X------
-----------------X...XXXXXXXXXXXXXXXXXXXXXXXXXXXXXXXXXXXXX-X...X---X......X------------------------X...X------
-----------------X.....,.............................,...X-X...X----X.....X-----XXXXXXXXXXXXXXXXXXXX...X------
-----------------X.....,...H.........................,...X-X...X----X....X------X..................,...X------
-----------------X.....,.............................,...X-X.::X----X....X------X.W.A..........E..E,...X------
-----------------XXXXXXXXXXXXXXXXXXXXXXXXXXXXXXXXXXXXX...X-X.::X-----X...X------X...................,..X------
-----------------------------------------------------X...X-X...XXXXXXX...XXXXXXXXXXXXXXXXX.........E,..X------
-----------------------------------------------------X...X-X.....................X-------X...,,,,,,,,..X------
-----------------------------------------------------X.W.X-X......:.:.........A.WX-------X...,.....,,..X------
-----------------------------------------------------X...X-X......:.:............X-------X...,.....,.,.X------
-----------------------------------------------------X...X-XXXXXXXXXXXXXXXXXXXXXXX-------X...,.....,.,.X------
-----------------------------------------------------X...X-------------------------------X...,.....,.,.X------
-----------------------------------------------------X...X-------------------------------X...,.....,.,.X------
-----------------------------------------------------X.EEX-------------------------------X...,.....,.,.X------
-----------------------------------------------------X...X-------------------------------X...,.....,..,X------
-----------------------------------------------------X.EEX-------------------------------X...,.....,..,X------
-----------------------------------------------------X...XXXXXXXXXXXXXXXXXXXXXXXXXXXXXXXXX...,.....,..,X------
-----------------------------------------------------X,.,....A...,,.,,,,,,.,,,,,.,E,.+.......,,,,,,,..,X------
-----------------------------------------------------X,.,....A...,,.,,,,,,.,,,,,.,,,.+E................X------
-----------------------------------------------------X.,,,,,.A...,,.,,,,,,.,,,,,.,E,.+.................X------
-----------------------------------------------------XXXXXXXXXXXXXXXXXXXXXXXXXXXXXXXXXXXXXXXXXXXXXXXXXXX------
-------------------------------------------------------:X:----------------------------------------------------
--------------------------------------------------------------------------------------------------------------
