---------------------------------------------XXXXXX-------------------------------------------XXXXXXXXXXXXXXX------
-------------------------------------------XX......X------------------------------------------XK,:WH:XX.....X------
------------------------------------------X...HHHH..X-----------------------------------------X,,....XX.XXX.X------
-----------------------------------------X...........X----------------------------------------X...:.EXXEX-X.X------
-----------------------------------------X.:,,:,:,,:..X---------------------------------------X:.E..:XX.X-XEX------
----------------------------------------X..,...E,..,...X--------------------------------------X.XXXXXXX.X-X.X------
----------------------------------------X..,...E,..,...X--------------------------------------XEXXXXXXX,X-XEX------
---------------------------------------X.H.:..,,,..,:.AX--------------------------------------XLX.,,,,,.X-X.X------
---------------------------------------X.H.,,E,,,E,,..HX--------------------------------------X,X,..E.,.X-XEX------
---------------------------------------X.H.:,,,,,,,,:.AX--------------------------------------XHX,....,,X-X.X------
----------------------------------------XH.,...,,..,..AX--------------------------------------X.X,..:..,XXXEX------
----------------------------------------X..,...E,..,..X---------------------------------------XHX,....,,XXX.X------
-----------------------------------------X.:,,,,,,,:..X---------------------------------------X.X.,,.,,EX-X.X------
-----------------------------------------X....:.:....X----------------------------------------XHXXX++XXXX-X.X------
------------------------------------------X.........X-----------------------------------XXXXXXX,XXXXXXXXXXX,XXXXXXX
-------------------------------------------XX......X------------------------------------X.........................X
---------------------------------------------XX,XXX-----------------------------XXX----XXH........................X
----------------------------------------------X.X-------------------------------XTX----L,.........................X
---------------------------------------------X-X--------XXXXXXXXXXXXLLXXXXXXXXXXXtX----LXH...........W............X
---------------------------------------------X-X--------X..E....E..E...,,.E.LL....X-----X.........................X
------------------------------------XXXXXXXXX.X---------X..............,,...LL.E..X-----XH........................X
------------------------------------X......E,.X---------X..E....E..E...,,.E.LL....X-----X........A.A.H.A.A........X
------------------------------------X.XXXXXXX.X---------X.XXXXXXXXXXXXXXXXXXXXXXXXX-----X.......XXXXXXXXXXX.......X
------------------------------------X.X-----X.X---------XEX-----------------------------X.......X---XXX---X.......X
------------------------------------X.X-----X.X-----XXXXX.X-----------------------------X.......X---X,X---X.......X
------------------------------------X.X-----X.X-----X.....X-----------------------------X.......X--X...X--X.......X
------------------------------------X.X------X-X----X.XXXXX-----------------------------X.......X-X..W..X-X.......X
------------------------------------X.X------X-X----X.X---------------------------------X.......X-XH...HX-X.......X
------------------------------------X.X-------X.X---X.X---------------------------------X...E...X-X..A..X-X...E...X
------------------------------------X.X-------X.X---X.X---------------------------------X.......X-X.....X-X.......X
------------------------------------X.XXXXXXX-X.X---X.X---XXXXXXXXXXXXXXXXXXXXXXXXX-----X.......X--X.A.X--X.......X
------------------------------------X.......X-X.X---X.X---X.......................X-----X...E...X--X...X--X...E...X
------------------------------------XXXXXXX.X-X.X---X.X---X.......................X-----X.......X--X...X--X.......X
------------------------------------------X.X-X.X---X.X---X....E...EXXXXXX........X-----X.......X--XX,XX--X.......X
------------------:X:XXXXXXXXXXXXXXXXXXXX-XEX-XEX---X,X---X.....,,,.XXXXXX........X-----X.......X-XXX,XXX-X.......X
------------------X..,..............,...X-X.X-X,X-XX..X---X.....,T,.XX...X........X-----X.......X-X..E..X-X.......X
------------------:..,............E.,...X-X.X-X,XX.....X--X.....,,,.AX.E.XH....E..X-----X.......X-X.....X-X.......X
------------------X,,,H.............,...X-X.X-X.......EX--X..XXXXXXAAX...XHXX.....X-----X.......X-X.E.E.X-X.......X
------------------X..HH.............,...X-X.X-X...E.....X-X..XXXXXXXXX...XXXX.....X-----X.......X-X.....X-X.......X
------------------X.................,...X-X.XX.B..B...B.X-X..XX.............X.....X-----X..E.E..X-XE...EX-X..E.E..X
------------------X.........E.......,...X-X.XX..........X-X..XXtt...........X.....X-----X,,,,,,,X-X.....X-X,,,,,,,X
------------------X.................,...X-X.XX.H........X-X..XXTt...........X.....X-----X.......X-X.....X-X.......X
------------------X.......A,,A,.,,,.t...X-X.X-X...B.....X-X..XXXXXXXXX...XXXX.....X-----X,,,,,,,XXX,,,,,XXX,,,,,,,X
------------------X.......,...,.,T,.A...X-XEX-X.....E...X-X........AAX...XH.......X-----X.........,.....,.........X
------------------X.E.....,.:.,E,,,.t...X-X.X--X....B..X--X.........AX.E.XH.......X-----X.........,,,,,,,.........X
------------------X.......A..A,.....,...X-X.X---XXX....X--X.........XX...X........X-----X.........................X
------------------X.......,,,,,.....,...X-X.X------XX,X---X.........XXXXXX........X-----X.........................X
------------------X.................,...X-X.X-------X.X---X.......................X-----X.........................X
------------------X.........E.......,...X--X-X------X.X---X.......................X-----X.....X,,XX.....X,,XX.....X
------------------X.................,...X--X-X------X.X---X.......................X-----X.....,...,.....,...,.....X
------------------X..HH.............,...X---X.X-XXX-X.X---X...E...................:XXXX-X.....,.<.,.....,.<.,.....X
------------------X,,,H.............,...X---X.X-XHX-X.X---X........................XX:X-X.....X..XX.....X..XX.....X
------------------:..,............E.,...X---XHX-X.X--X-X--X........................XX,XXX.....X,,XX.....X,,XX.....X
------------------K.:,....HHH.......,...X---X.X-X,X--X-X--X..............E.........LL.,,,.....,...,.....,...,.....X
------------------XXXXXXXXX,XXXXXXXXXXX.X---X.XXX,XXX-X.X-X........................LL.E,,.....,...,.,,,.,...,.....X
--------------------------XLL---------X.X---X......AX-X.X-X........................LL.,,,.....,...,.,:,.,...,.....X
--------------------------------------X.X---XXXXX...X-XEX-X........................LL.E,,.....,...,.,,,.,...,.....X
--------------------------------------X.X-------X...X-X.X-X........E...............LL.,,,.....,...,.....,...,.....X
--------------------------------------X.XXXXXXX-X.,,X-X.X-X........................XX,XXX.....X,,XX.....X,,XX.....X
--------------------------------------X.,.....X-XA,:X-X.X-X.......................:XX:X-X.....,...,.....,...,.....X
--------------------------------------X.,.H.H.X-XXXXX-X.X-X...........,,..........XXXXX-X.....,.<.,.....,.<.,.....X
--------------------------------------X.,.....X-------X.X-X.........,,..,,........X-----X.....X..XX.....X..XX.....X
--------------------------------------X.,.H.H.XXXXXXXXX,X-X.......,,......,.......X-----X.....X,,XX.....X,,XX.....X
--------------------------------------X.,.....,.......,.X-XHHHH...,.......,.......X-----X.....,...,.....,...,.....X
----------------------------------XXXXX.,,,,,,,,,,,,,,,.XXX,,,,,,,,,,,,,,..,......X-----X.....,...,.....,...,.....X
----------------------------------X.XX,.............,E.E.E,......,......,..,......X-----X.....,...,.....,...,.....X
----------------------------------XtXXXXXXXXXXXXXXXXXXXXXXX,,,,,,,,,,.H.,...,.....X-----X.....,...,.....,...,.....X
---------------------------------X:,X:XXXXXXXXXXXXXXXXXXXXXHHHH.,...,...,...,.....X-----X.....,...,.....,...,.....X
---------------------------------X...XX........,,...,,,..XX......,..,,,,,..,......X-----XXXXXXXXXXXXXXXXXXXXXXXXXXX
---------------------------------X...XX,,,....,.......,..XX......,.........,......X--------------------------------
----------------------------LLXXXXXXE,,..,...,.......E.,.XX.......,,......,.......X---XXXXXXXXXXXXXXXXXXXXXXXXXXXXX
----------------------------X...XXXX.XX,,,...,..........,XX.........,,..,,........X---X..........,,...............X
----------------------------XH.HXXK,EXX.....,...........,XX...........,,..........X---X..........,,.,,,...........X
----------------------------X.E.XXXX.XX,,,..,.....E.....,XX.......................X---X..E......H,,.,.,E..........X
----------------------------XA.AXX..E,,..,..,...........,XX..E....E....E.......E..X---X..........,,.,,,...........X
----------------------------X....,...XX,,,..,...........,XX.......................X---X..........,,.........H,....X
----------------------------XXXXXX..EXX......,.E........,XX.......................X---X.....H,...,,.........,,,...X
---------------------------------X...XX,,,...,,.......,,.XX.......................X---X.....,,...,,.........,.,E..X
----------------------------XXXXXX..E,,..,.....,......,,.XXXXXXXXXXXXX,,,,,,XXXXXXX-XXX..........,,.........,,,...X
----------------------------X.E.E,...XX,,,......,,,,,,,.,X----------XXX.,,,.XXX-----X.t........H.,,...............X
----------------------------X...XX:..:X...............,.,X---XXXXX--X,,.....,,X-----XTt........,.,,...............X
----------------------------XE.EXXXXXXXXX.XXXXXXXXXXXXX.XX--X....X--X.........X-----X.t..........,,...............X
----------------------------X...X-------X,X-----------X.XXXXX..E..X-X..E.H.E..X-----XXX.....,,,..,,...............X
----------------------------XE.EX-------XEX-----------X.,...,.....X-X.........X-------X.....,.,E.,,...............X
----------------------------XXXXX-------X,X-----------X.XXXXX..E.X--XX,.....XXX-------X.....,,,..,,H,......H......X
----------------------------------------XEX----------X...X---X...X--XXX.....XXX-------X..........,,,,......,......X
----------------------------------------X,X---------X.....X---X,X---XXXXX,XXXXX-------X...H......,,.,,,...........X
----------------------------------------XEX---------XH...HX---X,X-------X.X-----------X...,......,,.,.,E..........X
----------------------------------------X,X---------X.....X--X...X----XXX.XXX---------X........E.,,.,,,...........X
----------------------------------------X,X---------XH...HX-X.,,,,X---X.....X---------X..........,,...............X
------------------------------------XXXXX,XXXXXXX---XXX,XXX-X,,.,,X---XX,.XXX---------XXXXXXXXXXXXX...............X
------------------------------------XH.........HX-----X.X---X,,,,,X---XX,.XXX---------------------X...............X
------------------------------------XH.........HX-----X.X---X.....X---X,,.,,X---------------------X..........W....X
------------------------------------XH.........HX-----X+X----XXXXX----X.....X-------------XXX-----X..A............X
------------------------------------XH..XXXXX..HX---XXX+XXXXXXXXXXXXXXX,,,,,XXXXXXXXXXXXXXX,XXX---X..,........,,,.X
------------------------------------X...X---X...X---X.....,...........,.....,...........,.B..BX---X...........,.,EX
------------------------------------X...XXXXX...X---X.....,...........,.....,...........,..BB.X---X...........,,,.X
-----------------------------------X......H.....X---X.....,...........,.....,...........,H.BB.X---X...............X
-----------------------------------X..,,,,,,,,,.X---X.....,...........,.....,...........,.B..BX---X...............X
-----------------------------------X..,.E++.E.,X----X..E..,...........,.....,...........,.....X---X...............X
-----------------------------------X..,,,,,,,,,X----X.....,...........,.....,...........,BBBB.X---X...............X
----------------------------------X.H.....H.,,.X----X.....,...........,.....,...........,B....X---X...............X
----------------------------------XXXXX........X----X.....,...........,.....,...........,B...EX---X.....,,,.A.....X
--------------------------------------XXXXXXXXXX----X.....,...........,..E..,...........,.....X---X..H,.,,,E......X
--------XXX-----------------------------------------X.....,...........,.....,...........,.BBBBX---X.....,,,.......X
--------XTX-----------------------------------------X.....,...........,.....,...........,....BX---X...............X
XXXXXXXXXtXXXXXXXXXXXXXXXXXXXXXXXXXXXXXXXXXXXXXXX---X.....,...........,.....,...........,.E..BX---X...............X
X...............,...............,...............X---X.....,...........,.....,...........,.....X---X...............X
X...............,E..............,...............X---X.....,...........,.....,...........,BBBB.X---X...............X
X...............,...............,...............X---X.....,...........,.....,...........,B....X---X...............X
X+XXXXXXXXXXXXXXX..,,,,,,,,.....XXXXXXXXXXXXXXX+X---X.....,...........,.....,...........,B...EX---X..........H,...X
X.,............XX..,......,.....X.............,.X---X.....,...........,.....,...........,.....X---X..........,,...X
X.,............XX...,.....,.....X.............,.X---X.....,...........,.....,...........,.BBBBX---X.........,,,...X
X.,............XX...,......,....X.............,.X---X.....,...........,.....,...........,....BX---X.........,.,...X
X,,............XXXXXXX,,,,,XXXXXX.............,,X---X.....,...........,.....,...........,.E..BX---X.........,,,...X
X...............................................X---X.....,...........,.....,...........,.....X---X..........E....X
X.,,,,,,,,,,,,,,,,,,,,,,,,,,,,,,,,,,,,,,,,,,,,,.X---X.....,...........,.....,...........,BBBB.X---X...............X
X.,...........................................,.X---X.....,...........,.....,...........,B....X---X..H............X
X.,...........................................,.X---X.....,...........,.....,...........,B...EX---X...............X
X.,...........................................,.X---X.....,...........,.....,...........,.....X---X...............X
X.,...........................................,.X---X.....,...........,.....,...........,.BBBBX---X...............X
X.,...........................................,.X---X.....,...........,.....,...........,....BX---X........H......X
X.,...........................................,.X---X.....,...........,.....,...........,.E..BX---X...............X
X.,...........................................,.X---X.....,...........,.....,...........,.....X---X...............X
X.,............E..............................,.X---X..E..,...........,..H..,...........,BBBB.X---X....H..........X
X.,...................,,,..............E......,.X---X.....,...........,.....,...........,B....X---X...............X
X.,................,,,...,,,..................,.X---X.....,...........,.....,...........,B...EX---X.....,,,.......X
X.,.............,,,.........,,,...............,.X---X.....,...........,.....,...........,.....X---X.....,,,H,.....X
X.,...........,,...............,,.............,.X---X.....,...........,.....,...........,.BBBBX---X.....,,,,,.....X
X.,..........,...................,,...........,.X---X.....,...........,.....,...........,....BX---X...............X
X.,.........,..........,,,.........,..........,.X---X.....,...........,.....,...........,.E..BX---X......E........X
X.,........,...........,,,..........,.........,.X---X.....,...........,.....,...........,.....X---X...............X
X.,........,.......,,,,,,,,,,.......,.........,.X---X.....,...........,.....,...........,BBBB.X---X...............X
X.,.......,.......,..........,.......,........,.X---X.....,...........,.....,...........,B....X---X...............X
X.,......,.......,..XX....XX.,.......,........,.X---X.....,...........,.....,...........,B...EX---X...............X
X.,.....,.......,...XX....XX..,,......,.......,.X---X.....,...........,.....,...........,.....X---X...............X
X.,.....,......,XX............XX,.....,.......,.X---X.....,...........,.....,...........,.BBBBX---X...............X
X.,....,.......,XX............XX,......,......,.X---X.....,...........,.....,...........,....BX---X...............X
X.,....,......,.................,......,......,.X---X.....,...........,.....,...........,.E..BX---X....H,.........X
X.,....,......,.................,......,......,.X---X.....,...........,..E..,...........,.....X---X....,,.........X
X.,....,......,.......>>>>>......,......,.....,.X---X.....,...........,.....,...........,BBBB.X---X.............E.X
X.,....,.....,........>...>......,......,.....,.X---X.....,...........,.....,...........,B....X---X...............X
X.,....,..E..,....E...>...>...E..,...E..,.....,.X---X.....,...........,.....,...........,B....X---XXXXX.......XXXXX
X.,....,......,.......>...>......,......,.....,.X---X..E..,...........,.....,...........,.....X-------X:.....:X----
X.,....,......,.......>>>>>......,.....,......,.X---X.....,...........,.....,...........,.BBBBX-------X.......X----
X.,....,......,.................,......,......,.X---X.....,...........,.....,...........,....BX-------XA.....AX----
X.,....,......,.XX............XX,......,......,.X---X.....,...........,.....,...........,....BX-------X,,,,,,,X----
X.,.....,......,XX......H.....XX,.....,.......,.X---X.....,...........,.....,...........,.....X-------X,,,,,,,X----
X.,.....,......,...............,......,.......,.X---X.....,...........,.....,...........,BBBB.X-------XH,E,E,HX----
X.,......,......,,..XX....XX..,.......,.......,.X---X.....,,,,,,,,,,,,,.....,,,,,,,,,,,,,.....X-------X,,K,,,,X----
X.,......,........,.XX....XX.,.......,........,.X---XXXXXXXXXXXXXXXXXXXXXXXXXXXXXXXXXXXXXXXXXXX-------XXXXXXXXX----
X.,.......,........,,,,,,,,,,........,........,.X------------------------------------------------------------------
X.,........,........................,.........,.X------------------------------------------------------------------
X.,..E......,......................,.......E..,.X------------------------------------------------------------------
X.,..........,...................,,...........,.X------------------------------------------------------------------
X.,...........,,...............,,.............,.X------------------------------------------------------------------
X.,.............,,,.........,,,...............,.X------------------------------------------------------------------
X.,................,,,...,,,..................,.X------------------------------------------------------------------
X.,...................,,,.....................,.X------------------------------------------------------------------
X.,...........................................,.X------------------------------------------------------------------
X.,...........................................,.X------------------------------------------------------------------
X.,...........................................,.X------------------------------------------------------------------
X.,...........................................,.X------------------------------------------------------------------
X.,...........................................,.X------------------------------------------------------------------
X.,...........................................,.X------------------------------------------------------------------
X.,...........................................,.X------------------------------------------------------------------
X.,.........................................E.,.X------------------------------------------------------------------
X.,.E.........................................,.X------------------------------------------------------------------
X.,...........................................,.X------------------------------------------------------------------
X.,...........................................,.X------------------------------------------------------------------
X.,,,,,,,,,,,,,,,,,,,,,,,,,,,,,,,,,,,,,,,,,,,,,.X------------------------------------------------------------------
X...............................................X------------------------------------------------------------------
XXXXXXXXXXXXXXXXXXXXXXXXXXXXXXXXXXXXXXXXXXXXXXXXX------------------------------------------------------------------
