----------------XXXXXXX----------------
----------------X.....X----------------
----------------X..W..X----------------
----------------X.....X----------------
----------------X.....X----------------
----------------++X+++X----------------
------------------W:X------------------
------------------X.X------------------
------------------H:X------------------
--XXXXXXXXXXXXXXXXX,XXXXXXXXXXXXXXX----
--X...............................X----
--X...............................X----
--X........E...................E..X----
--H,,,,..........,,,A,...,,,......X----
--X,,,,..,AAA,...,,,,,...,:,......X----
--X,.....,,,,,...........,.,......X----
--X,.....................,.,......X----
--H,..:..................,K,......X----
--X,.....................,W,......X----
--X,........W..E....E....,,,....H.X----
--H,,H............................X----
--X,,,..............,.............X----
--XW,H,,,,........,,.,,...........X----
--XA,,,,,,.......:.....:........:.X----
--X.,,,,,,.....XXX.....XX,........X----
--XH,H,,,,....X--X.....XBBX,......X----
--X.,,........X---X...X-X..,,,....X----
--X.,H........X---X...X-XW...,,,..X----
--X:,,...E....X---XLLLX-X.....,,XXX----
--X.,H........X---X,,,X--XX.:...XXX----
--X:,,........X---X,,,X----XX.....X----
--X.,,..,,,,,.X---X,,,X------X....X----
--X.,,..,A,A,.X---X,,,X-------X...X----
--X.,,..,.A,,.X---X,,,X-------X...X----
--X.,,.A,AA,,.X---X,,,X-------X...X----
--X.,,..,,,,,.X---X,,,X-------X...X----
--X.,,........X---X,,,X-------X...X----
--X...........X---X,,,X-------X...X----
--X...........X---X,,,X-------X...XXXXX
--X,XXXXXXXXXXX---X,,,X-------X.E.,...X
--X.X-------------X,,,X-------X...,E.EX
--X.X------------XX,,,XX------X...,...X
--X.X---------XXX.......XXX---X.E.,E.EX
--X,X-------XX.............XX-X.A.XXXXX
--X.X-------X:.............:X-X...X----
--X,X-------X...H.......W...X-X.A.X----
--X.X-------X.......E.......X-X...X----
--X,X-------X...............X-X.A.X----
--X.X--XXXHXX...E......E....X-X...X----
--X,XXX,....X:.............:XXX...XXXX>
--X.++:.,+++,......,,,......,+X...L...>
--X:++.:,WK+,...:..,H,......,+X...L.W.>
--XW++::,+.+,.E....,,,...E..,+X...L...>
--X,XXX,,+++X:.............:XXX...XXXX>
--X.X-XH...XX...............X-X...X----
--X,X--XXXX-X...A.......H...X-X...X----
--X.X-------X...............X-X...X----
--X,X-------XE..E...E..E..E.X-X...X----
--X.X-------X:.............:X-X.:.X----
--X,X-------XXXXXXXXX,,,XXXXX-X...X----
--X.X-------------XXK.XX------X.W.X----
--X,X-----------XX:.XX--------X...X----
--X.X---------XX:.XX----------X<.<X----
XXX,XXXXXXXXXXLLXXXXXXXXXXXXXXX...X----
X.............................X<.<X----
XE......A.....W.......A.....E.X...X----
X..,,,.........E.........,,,..X,,,X----
X..,.,,,,,,,,,,,,,,,,,,,,,.,..X,,,X----
X..,,,,,,.,,,.,,,.,,,.,,,,,,.,,...X----
X...,.,.,.,.,.,.,.,.,.,.,.,..,,...X----
X...,.,E,.,E,.,.,.,E,.,E,.,..,,...X----
X...,H,.,.,.,.,.A.,.,.,.,.,..,XXXXX----
XE..,.,.,.,.,.,.,.,.,.,.,.,.E.X--------
X...,.,.,.,.,.,.,.,.,.,.,.,..,X--------
X..,,,,.,.,.,.,.,.,.,.,.,,,,,.X--------
X..,.,,,,,,,,,,,,,,,,,,,,,.,..X--------
X..,,,,,,,,,,,,,,,,,,,,,,,,,..X--------
X...........A.......A...W.....X--------
XE.............E............E.X--------
XXXXXXXXXXXXXXXXXXXXXXXXXXXXXXX--------
