---------------------------------------------XX------------------------------
-----------------------------------------XXXX.X------------------------------
-------------------------------------XXXX.,,,,X------------------------------
---------------------------------XXXX.....,,,,X------------------------------
------------------------------XXX,,.......,,.,X------------------------------
------------------------------X..,t,,,,,......X------------------------------
------------------------------X..,t....,.:.,,,X------------------------------
------------------------------X..,t....,...,,,X------------------------------
------------------------------XT.,t...W,...,,,X------------------------------
------------------------------X..,t....,...,,,X------------------------------
------------------------------X..,t....,.:....X------------------------------
------------------------------X..,,,,,,,...,,,X------------------------------
------------------------------XXX,,.......,,,,X------------------------------
---------------------------------XXXX.....,,,,X------------------------------
-------------------------------------XXXX...,,X------------------------------
-----------------------------------------XXXX.X------------------------------
---------------------------------------------XX------------------------------
-----------------------------------------------------------------------------
-----------------------------------------------------------------------------
-----------------------------------------------------------------------------
-----------------------------------------------------------------------------
-----------------------------------------------------------------------------
-----------------------------------------------------------------------------
-----------------------------------------------------------------------------
-----------------------------------------------------------------------------
-----------------------------------------------------------------------------
-----------------------------------------------------------------------------
-----------------------------------------------------------------------------
-----------------------------------------------------------------------------
-----------------------------------------------------------------------------
-----------------------------------------------------------------------------
-----------------------------------------------------------------------------
-----------------------------------------------------------------------------
-----------------------------------------------------------------------------
-----------------------------------------------------------------------------
-----------------------------------------------------------------------------
-----------------------------------------------------------------------------
-----------------------------------------------------------------------------
---------------------------------------XXXXXXXXX-----------------------------
---------------------------------------X.......X-----------------------------
---------------------------------------X.....E.X-----------------------------
---------------------------------------X.......X-----------------------------
---------------------------------------X.......X-----------------------------
---------------------------------------X.......X-----------------------------
---------------------------------------X.E.....X-----------------------------
---------------------------------------X.......X-----------------------------
---------------------------------------XXXXXXXXX-----------------------------
-----------------------------------------------------------------------------
-----------------------------------------------------------------------------
-----------------------------------------------------------------------------
-----------------------------------------------------------------------------
------------------------XXX-XXXXXXXXXXXXXXXXXXXXXXXXXXXXXXXXXXXX-------------
------------------XXXXXX..X-X.............................,,....XX-----------
-X-------------XXX........X-X.............................,,.H....X----------
-XX-----------X...........XXX..........++.................XXXXX...X----------
-XX----------X............L,...H...:...:+..E..W.......:...X----XX..X---------
-X.X-------XX...W.........XXX.............................X-----XW.X---------
-X.X------X...............X-X.............................X------X..X--------
-X..X--X-X...............XX-X.............................X------XH.X--------
-X..X-X:X............XXXX---XXXXX,,,XXXXXXXXXXXXXXX.......X------X..X--------
-X...X-X.......,,,,XX-----------X,,,XHX,,,,,,,XXXWX.......X------XLLX--------
X....X-X......,..XXXXXXXXXXXXXXXX...............X.X..E....X-XXXXXXLLX--------
X.....X.......,.,X-XW.KXX,>E..W+L.............A.X.X.......X:X.......X--------
X..E..,.....:.,X.X-XX+XXX,,....XX...............X.X.......XXX.......X--------
X....,.......XXX.XXXX,XXXXXXXXXXX...........,,,,X.X.......L,,..AAA..X--------
X....,.......X-X.,LL,..H.................E..,H..XHX.......L,,.A.AA..X--------
X..XX........X-X.XXXX........:.:............,,,,XXX.......L,,..A.A..X--------
XXX-X.::.::.,X-X.X--X...........................X-X.......L,,...A...X--------
--XX.:.::.:.,XXX,X--X........:.:................X-X.......X:X.:.::.:X--------
--X:.......X.tXX,X--H,,,..............B.........XXX.......XXX,,,,,,,X--------
---X.......X:XXX.X--X,,,,....:.:................X:X.......X-X..:.:...X-------
---XH......:XX-X.X--X...,,................B.....XXX.......X-X.......,:X------
---X.,.....,HXXX.XXXX..W.,,..:.:.,,,............,,,.......A-X..:.:,,,,X------
---+.,.....,W,.,.,..,....,,...H.,...,.B........A,,,....:..A-X..:.:,:,KX------
---X.,.....,.,H,.,E.E....,,.....,.T.,....B......,,,.......A-X.....,,,.X------
---X,,.....,HXXX.,..,....,,......,,,............,,,.......A-X..:.:..,,X------
---XA......:XX-X.XXXX..K.,,..:.:................XXX.......X-X..:.:..,:X------
---X.......XAXXX,X--X...,,.............E.B..B...X:X.......X-X,,,,,,,XX-------
--X:.:.::.:X.X.,+X--X,,,.....:.:....B...........XXX.......X:X.....,.XXXXX----
---X..::.::,.XtX.X--H...........................X-X.......XXX....,,,XXX-X----
----X.......,X,X.X--X........:.:................X-X.......L,,..AAA..X--XX----
----X.......,XXX.XXXX...........................X-X.......L,,.A.AA..X--------
-----X.......X-X.,.L,........:.:.,,,,,,,,,,,,...X-X.......L,,..A.A..X--------
-----X.......XXX.XXXX..H.........,..........,...X-X.......L,,...A...X--------
------X.......,X.X--X...........,.A...H...A..,..X-X..E....X:X.......X--------
------X....:..,.,X--X...........,..,,,,,,,...,.HX-X.......XXXXXXX,,XX--------
-------X......,..XX-XXXXXXXXXXXX,,,X:XXXX:X,,,XXX-X.......XXXXX-XLX----------
-------X.......,,,,XX----------X...X------X...X---X.......X,t-XX.HX----------
-------:X....W.......XXXX---XX:,,,XXXXXXXXXX,,,XXXX.......XXXXXX.X-----------
---------X,..............XX-X.............................,,,,,..X-----------
---------X.X..............X-X................H.....<.<.<.<W,,,,.X------------
---------X.XX.............XXX.............................XXXX..X------------
---------X.X-X............,,...H...:...:..E..W........:...X--X.X-------------
---------X.X--X...........XXX.............................X-X..X-------------
---------XHX---XXX........X-X.............................X-X.X-----XXXXXXXX-
---------X.X------XXX...XXX-X.............................XXH.X-----XT.t..:X-
---------X.X--------X...X-X-XXXXXXX,XXXXXXXXXXXX,XXX,XX,,,XX.X------X,tt...X-
---------X.X--------X...X----X:---X.XXXHXXXHXHXX.X,.TXX:.:X..X------X......X-
---------X.X--------X...XXXXXXXXXXX,XXXXXXXXXXXXXXXXXXX...,.X-------X...,,,X-
---------X.XXXXXXXXXX.....LL......:.......................,.X-------X...,W,X-
---------X..........,.....LL.............E................,X--------X..:,,,X-
---------XXXXXXXXXXXX.....LL......:.......................,X--------X..:,.:X-
--------------------XXXXXXXXXXXXXXXX,,,,,,,,,,,,,,,,XXXXXXX---------X......X-
-----------------------------------X:t.............,X---------------X..:..:X-
-----------------------------------XXXXXXXXXXXXXXXX.X---------------XXXXXXXX-
--------------------------------------------------XTX------------------------
--------------------------------------------------X.X------------------------
--------------------------------------------------X.X------------------------
--------------------------------------------------X.X------------------------
--------------------------------------------------X.X------------------------
--------------------------------------------------X.X------------------------
--------------------------------------------------X++------------------------
