-------------------------------------------------------------------------------------XXXXXXXXXXXXXXXXXXXX-----------------------------
-------------------------------------------------------------------------------------XA.............A...X-----------------------------
-------------------------------------------------------------------------------------X..E..E....E.....E.X-----------------------------
-------------------------------------------------------------------------------------X..................X-----------------------------
-------------------------------------------------------------------------------------X.H...............X------------------------------
-------------------------------------------------------------------------------------X.......E.........X------------------------------
-------------------------------------------------------------------------------------X.................X------------------------------
-------------------------------------------------------------------------------------X.................X------------------------------
-------------------------------------------------------------------------------------X...............E.X------------------------------
-------------------------------------------------------------------------------------X.:...............X------------------------------
-------------------------------------------------------------------------------------X........T.......HX------------------------------
-------------------------------------------------------------------------------------X.................X------------------------------
-------------------------------------------------------------------------------------X................H-------------------------------
-------------------------------------------------------------------------------------X................X-------------------------------
-------------------------------------------------------------------------------------X................X-------------------------------
-------------------------------------------------------------------------------------X...............HX-------------------------------
------------------------------------------------------------------------------------XX..E.............X-------------------------------
----------------------------------------------------------------------------------XX.XX..............HX-------------------------------
---------------------------------------------------------------------------------X.<AXX...............X-------------------------------
--------------------------------------------------------------------------------X....XX............H..X-------------------------------
------------------------------------------------------------------------------XX.....XX..............HX-------------------------------
-----------------------------------------------------------------------------X....E..XXA.........H.H..X-------------------------------
----------------------------------------------------------------------------X..H.....XXXXX,,,XXXXX....X-------------------------------
--------------------------------------------------------------------------XX.E......AX---X+++X---X...X--------------------------------
-------------------------------------------------------------------------X...........XXXXX,,,XXX-X.E.X--------------------------------
-------------------------------------------------------------------------XA.............E..:..HX-X...X--------------------------------
-------------------------------------------------------------------------X.........E..E.......EX-X.W.X--------------------------------
-------------------------------------------------------------------------X...............E.....X-X...X--------------------------------
-------------------------------------------------------------------------XE..B,,,,,,,,,,,,,,...X-X...X--------------------------------
-------------------------------------------------------------------------X...,A....W.H....AB..EX-X.E.X--------------------------------
-----------------------------------------------------------XXXXXXXXXXXXXXX...,.............,...X-X+++X--------------------------------
-----------------------------------------------------------+E.E..A.E.E.E++...,...:.....:...,...X--------------------------------------
-----------------------------------------------------------XXXXXXXXXXXXXXX...,.............,.E.X--------------------------------------
-------------------------------------------------------------------------XE..,......H......,E..X--------------------------------------
-------------------------------------------------------------------------X...B,A,,,,,,,,,A,B...X--------------------------------------
-----------------------------------XXXXX---------------------------------X..............E......X--------------------------------------
-------------XXXXXXXXXXX:XXXXXXXXXX,,,,.XX-------------------------------X.................E..EX------------XXXXXXXXXXX---------------
-------------X..,,,,..,.,....:.,,..:...,,.XX-----------------------------XE.....E..............X------XXXXXX...........XXXXXXXX-------
-------------X..,...A.,.,....,,......A...,..XX---------------------------X...E......H..........X--XXXX........................X-------
------------X.B.,......,.E..,.,,..........,...X--------------------------X.....................X--X.....:....H.........H.....WX-------
------------X..,..E..,,,...,....,,.,......,.E..XX------------------------X...E.E..E.....:......X--X.A..........................X------
------------X..,....,......,..E...,.,,.....,.B...XX----------------------X.....................X--X.....................,,.....X------
------------X..,....,..E..A,.....,....,....,.......XX--------------------X.....E...............X--X.........E...........,.,,...X------
------------X..,....,......,...,,.H...A,.H.,.....E...XX------------------X.....................X--X......................,..,..X------
-----------X..,...E.,......,..,........,...,........:..XX----------------X.....................X--X:.,,..............E...,..,...X-----
-----------X..,.....,...E..,.,.....B...,...,...........H.XX--------------XE....................X--X..,.,,,................,..,..X-----
-----------X...,....,,,....,.,........,....,.........E.....XX------------X...........W.......<.X--X..,....,,,,............,..,..X-----
-----------X....,....,,,,,,,.,.E......,.E..,..............A..XX----------X.....................X--X..,,,......,,,.........,..,..X-----
-----------X.....,..B..,,....,........,....,..........,,,,...E.XX--------X.....................X--X.....,,,,.....,,,.......,.,...X----
----------X.......,......E....,.....,,.....,XX......,,....,,,,...XX------X.....................X--X.........,,,,....,,,,...,..,..X----
----------X...E....,..........,...,,..A...,XXX...,,,.......E..E,,.X------X.....................X-X..............,,,,....,,,.,.,..X----
----------X.........,.........,..,......,XX--X.,,......,,,,......,X------X.....................X-X..........E.......,,,,...,,.,..X----
----------X..........,......,,....,,..,XXXXXXX.,.....,,....,,,,,.,X------X.....................X-X......................,,,,..,...X---
----------X...........,,,,,,..B.....,XXXX,,.XX.,...,,...........,,,X-----X.....................X-X.......E..................,,.,..X---
---------X.................B.B..B..XXX,,..,.XX.,...,......:.A......X-----X.....................X-X..,,,,,....................,.,..X---
---------X..................XXXXXXX..,..E.,.XX,....,...A.........E.X-----X.K.................<.X-X..,....,,,,,,,,...A.....E...,,..X---
---------X...........XXXXXXX.........,.....,XX,..A.,...............X-----X.....................X-X..,..E.........,,,,,,,,.....,.,.X---
---------X...........................,..E..,XX,.....,.........E....X----X.................:..XX--X..,,,,,................,,,,,,.,.X---
---------X.....E...........,,B..B....,.....,XX,......,,..E.........X----X.E................XX----X.......,,,,,..H.,,,,,,E....,.,,..X--
---------X.................,..,,,,B..A.....,XX.,,...E..,........E..X----X.................X------X...........,....,.....,,,,,,.,,..X--
--------X..................,.,,t...,,,.....,XX...,,.....,,,,,,,,,,,X----X...........E...XX-------X......E...A,....,.A...........,,.X--
--------X..................,.,tt.....,.....,XX.....,........E.....,X----X<............XX--------X.............,.E.,.E..E........,,.X--
--------X.............:....,.t,,.E.E.,.....,XX......,,.........A..,X---X....E.....K..X---------X..........E.H.,...,.....,,,,,,.....X--
--------X....,,,,,.........,,,,,,....,...E.,XX........,,,,,,,.....,X---X.......E...XX---------X...........,,,,,...,,,,,,.....,....HX--
--------X....,....,,,,,,,,.......,,,,,.....,XX...............,,,,,,X---XA........XX----------X......,,,,,,......H.......E...,.E....X--
-------X.....,........E...,,,,.......,.....,XX.....................X--X.,.H.....X-----------X.......,..................,,,,,,......X--
-------X....,...E............,.......,.....,XX.....................X--X++,....XX-----------X........,......,,,,,,,,,,,,.............X-
-------X....,......XXXX...E..,.....H.,..E..,XX................,,,,..X-X..+,AXX------------X....A....,,,,,,,.........................X-
-------X..E.,..E...X---XX....,.......,.....,XX...:.......E...E,..,..X-X...XXXXXX---------X...........................XXXX.........A.X-
-------X....,.....X------X...,........,....,XX.,,..............,.,..X-XtE.....:X--------X..............E.....XXXXXXXX---X...........X-
-------X...,......X------X...,........,....,XX.,.,,,,..........,H,..X-X.ttE....XXXXX---X................XXXXX-----------X.....:...XX--
------X....,.....XX-----X....,..X.....,....XX..,.....,,,....E..,..,.X-X...t..E.+A,WX--X.................X-----------X---X........,.X--
------X....,,......XXX--X....,XX-X....,....XX.,....:....,,,...A,..,.X-X....t..:XXXXX-X..................X-------X---XX---X......,.EX--
------X......,,.E..H..XX.....,.X--XXX.,.H..XX.,.E.....A....,,,,.,.,.X-X...XXXXXX----X......,,,..........X-----XXX---X.X--X.....,....X-
------X........,,........A...,.X----X.,....XX.,,,,.......A.....,,.,.X-XXXX--XXXXXXXX.....,,,..,,,.......X----X..X---X..X-X..E..,..HX--
------X..........,,..E.......,..X---X.,...,XX.....,,,,,,..........,.XXXXXXXX...........,,..,....,,,.....X----X..X---X.E.XX.....,.EX---
------X....,,......,,,.......,...XXXX.,.E.,.............,,,,,,...H,......E............,...,.....,..,....X----XE.X---X...XX.....XX-----
------X....,.,,.......,,...E.,........,...,....,,,,...........,,,..,................,,....,,,..,...,....X---X...X---X...XX.....X------
------X....,...,,.....E.,,...,........,...,....,..E,,,,,,,......,..,...,...........,.....,...,,,...,....X---X...X---X..X--X....X------
-----X....,......,,,......,,.,........,...,...,...........,,,,..,..,...,,,.........,....,.......,...,...X---X...X--XX..XX-X..E.X------
-----X....,.........,,......,,.........,H.,...,.......A..E...,..,..,..,..A,,.......,...,........,...,...X---X...XXX......XX....X------
-----X....,..A...E....,,,..............,..,...,..,,,.......H.,..,..,..,.....,,.....,..,.H.....:..,..,...X---X..................X------
-----X....,..............,,............,..,...,..,..,,.,,....,..,.A,.,,,......,,...,..,...........,.,...X---X..................X------
-----X...,.................,,..........,.E,..,.E.,E..,.,.,,..,...,..,...,,,,....,,.,..,...........,..,...X-X...................X------
-----X...,,,,,,...........E..,,........,..,..,...,...,.,..,..,...,..,....A..,,....,,..,...........,..,....XX..................EX------
-----X...B.....,,,,,,.E........,.......,..,..,..,....,.,.A,..,...,..,......,,...,,..,.,.A.........,..,.....X...................X------
----X..B............,..........,....E..,,,..,...,.A.,.E,..,.,....,.,,....,,.A..,....,.,..........A.,.,.........................X------
----X.............E.,........X..,......,....,...,...,..,E.,E,....,,....,,.....,.....,.,......T.....,.,.........................X------
----X...............,.....XXXX...,......XXX.,.H.,...,..,..,.,.........,.....,,......,..,,..........,.,........................AX------
----X......:.......,,.....X--X.E..,....X-X..,...,...,,.,..,.,..........,...,,.A.....,....,........,..,.........................X------
----X............,,.......X---X...,....X-X.,....,.....,,..,.,.........E.,....,,.....,.....,.....,,...,.........................X------
----X.........,,,.....,....X--X....,..X-X..,....,.........,.,..,,,,,,,,,,,...E.,,....,,...,....,....,........:................X-------
---X.......,,,.......,,..E.XXX...,,...X-X...,..,..........,,,..,.................,,....,..,...,...,,.................E........X-------
---X.....,,.....A...,..,...X...,,....X-X.....,.,...............,....A........,,,,.......,,,....,.,...........................AX-------
---X...,,,........,,..EH......,.....X--X......,,...............,.........,,,,.............,.....,.............................X-------
---X......,,,,...,......,...,,......X-X........,......A........,.....,,,,.....................................................X-------
---X..........,,,.......,.,,.......X--X...,,...................,.,,,,....E....................................................X-------
---X.H...................,.........X-X....,.,,,,..........A....,,.............................................................X-------
--X............................B..X-X....,......,,,.....................,,,,,,,,,.........,,,,,,............................A.X-------
--X.....,,,,,................B.B.X--X....,.E...E...,,,,,......,,,,,,,,,,........,........,......,,............................X-------
--X.....,....,,,,,,,,,...........X-X....,,,.............,,,...,..........E.....E,......,,.........,,......................E...X-------
--X....,.....A........,,,,,.....X--X.......,,,,...........,...,...H..............,....,........E....,.........................X-------
--X....,...........E......,.....X-X.......A....,,,...E.....,..,.E..........XXXX..,....,..E..........,..........:..............X-------
--X.:..,.........E........,....X--X............W.,.......,.,..,......,,,...X--X..,...,..............,....................E....X-------
-X.....,..,,,,,,..,,,,,,,..,...X-X.:.............,......,,..,.,..,,,,..,...X---X.,...,...............,......................WX--------
-X....,...,....,..,.....,..,...X-X...............,.....,..,.,.,,,.......,.AX---X..,.,.............E..,.......................X--------
-X....,...,....,..,..E..,..,....XX.....:.....E...,....,...,..,..........,...X---X.,.,...E...H........,.......................X--------
-X....,...,.H..,..,....H,..,....XX..............A,.....,...,.,....E......,..X---X.,..,...............,.......................X--------
-X....,..,.....,..,.....,..,....X-X.............,,......,..,..,..........,..EXXXE.,..,..............,......................W.X--------
-X...,...,...E.,.,......,.E,....X-X.......E...,,...,..E..,,...,.........A.,........,.,..........E...,........H.....H..H.E....X--------
-X...,...,.....,.,...H..,...,...X-X.........,,....,.,........,......A.....,.....,,,,..,..H..E......,.H....E.....H........XXXXX--------
-X...,...,.....,.,......,...,...X-X.......,,....,,...,....E.,..............,,,,,......,,..........,,.....A......XXXXXXXXX-------------
-X..,....,.....,,,...E...,..,....XX.....,,.....,...A..,...,,........A...................,,.....,,,....XXXXXXXXXX----------------------
-X..,....,..H....,.H....H,..,....XX...,,...E..,........,.,.............A.......E......:...,,,,,.XXXXXX--------------------------------
-X..,....,...............,..,....X-X...,.....,..........,...................A.........XXXXXXXXXX--------------------------------------
X...,....,.....H.........,..,....X-X...,...,,....................A..:.XXX,,,,,,,XXXXXX------XXX---------------------------------------
X..,..H.,.............H..,...,...X-X...E,.,.......E..............XXXXX--X......EX-----------XEX---------------------------------------
X..,,...,..........H....:,...,...X-X.....,..................XXXXX--------XE.....X-----------X.X---------------------------------------
X....,,.,..H.............,..,,..E.X-B..................XXXXX-------------X....E.X-----------XtX---------------------------------------
X......,,....E..H.....:..,,,......X--XX..........XXXXXX-------------------X:..XXX-----------XHX---------------------------------------
X.B..B........................XXXXX----X...XXXXXX-------------------------XXXX--XAXXXXX-----X.X---------------------------------------
X.....................XXXXXXXX----------XXX-------------------------------------X......XXXXXX,X---------------------------------------
X........XXXXXXXXXXXXX----------------------------------------------------------X.........:...XXXX------------------------------------
XXXXXXXXX-----------------------------------------------------------------------X.................XXXXXX------------------------------
-------------------------------------------------------------------------------X........................XXXXXX------------------------
-----------------------------------------------------------------XXXXXXX-------X.:..T.........................XXXXXX------------------
-----------------------------------------------------------------XH.A.HX-------X,...................................XXXX--------------
-----------------------------------------------------------------XA.....XXX----X.,,..................................W.X--------------
-----------------------------------------------------------------X...E.....XXXXX..,...............XXXXXXX.....A........X--------------
-----------------------------------------------------------------X.A.........,,,...,..............X------XXXXXXX......AX--------------
-----------------------------------------------------------------X.....E...E.,,,...,,............AX------------X.......X--------------
-----------------------------------------------------------------XH.AK......,,,.....:,............X-------------X...:..X--------------
-----------------------------------------------------------------XXXXXXXXXXXXXX....,,.............XXXXXXX--XXX--X......X--------------
------------------------------------------------------------------------------X...,....................HX--XHX--X......X--------------
------------------------------------------------------------------------------X,,.,......................XXX.X--X....E.X--------------
------------------------------------------------------------------------------X..,.................XXX......EX---X.....X--------------
------------------------------------------------------------------------------X:.................XX---XXXX...XXXXX..E..X--------------
-----------------------------------------------------------------------------X..................XXX-------XXXX........BX--------------
-----------------------------------------------------------------------------X.....................XXXX-------XX.......X--------------
-----------------------------------------------------------------------------X......:.....,,,......:.XXXX------X......BX--------------
-----------------------------------------------------------------------------X........,,,,...,...XXXX----------X.......X--------------
----------------------------------------------------------------------------X......,,,.......,...X------XX------XH.....X--------------
----------------------------------------------------------------------------X......,..........,..X----XX.X------X......X--------------
----------------------------------------------------------------------------X.....,....,,......,..X-XX..E.X---XXX.....AX--------------
----------------------------------------------------------------------------X.....,.,,,..,,....,..XX......XXXX....E....X--------------
----------------------------------------------------------------------------X....,..,......,....,.............XXX.....AX--------------
----------------------------------------------------------------------------X....,..,.H....A,...,.......XXXXXX--X......X--------------
----------------------------------------------------------------------------X...,..,........,...,...XXXX------XXX......X--------------
---------------------------------------------------------------------------X....,..,..B..E..,...,...X---XXXXXX.........X--------------
---------------------------------------------------------------------------X.....,..,,....,,...,....XXXX........A..E...X--------------
---------------------------------------------------------------------------X......,...,.,,.....,..........XXXX.........X--------------
---------------------------------------------------------------------------X.......,..,..,....,,.....XXX.X----XXX......X--------------
---------------------------------------------------------------------------X........,,...,..,,....XXX-X-X-XXXXXXX....H.X--------------
---------------------------------------------------------------------------X:........,....,,......X-XX--XX....E+X......X--------------
---------------------------------------------------------------------------X...................E.X-XX--X-X.H.XX+X......X--------------
---------------------------------------------------------------------------X..........XXXXXX.....X---XX-X.XXX--X.......X--------------
---------------------------------------------------------------------------X........XX------X...X---XXXX..X---X........X--------------
---------------------------------------------------------------------------X......XX---------X..XXXX......XXXX.........X--------------
--------------------------------------------------------------------------X......X-----------X...E..,,,................X--------------
--------------------------------------------------------------------------X......X------------X....,...,,,,,.E.........X--------------
--------------------------------------------------------------------------X......X-------------X..,.........,,,........X--------------
--------------------------------------------------------------------------X......X-------------X..,...,,,,.....,:..E...X--------------
--------------------------------------------------------------------------XA....X--------------X..,...,H..,,,..,.......X--------------
--------------------------------------------------------------------------X.....X--------------X..,...,..E..,...,......X--------------
--------------------------------------------------------------------------X.....X--------------X..,....,...H.,..,......X--------------
-------------------------------------------------------------------------X......X--------------X..,.....,B..,..,.......X--------------
-------------------------------------------------------------------------X.......XX----------XX....,..,,..,,.E.,.......X--------------
-------------------------------------------------------------------------X.........XX------XX.A.....,,...,....,........X--------------
-------------------------------------------------------------------------X.......E...XXXXXX.............E.,,,,,.....:..X--------------
------------------------------------------------------------------------X..........E......H............................X--------------
------------------------------------------------------------------------X..............H........E.....XXXXX...........HX--------------
------------------------------------------------------------------------X.............H.H..HH.......XX-----XXXX........X--------------
------------------------------------------------------------------------X...............H......E..XX-----------X.......X--------------
------------------------------------------------------------------------X.............E..H..H.....X------------X......:X--------------
-----------------------------------------------------------------------X.:........................X-------------X......X--------------
-----------------------------------------------------------------------X..........................X-------------X......X--------------
-----------------------------------------------------------------------X...E.......E..............X-------------X......X--------------
-----------------------------------------------------------------------X....................:.....X------------X.......X--------------
----------------------------------------------------------------------X..:......................E..XX----------X......X---------------
----------------------------------------------------------------------X..................E...........X-----XXXXX....E.X---------------
----------------------------------------------------------------------XXXXX...........................XXXXX...........X---------------
---------------------------------------------------------------------------XXXXXXXX..........:......E.................X---------------
-----------------------------------------------------------------------------------XXXXXXX.......................E..W.X---------------
------------------------------------------------------------------------------------------XXXXXXX............A........X---------------
-------------------------------------------------------------------------------------------------XXXXXXX..............X---------------
--------------------------------------------------------------------------------------------------------XXXX+XXXXX...HX---------------
-----------------------------------------------------------------------XXXXXXXXXXXXXXXXXXXXXXXXXXXXXXXXXXXXX+XXX--XXXXX---------------
-----------------------------------------------------------------------X..+A....H..........:...................X---XXX----------------
-------------------------------------------------------------------XXXXX..+........E...E......................AXXXX..X----------------
------------------------------------------------------------------->E.,L..+....E..............E...........E....,,E...X----------------
-------------------------------------------------------------------XXXXX..+....................................,,...EX----------------
-----------------------------------------------------------------------XA.+..:......E....E.........H..........:XXXX..X----------------
-----------------------------------------------------------------------XXXXXXXXXXXXXXXXXXXXXXXXXXXXXXXXXXXXXXXXX---XXX----------------
