-------------------X:XXXXAXX-------
-------------------XXXEEXA.X-------
-------------------XX---X..X-------
-------------------XX---XA.X-------
---XXXXXX----------XX---XA.X-------
--X..,,W.XX--------XX---X..X-------
-X...+,+...X--->W>-XX--XXX,XX------
X....+++...XXXXX,XXXX-X,.,.,.X-----
X...........X..,E,..XX,.XXX.,X-----
X..........:X...E...XX.X-:XX:.X----
X.....E.....X...:...XX,XX..XX,X----
X...........L.......++.XX:WXXEX----
XXXXX,B,XXXXX...H...XXXX-XXXX,X----
----XAE,W---X...B...XXXXXXXX..X----
----XEWEX---X:......XXAAXXA,XX-----
----XXXXX---XXX+++XXXXA:XX.X-------
------------XXX+++XXXX,,XX.XEH-----
------------X.H....HXX.:.,.,.X-----
------------X.......XX...,..,XXXXX-
------------X.......XX....,,.,...X-
------------XH..:..HXX......,,...X-
------------X...<...XX.......XXXXX-
------------X..<..<.XX..E....X-----
------------X.H.<..HXX....E.HH-----
------------X.......XX......HH-----
------------XXXX+XXXXXXXXXXXXW-----
------------XXXX+XXXX-------XK-----
------------XA.....HX--------------
------------X...E...X--------------
------------X...:.W.X--------------
------------X:..H..:X--------------
------------XXXXXXXXX--------------
