---------------------------------------------------------------------------------------------------------X----------------------------------------------------
--------------------------------------------------------------------------------------------------------X.X---------------------------------------------------
-------------------------------------------------------------------------------------------------------,X.EX--------------------------------------------------
-----------------------------XXX-----------------------------------------------------------------------X,,..X-------------------------------------------------
-----------------------------X,X----------------------------------------------------------------------X.t,,X--------------------------------------------------
-----------------------------X,X---------------------------------------------------------------X------X..t,X--------------------------------------------------
-----------------------------X,X--------------------------------------------------------------XX-------XX.X---------------------------------------------------
-----------------------------X,X-------------------------------------------------------------XXEXXXXXXXXXXXXXXXXXXXXXXXXXXXX----------------------------------
-----------------------------X,X---------------------------------------------------------------X,,+,...XX:,,:X:,,:X:,,:X:,,:X---------------------------------
-----------------------------X,X---------------------------------------------------------------X,W+,...,,...,,...,,...,,...,XX--------------------------------
-----------------------------X,X---------------------------------------------------------------X+++,...,,,,,,,,,,,,,,,,,...,,X--------------------------------
-----------------------------X,X---------------------------------------------------------------X,,,,...,,,,,,,,,,,,,,,,,..<,,X--------------------------------
-----------------------------X,X--------------------------------------XXXXXXXXXXXXXXXXXXXXXXX--X.......,,,,,,,,,,,,,,,,,...,,X--------------------------------
-----------------------------X,X-----------------------------------XXXX:,,:X:,,:X:,,:X...,,,X--X.......,,...,,...,,...,,...,XX--------------------------------
-----------------------------X,X-----------------------------------X:,,...,,...,,...,,...,,,AX-X......,XX,,,XX,,,XX,,,XX,,,XX---------------------------------
-----------------------------X,X-----------------------------------X.,,,,,,,,,,,T,,,,,...,,++X-XX,,,,,X:X:XX:X:XX:X:XX:X:XX:----------------------------------
-----------------------------X,X-----------------------------------XK,,,,,,,,,,,,,,,,,...,,,,X-XX,,,,,XX------------------------------------------------------
----------------------XXXXXXXX,XXXXXXXX----------------------------X.,,,,,,,,,,,,,,,,,.......X-X:.,,,.,:------------------------------------------------------
---------------------XA,.....,,......AX----------------------------X.,,...,,...,,...,,.......X-X,.,,,.,X------------------------------------------------------
---------------------X,..T...,,.......X----------------------------X:XX,,,XX,,,XX,,,XX,......X-X,.,,,.,X------------------------------------------------------
---------------------X..,,,,,,,,,,,,..X-------------------------------X...XX:XX:X:XX:X:,,,,,XX-X:,,,,,X:------------------------------------------------------
---------------------X..,,,,,,,,,,,,..X-------------------------------X...X----------XX,,,,,XX-XX,,,,,XX------------------------------------------------------
---------------------X..,,.........,..X---------XXXXXXXXXXXXXXXXXXXXXXX...XXXXXX-----X:.,,,.,:-X:.,,,.,:------------------------------------------------------
XXXXXXXXXXXXXXXXXX---X..XX,,,,,,,,,X..XXXXX----X,,,...XX:,,:X:,,:X:,,:X,,,XX:,,:X----X,.,,,.,X-X,.,,,.,X------------------------------------------------------
XEE.EE,,,E.EE..,tX---X..,,.........,.:+,,,X---X,A,,...,,...,,...,,...,,.E.,,...,X----X,.,,,.,X-X,.,,,.,X------------------------------------------------------
XE.E.E,,,E.E..E,tXXXXX..,,.........,..+,K,X---X,,,,...,,,,,,,,,,,,,,,,,,,,,,,,,,X----X:,,,,,X:-X:,,,,,X:------------------------------------------------------
X.....,,,......,tXXE,,..XX,,,,,,,,,X..+,,,X---X,,,,...,,,,,,,,,,,,,,,,,,,,,,,,,,X----XX,,E,,XX-XX,,,,,XX------------------------------------------------------
XEE.EE,,,E.EE..,tXX,XX..XX,,,,,,,,,X..XXXXX---X.......,,,,,,,,,,,,,,,,,,,,,,,,,,X----X:.,,,.,:-X:.,,,.,:------------------------------------------------------
XXXXXXXXXXXXXXXXXXX,XX,,,,.........,,,X-------X.......,,...,,...,,...,,...,,...,X----X,.,,,.,X-X,.,,,.,X------------------------------------------------------
------------------X,XX,,,,.........,,,X-------X......,XX,,,XX,,,XX,,,XX,,,XX,,,XX----X,.,,,.,X-X,.,,,.,X------------------------------------------------------
------------------X,XX................X-------XX,,,,,X:X:XX:X:XX:X:XX:X:XX:X:XX:-----X:,,,,,X:-X:,,,,,X:------------------------------------------------------
------------------X,XX................X-------XX,,,,,XX----------X-------------------XX,,,,,XXXXX,,,,,XX------------------------------------------------------
------------------X,XXXXXX,XXXXXXXXXXXX-------X:.,,,.,:---------X.X----XXX-----------X:.,,,.,,..,.....,:------------------------------------------------------
------------------X,X---XX,XXXXXXXXX----------X,.,,,.,X--------XE..XXXX...XXXXXXXXXXXX,.,,,.,,..,.....,X------------------------------------------------------
-----------------XX,XXXXX...........X---------X,.,,,.,X------XXE..EXXH,.E.,..,......HX,.,,,.,,..,.....,X------------------------------------------------------
-----------------X..,.,.,,,,,..,,,,,X---------X:,,,,,X:-----X.E..EX-XXX...XXXX.,,,,,,X:,,,,,XXXXX,,,,,X:------------------------------------------------------
-----------------X..,,,.,,,,,..,,,,,XX--------XX,,,,,XX----X,..E.X-----XTX---X.,:,,,,XX,,,,,X---X,,,,,X-------------------------------------------------------
-----------------X......,,A,,.T,,A,,::X-------X:.,,,.,:---X..,,..X-----X+X---X.,,,,,,XX..:..X---X..H..X-------------------------------------------------------
-----------------X.,,,..,,,,,..,,,,,:XX-------X,.,,,.,X----X.t,,XXXXXXXX+XX--X.,,,E,,XX:XXXX:---X:XXXX:-------------------------------------------------------
-----------------XH,.,..,,,,,..,,,,,X---------X,.,,,.,X-----XXtXX,AAAXX...X--X.,,,,,,X------------------------------------------------------------------------
-----------------XXXXXXXX...........X---------X:,,,,,X:-----XXXX.E,,,LL...X--X.,,,,,,X------------------------------------------------------------------------
------------------------XXXXX,,,XXXXX---------XX,,E,,XX-----XX:.,,,,.XX,,XX--X.,...ttX------------------------------------------------------------------------
----------------------------X+++X-------------X:.,,,.,:-----XX.....E.XX,,XX--X.,...t.X------------------------------------------------------------------------
----------------------------X,,,X-------------X,.,,,.,X-----XX.......,,.H.X--XXXXXXXXX------------------------------------------------------------------------
----------------------------XE,EX-------------X,.,,,.,X-----XX.......XX.A.X-----------------------------------------------------------------------------------
----------------------------X,,,X-------------X:,,,,,X:-----XX...XX,XXX,,XX-----------------------------------------------------------------------------------
----------------------------X,,,X--------------XX,,,XX------XX+++XXXX-X..X------------------------------------------------------------------------------------
--------------------------XXX,,,XXXXXXXXXXXXXXXXX,,,XXXXXXXXXX+++XXXXXX,,XX---XXXXXXXXXXXXX-------------------------------------------------------------------
--------------------------X.......X:..,,........,,,,,......HXX...XX.......X---X.,,,,,,,,>TX-------------------------------------------------------------------
--------------------------X.......,...,,...T....,,,,,.......,,...,,.......X---X,.........>X-------------------------------------------------------------------
--------------------------X.......,...,,........+,,,,.......,,...,,.......X---X,..,,,..,,,X-------------------------------------------------------------------
--------------------------X.......,...,,........+++++.......,,...,,.......X---X,.,XX,XXX,XX-------------------------------------------------------------------
--------------------------X.....E.,...,,,,..................,,...,,E......X---X,.,XXXX-XXX--------------------------------------------------------------------
--------------------------X.......,...,,.,.,,,.........,,,..,,...,,.......XXX-X,.,X---------------------------------------------------------------------------
--------------------------X.......,...,,.,.,.,.........,.,,,,,...,,.......,,X-X,..X---------------------------------------------------------------------------
---------------------XXXXXX.......,...,,.,.,.,..E......,,,,,,,...,,.......,EX-X,..X---------------------------------------------------------------------------
---------------------H...,,.....E.,...,,,,.,.,......E.......,,...,,E......,.X-X,,,X---------------------------------------------------------------------------
---------------------XE.E,,.......,...,,.,.,,,..............,,...,,.......XXX-XXXXX---------------------------------------------------------------------------
---------------------X...,,.......,...,,,,,,.........,,,,,..,,...,,.......X-----------------------------------------------------------------------------------
---------------------XEHE,,.......,...,,...,.........,...,,,,,...,,.......X-----------------------------------------------------------------------------------
---------------------X...,,.....E.,...,,,,,,..,,,....,,,,,,.,,...,,E......X-----------------------------------------------------------------------------------
---------------------X...,,.......,...,,,,.,,.,.,,,,,,..,,,,,,...,,.......X-----------------------------------------------------------------------------------
---------------------XE.E,,.......,...,,.,.,,.,,,,...,E.,...,,...,,.......XXX---------------------------------------------------------------------------------
---------------------HXXXXX.......,...,,,,,,,,,,,,,,,,AA,,,,,,...,,.......,.X---------------------------------------------------------------------------------
--------------------------X.....E.,...,,,X,XX,X,XX,X,XX,X,XX,,...,,E......,EX---------------------------------------------------------------------------------
--------------------------X.......,......X.XX.X.XX.X.XX.X.XX.....,,.......,,X---------------------------------------------------------------------------------
--------------------------X.......,......,.,,.,.,,.,.,,.,.,,.....,,.......XXX---------------------------------------------------------------------------------
--------------------------X.......,......,.,,.,.,,.,.,,.,.,,.....,,.......X-----------------------------------------------------------------------------------
--------------------------X.......X:,,,,,X,XX,X,XX,X,XX,X,XX,,,,,:X.......X-----------------------------------------------------------------------------------
--------------------------X.......X,,,,,,X,XX,X,XX,X,XX,X,XX,,,,,X........X-----------------------------------------------------------------------------------
--------------------------X..........E...,E,,.,E,,.,E,,.,E,,..E...........X-----------------------------------------------------------------------------------
--------------------------H..............,.,,.,.,,.,.,,.,.,,.............HX-----------------------------------------------------------------------------------
--------------------------XXXXX..........,.,,.,.,,.,.,,.,.,,..........XXXXX-----------------------------------------------------------------------------------
-------------------------------X.........,.,,.,.,,.,.,,.,.,,........XX----------------------------------------------------------------------------------------
-------------------------------X.........,.,,.,.,,.,.,,.,.,,........X-----------------------------------------------------------------------------------------
-------------------------------X.........,.,,.,.,,.,.,,.,.,,........X-----------------------------------------------------------------------------------------
-------------------------------X.........,.,,.,.,,.,.,,.,.,,........X-----------------------------------------------------------------------------------------
-------------------------------XHXXXXXXXXXXXXXXXXXXXXXXXXXXXXXXXXXXXH-----------------------------------------------------------------------------------------
--------------------------------------------------------------------------------------------------------------------------------------------------------------
--------------------------------------------------------------------------------------------------------------------------------------------------------------
--------------------------------------------------------------------------------------------------------------------------------------------------------------
--------------------------------------------------------------------------------------------------------------------------------------------------------------
--------------------------------------------------------------------------------------------------------------------------------------------------------------
--------------------------------------------------------------------------------------------------------------------------------------------------------------
--------------------------------------------------------------------------------------------------------------------------------------------------------------
--------------------------------------------------------------------------------------------------------------------------------------------------------------
--------------------------------------------------------------------------------------------------------------------------------------------------------------
--------------------------------------------------------------------------------------------------------------------------------------------------------------
--------------------------------------------------------------------------------------------------------------------------------------------------------------
--------------------------------------------------------------------------------------------------------------------------------------------------------------
--------------------------------------------------------------------------------------------------------------------------------------------------------------
--------------------------------------------------------------------------------------------------------------------------------------------------------------
--------------------------------------------------------------------------------------------------------------------------------------------------------------
--------------------------------------------------------------------------------------------------------------------------------------------------------------
--------------------------------------------------------------------------------------------------------------------------------------------------------------
--------------------------------------------------------------------------------------------------------------------------------------------------------------
--------------------------------------------------------------------------------------------------------------------------------------------------------------
--------------------------------------------------------------------------------------------------------------------------------------------------------------
--------------------------------------------------------------------------------------------------------------------------------------------------------------
--------------------------------------------------------------------------------------------------------------------------------------------------------------
--------------------------------------------------------------------------------------------------------------------------------------------------------------
--------------------------------------------------------------------------------------------------------------------------------------------------------------
--------------------------------------------------------------------------------------------------------------------------------------------------------------
--------------------------------------------------------------------------------------------------------------------------------------------------------------
--------------------------------------------------------------------------------------------------------------------------------------------------------------
--------------------------------------------------------------------------------------------------------------------------------------------------------------
--------------------------------------------------------------------------------------------------------------------------------------------------------------
--------------------------------------------------------------------------------------------------------------------------------------------------------------
--------------------------------------------------------------------------------------------------------------------------------------------------------------
--------------------------------------------------------------------------------------------------------------------------------------------------------------
--------------------------------------------------------------------------------------------------------------------------------------------------------------
--------------------------------------------------------------------------------------------------------------------------------------------------------------
--------------------------------------------------------------------------------------------------------------------------------------------------------------
--------------------------------------------------------------------------------------------------------------------------------------------------------------
--------------------------------------------------------------------------------------------------------------------------------------------------------------
------------------------------------------------------------------------------------------------------------------------------------------------------------XX
------------------------------------------------------------------------------------------------------------------------------------------------------------XX
