--------------X:X-X:X---X:X-X:X----------
--------------X.X-X.X---X.X-X.X----------
--------------X:X-X:X---X:X-X:X----------
--------------X.X-X.X---X.X-X:X----------
--------------X:X-X:X---X:X-X.X----------
--------------XtX-XtX---XtX-XtX----------
--------------X,X-X,X---X,X-X,X----------
--------------X,X-X,X---X,X-X,X----------
------------XXX,XXX,XXXXX,XXX,XXX--------
------------XT....++++A++++...,TX--------
XXX-XXXX:XXXX.....+.......+.....XXXXXX:XX
XAX-X::..t,,,..,,,+++++++++,,,..,,,t:..:X
X.X-XXXXXXXXX..,.,.,.,.,.,.,.,..XXXXXXXXX
XAX---------X..,.,.,.,.,.,.,.,..X--------
X.X---------X..,.,H,.,.,.,.,.,..X--------
XAX-XXXXXXXXX..,.,.,.,.,.,.,.,..X--------
XAX-X::.:t,,,..,.,.,.,.,.,.,.,..XXXXXXXXX
X.X-XXXXXXXXX..,.,.,.,.,.,.,.,..,,,t:.::X
XAX---------X..,.,.,.,.,.,.,.,..XXXXXXXXX
X.X---------X..,.,.,.,.,.,.,.,..X--------
XAXXXXXXXXXXX..,,,,,,,,,,,,,,,..XX-------
X.,........,.....,T..,T..,T.....,X-------
XAXXXXXXXXXXX..,,,.,,,.,,,,,,,..XX-------
X.X---------X..,.,.,.,.,.,.,.,..X--------
XAX-XX:XXXXXX..,.,.,.,.,.,.,.,..XXXXXXXXX
XAX-X:..:t,,,..,.,.,.,.,.,.,.,..,,,t::.:X
X.X-XXXXXXXXX..,.,.,.,.,.,.,.,..XXXXXXXXX
XAX---------X..,.,.,.,.,.,.,.,..X--------
X.X---------X..,.,.,.,.,.,.,.,..X--------
XWX-X::XXXXXX..,.,.,.,.,.,.,.,..XXXXXXXXX
X.X-X...:t,,,..,,,.,,,.,,,,,,,..,,,t:.::X
XXX-XXXXXXXXX,....:...........,,XXXXXXXXX
------------XT................,TX--------
------------XXXXXX,XXXXXXXXXXXXXX--------
----------------X,.X---------------------
----------------X,X----------------------
---------------X,.X----------------------
---------------X,X-----------------------
---------------X,X-----------------------
---------------X,X-----------------------
------------XXXX,XXXXXXXXXX--------------
------------X...........T,X--------------
------------X...........,,X--------------
------------X.............X--------------
------------X.....,,,...,,X--------------
------------X.....,.,H..,.X--------------
------------X.<...,.,...,.X--------------
------------X.....,.,...,.X--------------
-----------XX<....,.,H..,.X--------------
-----------X,.....,.,...,.X--------------
-----------X,<....,:,,,.,.X--------------
-----------X,.....,...,.,.X--------------
-----------XX<....,,,,,.,.X--------------
------------X...........,.X--------------
------------X...........,.X--------------
------------X...........,.X--------------
------------X.........:.,.X--------------
------------X...........,.X--------------
------------X.......,,,,,.X--------------
------------X.......,.....X--------------
------------XXX,XXXXXXXXXXX--------------
------------XXX,XXXXXXXXXXXXXXXXXXXXXXX--
------------X.......................,TX--
------------X.,,,,,,,,A,,.,,,,,,,,,,,.X--
------------X.,..H......,.,.......A.,.X--
------------X.,,,,,,,,,,,,,,,,,,,,,,,:X--
------------X...........,T.........,,.X--
------------X.,,,,,,,,,,,.,,A,,,,,,,,.X--
------------X.,A........,.,.........,.X--
------------X.,,,,,,,,,,,,,,,,,,,,,,,.X--
------------X......H....,T............X--
------------X.,,,,,,,,,,,.,,,,,,,,,,,.X--
------------X.,......A..,.,.......A.,.X--
------------X.,,,,,,,,,,,.,,,,,,,,,,,.X--
------------X..................H......X--
------------X.,,,,,,,,,,,,,,,,,,,,H,,.X--
------------X.,.A....H..,.,..A......,.X--
------------X.,,,,,,,,,,,,,,,,,,,,,,,.X--
------------X.........................X--
------------X.........................X--
------------X,,,,,,,..,,,,,,,..,,H,,,,X--
------------X,,,:,H,..,,H:,,,:.,,,:,,,X--
------------X,,,,,,,..,,,,,,,..,,,,,,,+--
------------XT,.......................X--
------------XXXXXXXXXX,XXXXXXXXXXXXXXXX--
---------------------X>>-----------------
