--------XXXXXXXXXXXXXXXXXXXXXXXXX--
--------X....,,,,,.....,,,,,....X--
--------X.,,,...............,,,.X--
--------X.,....,,,,,,,,,,.....,.X--
XXXXX---X.,....,........,.....,.X--
X,--X---X.,....,........,.....,.X--
X,,-X---X,.....,........,......,X--
X---X---X,.....,........,......,X--
X---X---X,.....,....E...,......,X--
X,--X---X,.....,........,......,X--
X,,-X---X,.....,........,......,X--
X---X---X,.....,........,......,X--
XXXXX---X,.....,,,,,,,,,,......,X--
--------X,.....................,X--
--------X.......................X--
--------X.......................X--
--------X.......................X--
--------XXXXXXX,,,,,,,,,,,XXXXXXX--
--XXX---XXXXXXX,,,,,,,,,,,XXXXXXX--
--------X:,.........+........,.:X--
--------X,,.........+.........,,X--
--------X..,,,,,,...+..,,,,,,...XXX
--XXXXXXX.<,,,,,,...+..,,,,,,...XXX
-X>,,.,,...,,...,...+..,,...,....,+
X>.>,.,,..<<,...,...+..,,...,....,+
-X>,..,,...,,...,...+..,,...,....,+
--XXXXXXX.<,,,,,,...+..,,,,,,...XXX
--------X,..........+..........,X--
--------X.,.........+.........,.X--
--------X:,.........+........,.:X--
--------XXXXXXX,,,,,,,,,,,XXXXXXX--
--------X.......................X--
--------X.......................X--
--------X.......................X--
--------X.......................X--
--------X,.....,,,,,,,,,,......,X--
--------X,.....,........,......,X--
--------X,.....,........,......,X--
--------X,.....,........,......,X--
--------X,.....,........,......,X--
--------X,.....,....E...,......,X--
--------X,.....,........,......,X--
--------X,.....,........,......,X--
--------X.,....,........,.....,.X--
--------X.,....,,,,,,,,,,.....,.X--
--------X.,...................,.X--
--------X.,,,...............,,,.X--
--------X....,,,,,.....,,,,,....X--
--------XXXXXXXXXXXXXXXXXXXXXXXXX--
