--------------------------------XXX
--------------------------------X>X
--------------------------------X.X
--------------------------------X,X
XXXXXXXXXXX-----XXXXXXXXXXX-----X,X
X.HHHHHHH.X-----X.HHHHHHH.X-----X<X
X,XXXXXXX,X-----X,XXXXXXX,X-----X.X
X.X-----X.X-----X.X-----X.X-----X<X
X.X-----X.X-----X.X-----X.X-----X.X
X.X-----X.X-----X.X-----X.X-----X<X
X.X-----X.X-----X.X-----X.X-----X.X
X.X-----X.X-----X.X-----X.X-----X<X
X.X-----X.X-----X.X-----X.X-----X.X
X.X-----X.X-----X.X-----X.X-----X.X
X,X-----X,X-----X,X-----X,X-----X,X
X,X-----X,X-----X,X-----X,X-----X,X
X,X-----X,X-----X,X-----X,X-----X,X
X,X-----X,X-----X,X-----X,X-----X,X
X,X-----X,X-----X,X-----X,X-----X,X
X,X-----X,X-----X,X-----X,X-----X,X
X,X-----X,X-----X,X-----X,X-----X,X
X,X-----X,X-----X,X-----X,X-----X,X
X,XXXXXXX,XXXXXXX,XXXXXXX,XXXXXXX,X
X.,.,E,.,.,.,E,.,.,.,E,.,.,.,E,.,.X
X.,.,.,.,.,.,.,.,.,.,.,.,.,.,.,.,.X
X.,.,E,.,.,.,E,.,.,.,E,.,.,.,E,.,.X
X,XXXXXXX,XXXXXXX,XXXXXXX,XXXXXXX,X
X,X-----X,X-----X,X-----X,X-----X,X
X,X-----X,X-----X,X-----X,X-----X,X
X,X-----X,X-----X,X-----X,X-----X,X
X,X-----X,X-----X,X-----X,X-----X,X
X,X-----X,X-----X,X-----X,X-----X,X
X,X-----X,X-----X,X-----X,X-----X,X
X,X-----X,X-----X,X-----X,X-----X,X
X,X-----X,X-----X,X-----X,X-----X,X
X.X-----X.X-----X.X-----X.X-----X.X
X.X-----X.X-----X.X-----X.X-----X.X
X.X-----X.X-----X.X-----X.X-----X.X
X.X-----X.X-----X.X-----X.X-----X.X
X.X-----X.X-----X.X-----X.X-----X.X
X.X-----X.X-----X.X-----X.X-----X.X
X.X-----X.X-----X.X-----X.X-----X.X
X,X-----X,X-----X,X-----X,X-----X,X
X,X-----X,X-----X,X-----X,X-----X,X
X,X-----X,X-----X,X-----X,X-----X,X
X,X-----X,X-----X,X-----X,X-----X,X
X,X-----X,X-----X,X-----X,X-----X,X
X,X-----X,X-----X,X-----X,X-----X,X
X,X-----X,X-----X,X-----X,X-----X,X
X,X-----X,X-----X,X-----X,X-----X,X
X,XXXXXXX,XXXXXXX,XXXXXXX,XXXXXXX,X
X.,.,E,.,.,.,E,.,.,.,E,.,.,.,E,.,.X
X.,.,.,.,.,.,.,.,.,.,.,.,.,.,.,.,.X
X.,.,E,.,.,.,E,.,.,.,E,.,.,.,E,.,.X
X,XXXXXXX,XXXXXXX,XXXXXXX,XXXXXXX,X
X,X-----X,X-----X,X-----X,X-----X,X
X,X-----X,X-----X,X-----X,X-----X,X
X,X-----X,X-----X,X-----X,X-----X,X
X,X-----X,X-----X,X-----X,X-----X,X
X,X-----X,X-----X,X-----X,X-----X,X
X,X-----X,X-----X,X-----X,X-----X,X
X,X-----X,X-----X,X-----X,X-----X,X
X,X-----X,XXXXXXX,X-----X,XXXXXXX,X
XWX-----X.HHHHHHH.X-----X.HHHHHHH.X
X++-----XXXXXXXXXXX-----XXXXXXXXXXX
