--------------XXXXX-----------------------------------------------------------------------------------------------------------------
--------------XAA.X-----------------------------------------------------------------------------------------------------------------
--------------XAA.X-----------------------------------------------------------------------------------------------------------------
--------------XAA.X-----------------------------------------------------------------------------------------------------------------
--------------X...X-----------------------------------------------------------------------------------------------------------------
--------------X.H.X------------------------------------XXHXX------------------------------------------------------------------------
--------------X...XXXXXXXXXXXXXXXXXXXXXXXXXXXXXXXXXXXXXX,,,X------------------------------------------------------------------------
------------XX.......................................HXX,..X------------------------------------------------------------------------
-----------X..........................................XX,..X--XXXXXXXXXXXXXXXXXXXXXXXHXXXXXXXXXXXXXXXXXXXXXXXXXXXXXXXXXXXXXXXXXXX---
----------X......XXXXXXXXXXXXXXXXXXXXXXXXXXXXXXXXXXXX,XX,..X-XH.........................,,....AA.AAA.AAA.AA......AA.AAAA.AA.AAA.X---
--------XX.....XX-XXXXXXXXXXXXXXXXXXXXXXXXXXXXXXXXXXX,XX,..XX.............................,,....................................X---
-------X......X-XXH.....................+.,.,.,......HXX,..XX....A.........XXXXXXXXXXXXX....,,................................A.X---
-------X....XX-X........................+.,.,.,.......XX,..XX.XXX.........AXXXXXXXXXXXXXXX....,,,,,,,,,,,,,...................A.X---
-------X...X-XX.........................+.,.,.,.......XX...XX.X-XA.........XX.........A.XXXX...............,,...................X---
------X....XX.............,,,,,.........+.,.,.,.......XX,,,XX.X-X.........AXX.............X-XX...............,,...............A.X---
------X...X-X.............,...,.......XXXXXXXXXXXX....XX...XX.X-XA........AXX,,,,..........X--X.....XXXXX......,................X---
------X...X-X...,,,,,,,...,...,.......X----------X....XX...XX.X-XA.AAA.AA..XX,,,,HH.H.......X-X.....X-XXXXX.....,,............A.X---
------X...XX....,.....,...,...,.....A.X----------XX,,,XXX,,XX.X-X,,,,,XXXXAXX,,XXXXXX,,,XX...XX.....XX.A.XXX......,,............X---
------X..X-X....,.....,...,AAA,..H..AXXXXXXXXXXXXXX,,,XXX,,XX+XXX,,,,,XXXXXXX..XXXXXX,,,XXA...X,,,,,X......XX.......,.........A.X---
------X..X-X....,.....,.H.,..,,,...AXX...................................................XXXXXX,,,,,XXX......XX......,..........X---
-----X...X-X....,.....,H..,,,...XX.XX.....................................................XXXXX,,,,,XXX.......XX......,.......A.X---
-----X..X-X.....,.....,.,,.......XXX................................................................AXX.........X.....,.........X---
XXXXXX..X-X.....,...A.,,..........X.................................................................XXX...XX.....X.....,........X---
XAA.....X-X.....,.....,.............................................................................XXX...X-XX....X.....,.......X---
XAA.....X-X.....,..A.,..............................................................................XA....X---X....X.....,......X---
X.......X-X.....,..A.,..............................................................................XX....X----X...X.....,......X---
XAA.H...X-X.....,,,,,,,,,.............,,,............................................................XX....X----X...X.....,.....X---
X.......X-X.......H.,....,,,,,,,,.....,T,............................................................,X.....X---X....X.....,....X---
XXXXXX..X-X.........,............,,,,XXXXXXXXXXXXXXXXXXXXXXH...........H.............................,.X.....X---X....X....,....X---
-----X..X-X.......H.,................XXXXXXXXXXXXXXXXXXXXXXXXXXXXXXXXXXXX............................,..X.....XX--X...XX....,...X---
-----X..X-X.........,...............,,A.AA.AA.AAAAAAAA....XXXXXXXXXXXX--X............................,...,......X--X...X....,...X---
-----X..X-X.........,...............,,....................,,,,,,,,,...XXX............................,....,,.....X--X..XX...,...X---
-----X..X-X..XX..,,,,..............,,.....................,,,,,,,,,....XX............................,......,.....X-X...X....,..X---
-----X..X-X..XX..,.A.,.............,,.....................XXXXXXXXX.....X................AA.,,,,,,,..,.......,.....X-X..X....,..X---
-----X..X-X..XX..,..A,X............,,..........................WWXX.....X...............A.,,,,,,,,,,,,........X...H.X-X.X....,H.X---
-----X..X-X..XX..,...AX............,,..................XXXXXXXXXXXX.....XAAAX,,,,,XXAAAXX,,,.......,,X.........X....X-X.X.....,.X---
-----X..X-X..XX..,....X............,,...........XXX....XXWXXXXXXBBX,,,,,BBBXX,,,,,BBBXXXXH...........X,,........X...XXX,X...A.XXX---
-----X..X-X..XX..,,XXXX............,,...........X-X....XX.......,.......................XH...........XT,........X...A...X......X----
-----X..X-X..XX...AXXXX............A,.......ttt.X-X.:..XX.......,,,,,,,,,,,,,,,,,,,,,,,,XH..........AX,,........X.......X...X+++X---
-----X..X-X..XX...AXX...............A,......t.t.X-X....,,...............................XH..........AX..........X.......X...X....X--
-----X..X-X..XX....XX...............A,HHHHH.ttt.X-XW.,,.,...............................XH..........AX..........X.......X+++X.....X-
-----X..X-X..XX...XXX................AXXXXXXXXXXX-X,,.,,................................XH...........X..........X.......X...X......X
-----X..X-X..XX...X-X................AXXXXXXXXXXXXX,,,..................................X.ttt.......AX..........X.......X,,,X..X...X
-----X..X-X..XX...X-X................AX.,...............................................X.t.t.......AX..........X.......X...X..X...X
-----X..X-X..XX...X-X................XX.,...............................................X.ttt........X..........XA......X,,,X..X...X
-----X..X-X..XXAA.X-X................XB.,...............................................X...........AX..........X.......X...X..X...X
-----X..X-X..XX.A.X-X................XB.,.........................:,,,,:................XXXXXXX.....AX..........XA......X,,,X..X...X
-----X..X-X..XXA..X-X................XB.,................,,,,,.....,,,,,................X-----X.....AX..........X.......X...X..X...X
-----X..X-X..XX...X-X................XX.,...............,,,,,,.....,,,,,................XXXXXXX.....AX..........X,,,,...X,,,X..X...X
-----X..X-X..XXAA.X-X................,,.,..............XX.....X....,,,,,................,W..........AX..........,.,.,...X...X..X...X
-----X..X-X..XXAA.X-X................,,.,..............HX.XAX.X.,,,,,,,,................,..:........AX..........,.,.,...X...X..X...X
-----X..X-X..XX...X-X................,,.,..............HX.XXX.X.,T,,,,,,................,,..........AX..........,.,.,...,...X..X...X
-----X..X-X..XXXXXXXX................,,.,..............HX,XXX,X.,,,,,,,,.................,..........AX..........,.,.,...,...X..X...X
-----X..X-X..H.HHHHXX................,,.,..............H,.XX..,,,,:,,,,:,HHHHHHHXX.......,,,XXX.....AX..........,.,.,...,..HX..X...X
-----X..X-X..,,,,,,XX................XX.,..............H,.XX..,,,,,,,,,,,,,,,,XXXX.....,,,,,XXX......X..........XXXXXXXXXXXXX..X...X
-----X..X-X..,,.,,.+,...............AXB.,..............H,.XX..................,...,,,,,......WX......X..........X...........X..X...X
-----X..X-X..,,.,,.+,...............AXB.,..............,,.XXXXXXXXXXX,XXXXXXXXXXX.,...........X.XX,,XX..........X........AA.X..X...X
-----X..X-X..,,.,,.+,..........XXXXXAXB.,..............H,.X-----XXXXX+XXXXXXXXXAX.,...........X.XX,,X...........X...........X..X...X
-----X..X-X..,XXXXXXX..........X---XXXX.,.......:......:,.XXHHHXX<H:..WHXX....XXX.,...........X.XX,,X...........X........AA.X..X...X
-----X..X-X.......HXX..........X-XX...,.,.......,,,,,,,,,.XXW...W.HH.:.HXX....,...,...........X.XX,,X...........,.......A.A.X..X...X
-----X..X-X........XX..........X-X....,.,.......,,,,,,,,,.XX..:W.XXH...HXX..,,XXXX............XWXX,,X...........,...........X..X...X
-----X..X-XXXXXXX..XX..........XX.....,.,.......,,,,,,,,,.,+....,.:.,W.HXX..,.................X.XX,,X...........,.......A.A.X..X...X
-----X..XXX.,.,,,..XX..........XX.....,.,.......,,,,,,,,,.XX:HH,....,.W.XX..,,,,............,BXWXX,,X...........,.........A.X..X...X
-----X...+,.,.,,,..XX..........XX.....,.,.......:,,,,,,:,.XXHHX......XX<XX..,,T,............,BXXXX,,X...........,.......A...X..X...X
-----X...XXXXXXXXXXXX..........XX,,XXXB.,...........,,,,,.XX<.X:.....:HHHX..:,,,...:........,.XXXX,,X...........,...........X..X...X
-----X.............XX..........XX,,XWXB.,...........,T,,,.XX..X......XHH:X..,,,,,,,,,.......,.,.....X...........,...........X..X...X
-----X..............,..........XX,,XWXX,,...........,,,,,.XXXWW,,...,...XX..,,,,,,,,,.......,.,.....X...........,...........X..X...X
-----X,,,,,,,,,......,.........XX,,X.XX............XXXX,,.X-H....X:XW.:.++..,,,,,,,,,.......,.,.....X...........,...........X..X...X
-----X........,......,.........XX,,X.XX...........,XXXX,,.X-H.:.HHXXW..WXX..,,,,,,,,,.......,.,....XX...........,...........X..X...X
-----X........,......,.........XX,,X.XX..........,,...,...X-HW..HH<.,HHHXX..:,,,,,,:,.......,.,...XXX...........,...........X..X...X
-----X........,HH.H.,..........XX,,X.XX..........,,.XXXXXXX-XXX+:HXXXXXXXX..,,..............,.XXXXXXX...........,...........X..X...X
-----XA.AAA.A.,....XX.........XXX,,X.XX..........,,.A-XXXXXXXXX,XXXXXXXXXX..,H..............,BA.................,...........X..X...X
-----X..AA....XXXXXXX.........XXX,,X.XXW.........,,.XXX.................XX..,H..............,BA.................,...........X..X...X
-----X....AAA.X....XX.........XX.....XX..........,,...,.................XX..,H..............,BA.................,...........X..X...X
-----X..AAAAA.X.HHHXX.........XA.....XXXX,,........XXXX,,,,,:,,,,:,,,,,.XX..,H..............,.X.................,...........X..X...X
-----XXXXXXXXXX....XX.........XA.........,,.........HHHHHHH.,,,,,,,..,,.XX..,H..............,.,.................,...........X..X...X
-----XXXXXXXXXX....XX.........XA.......:..,,.................,,,,,,T,XX,XXX,XH..............,.,.................,...........X..X...X
-----XA....A.A.....,,.........XA..........,,.................,,,,,,.,XX.XAX.XH..............,.,.................,...........X..X...X
-----X.A.A.A.A.....,,.........XA.........W.,,................,,,,,,,,XX.XXX.X...............,.,.................,.........A.X..X...X
-----XA.A.A........,,.........XX...........,,................,,,,,...XX.....X...............,.,.................,...........X..X...X
-----XAAA.AA.A.....,,.........XA......XXXXXXX................,,,,,.....,,,,,................,BX.................,.........A.X..X...X
-----X.............,,.........XA......X-----X...............:,,,,:..........................,BA.................,...........X..X...X
-----X.............,,.........XA......XXXXXXX................,,,,,..........................,BA.................X.........A.X..X...X
-----X.............,,.........XA...........XX...............................................,.A.................X.........A.X..X...X
-----X.............,,.........XX........tttXX...............................................,.X.................X...........X..X...X
-----X.............,,.........XX........t.tXX...............................................,.X.................X.........A.X..X...X
-----X.............,,.........XA........tttXX...................................,,XXXXXXXXXXXXXA................X.........A.X..X...X
-----X.............,,.........XA..........HXX.................................,,..X-X....HHHH.,AA...............X...........X..X...X
-----X.............XX.........XA..........HXX...............................,,..W.X-X.ttt......,................X.......XXX+X..X...X
-----X.............XX.........XA..........HXX...............................,.....X-X.t.t......,................XHH.HHH.X-X.X..X...X
-----XH............XX.......,,XX..........HXX,,,,,,,,,,,,,,,,,,,,,,,,......WX..:..X-X.ttt.......,...............XXXXXXXXX-X++..X...X
-----X.............XX.......T.XA..........HXX.......................,.......X.....X-X...........,...............X.......X---X..X...X
-----XXXXXX,XXXXXXXXX.......,,XX...........XXXAAAXX,,,,,XAAXX,,,,,XXXXXXXXXXX.....XXX...........,...............X.......XXXX..XX...X
----------X.X-------X.........,.,,.......,AA...............XX.....XWW...........................,...............X.......,.....XX...X
----------X++--XXXXX..........,...,,,,,,,A.................XX.....XXXXXXXXX.....................,...........X,,XXXXXX...,....X-X...X
--------------X,..,,..........,............................XX.....XXXXXXXXX.....................,...........X..X----X...,..XX--X...X
-------------X.,..,,..........,............................X-X....,,,,,,,,,.....................,...........X..XXXXXX...XXXXXXXX...X
-----------XX,.,..,,..........,............................X-XX...,,,,,,,,,...AAAA..AAAA.AAAAA.,............X...........XX....XX...X
---------XX...,.,.XX..........,............................XXXXXXXXXXXXXXXX....................,............X...........XX....XX...X
---------X,...,.,X--X.........,..........................................XXXXXXXXXXXXXXXXXXXXXX,,,,,,,,,,,,,XXXXXXX.....XX....XX...X
---------X,...,.X---X.........,.............................................................,,,.............XXXXXXX.....XX....XX...X
---------X.,...,X---X.........,.............................................................T.,...................X.....XX....XX...X
---------X.,...X----X.........,.............................................................,,,...................X.....XX....XX...X
---------X..,..X----X.........,...................................................................................,.....,.....XX...X
---------X...,.X----X.........,...................................................................................,.....,.....XX...X
--------X....,X-----X.........,...................................................................................,.....,.....XX...X
--------X....AX------X........,...................................................................................,.....,.....XX...X
--------X....AX------X........,...................................................................................,.....,.....XX...X
--------X.....X-XXXXX-X.......,.XXX.....H.H.H.H.H......................................H.H.H.H....................X.....,.....XX...X
--------X.....X-XAA.X--X......XXAAXX......XXX.....................................................................X.....,.....XX...X
--------X.....X-X...X-XXX.....XXX..XX.....XXXXXXXXXXXXX,,,,,XXXXX,,,,,XXXXX,,,,,XXXXX,,,,,XXXXXXXXXXXXXXX.........X.....,.....XX...X
--------X.....X-X...X-A,,.....,XX..,,.....,..AX-------X.....X---X.....X---X.....X---X.....X---------X..XX........XX.....,.....XX...X
--------X.....X-X...XXX,,.....,XX..,,.....,..AX-------X.....X---X.....XXXXX.....X---X.....XXXXXXXXXXX..XXXX,,,XXXX......,.....XX...X
---------X....X-X.......,,...,.XX...,,...,....X-------X.....X---X.....,...,.....X----X....,.,.,.,.,.............X.......,.....XX...X
---------X....X-XA........,,,...XX....,,,.....XXXXXXXXX.....X---X.....,...,.....X-----X...,.,.,.,.,.............XXXXX...,.....XX...X
---------X....X-X...............XX............,.,.,.,.,....X----X.....,...,.....X------X..,.,.,.,.,.............X---X...,.....XX...X
---------X.....XXXXXXXX..........XXX..........,.,.,.,.,...X-----X.....,...,.....X-------XXXXXXXXXXXXXXXXXXXXX...XXXXX...,.....XX...X
----------X....X--X................XXX........,.,.,.,.,..X------X.....,...,.....X---------------------------X...........,.....XX...X
----------X....X--XAA.............AA.XX.....XXXXXXXXXXXXX-------X.....,...,.....XXXXXXXXXXXXXXXXXXXXXXXXXXXXX...........XX....XX...X
----------X.....X-X..............XXXXXX.....XXHHH.......X-------X.....,....,....,.,.,.,.,...............................XX....XX...X
-----------X....X-XXXXXXXXXXX....XXXXXX.....XX..........XXXXXXXXX.....,.....,...,.,.,.,.,...............................XX....XX...X
-----------X.....X----------X....XXAA.......XX..........,.,.,.,.,....,.......,..,.,.,.,.,...............................XX....X....X
------------X.....XX--------X....XX.........XX..........,.,.,.,.,...,.........,,XXXXXXXXX.......................XXXXXXXXXXXXXXX....X
-------------X......XX------X....XX.........XX..........,.,.,.,.,..,............X-------X.......................XX-----------X.....X
-------------X........XXXXXXX....XXXXXXXX...XX..........XXXXXXXXX,,.............X-------X.......................,.X--------XX......X
--------------X..................X------X...............XXXXXX--X...............X-------X.......................,..XX--XXXX........X
---------------XX................XXXXXXXX..................H.X--X...............XXXXXXX-XXXXXXX,,,,,,,,,,,XXXXX.,....XX...........X-
-----------------X.........................................H.X--X.....................X--X..................X--XX.................X-
------------------XX.........................................X--X.....................XXXX..................X----XX..............X--
--------------------XXXXX..................................H.X--X.....................,.>X..................X------X...........XX---
-------------------------XXXXXXXXXXXXXXXXXXXXXXXXXXXXXXXXXXXXX--X.....................XXXX..................X-------XX.......XX-----
----------------------------------------------------------------X.....................X--X..................X---------XXXXXXX-------
----------------------------------------------------------------X.....................X--X..................X-----------------------
----------------------------------------------------------------X.....................X--X..................X-----------------------
----------------------------------------------------------------X.....................X--X..................X-----------------------
-----------------------------------------------------------------X...................X---X..................X-----------------------
------------------------------------------------------------------X.................X----X..................X-----------------------
-------------------------------------------------------------------X...............X-----X..................X-----------------------
--------------------------------------------------------------------XX...........XX------XXXXXXXXXXXXXXXXXXXX-----------------------
----------------------------------------------------------------------XXX.....XXX---------------------------------------------------
-------------------------------------------------------------------------XXXXX------------------------------------------------------
