--------------------------------XXXXXXX--------------------------------------------------------------------------------------------
--------------------------------X.....X--------------------------------------------------------------------------------------------
--------------------------------X.E.E.X--------------------------------------------------------------------------------------------
--------------------------------X.....X--------------------------------------------------------------------------------------------
--------------------------------X.H.H.X--------------------------------------------------------------------------------------------
--------------------------------X.....X--------------------------------------------------------------------------------------------
--------------------------XXXXXXX,,,,,XXXXXXX--------------------------------------------------------------------------------------
-------------------------X...................X-------------------------------------------------------------------------------------
------------------------X....................X-------------------------------------------------------------------------------------
------------------------X.....................X------------------------------------------------------------------------------------
-----------------------X....XXXXX,,,,,XXXXX...X------------------------------------------------------------------------------------
----------------------X....X----X.....X----X...X-----------------------------------------------------------------------------------
---------------------X....X-----X.H.H.X----X....X----------------------------------------------------------------------------------
--------------------X....X------X.....X-----X...X----------------------------------------------------------------------------------
--------------------X...X-------X.E.E.X------X...X---------------------------------------------------------------------------------
-------------------X...X--------X.....X------X...X---------------------------------------------------------------------------------
------------XXXXXXX,,,XXXXXXXXXXXXXXXXXXXXXXXXX,,,XXXXXXXXXXXXXXXXXXXXXXXXXXXXXXXXXXXXXXXXXXXXXXXXXXXXXXXXXXXXXXXXXXXXXXXXXXXXXXXXX
-----------X..................,...................................................................................................X
----------X...................,...................................................................................................X
--------XX....................,...................................................................................................X
-------X......................,...........................................................................................E.......X
------X.......................,...................................................................................................X
-----X........................,.............................................XXXXXXXHXXXXXXX:XXXXXXXXXXXXXXX:XXXXXHXXXXXXXXX.......X
----X.........................,.............................................X-----X+X-----X+X-------------XWX---XWX-------X.......X
--XX..........................,.............................................X-XXXXX+XXXXXXX+XXXXXX+++XXXXXX+XXXXX+XXXXXXX-X.......X
-X............................,.............................................X-X.........................................X-X.......X
X.............................,.............................................X-X.....E...............E.............E.....X-X.......X
X.............................,.............................................X-X.........................................X-X.......X
X.............................,.............................................X-X...XXXXXXXXXXXXXXXXXXXXXXXXXXXXXXXXXXX...X-X.......X
X.............................,..E..........................................X-X...X---------------------------------X...X-X.......X
X.............................,.............................................X-X...XXXXXXXXXXXXXXXXXXXXXXXXXXXXXXXXXXX...X-X.......X
X.............................,.............................................X-X.........................................X-X.......X
X.............................,.............................................X-X.................E.......E...............X-X.......X
X.............................,.............................................X-X.........................................X-X.......X
X.............................,.............................................X-X...............H.E...E...E.H.............X-X.......X
X.............................,.............................................X-X.........................................X-X.......X
X.............................,.............................................X-X.................E.......E...............X-X.......X
X.............E...............,.............................................X-X.........................................X-X.......X
X.............................,.............................................X-X...XXXXXXXXXXXXXXXXXXXXXXXXXXXXXXXXXXX...X-X.......X
X.............................,.............................................X-X...X---------------------------------X...X-X.......X
X.............................,...........XXXXXXXXXXXXXXXXXXXXXX............X-X...XXXXXXXXXXXXXXXXXXXXXXXXXXXXXXXXXXX...X-X.......X
X.............................,...........X--------------------X............X-X.........................................X-X.......X
X.............................,...........XXXXXXXXXXXXXXXXXXX--X............X-X...........E.......................E.....X-X.......X
X....................H,,,,H,..,...........,.,...............XXXX............X-X.........................................X-X.......X
X....................,,...,,..,...........,.,...............XE,,............X-XXXXXXXXXXXXXXXXXXX+++XXXXXXXXXXXXXXXXXXXXX-X.......X
X.....................,...,...,...........,.,...............XXXX............X-------------------X+++X---------------------X.......X
X.....................,...,...,...........,.,...............X--X............XXXXXXXXXXXXXXXXXXXXX,,,XXXXXXXXXXXXXXXXXXXXXXX.......X
X.....................,...,...,...........,E,...............X--X..................................................................X
X.....................,...,...,...........,.,...............X--X..................................................................X
X.....................,...,...,...........,A,...............X--X..................................................................X
X.....................,...,...,...........,.,...,,,.........XXXX..................................................................X
X.....................,...,...,...........,.,..,,,,.........X..,..................................................................X
X....................H,...H,..,...........,.,..,,,..........XE.,..................................................................X
X....................,,...,,..,...........,E,.,,,,..........X..,..................................................................X
X.....................,...,...,...........,.,..,,,..........XE.,..................................................................X
X.....................,...,...,...........,.,.,,,...........X..,..................................................................X
X...............H,....,...,...,...........X.,,,,,,,.........XXXX..................................................................X
X...............,,,,,,,...,...,...........XX.E..X.,.........X--X..................................................................X
X...............,.........,...,...........XXX,XXX.,.........X--X..................................................................X
X...............,.........,...,.................X.,.........X--X..................................................................X
X...............,.........,...,.................X.,.........X--X..................................................................X
X...............H,,,,,,...,...,.................,E,.........X--X..................................................................X
X...............,,....,...H,..,.................,.,.........XXXX..................................A.........................A.<...X
X.....................,...,,,,,.................,.,.........,.,,..................................................................X
X.....................,.......,...............A.,K,.........,A,,A.................................................................X
X.....................,.......,.................,.,.........,.,,..................................................................X
X.....................,.......,.E...............,.,.........XXXX..................................................................X
X.....................,...H,,,,.................,E,.........X--X..................................................................X
X.....................,...,,..,.................X.,.........X--X..................................................................X
X.....................,...,...,.................X.,.........X--X..................................................................X
X...............H,....,...,...,...........XXX,XXX.,.........X--X..................................................................X
X...............,,,,,,,...,...,...........X..E....,.........X--X..................................................................X
X...............,.........,...,...........X.,,,,,,,.........XXXX..................................................................X
X...............,.........,...,...........,.,...............X..,..................................................................X
X...............,.........,...,...........,.,...............XE.,..................................................................X
X...............H,,,,,,...,...,...........,E,...............X..,..................................................................X
X...............,,....,...,...,...........,.,...............XE.,..........XXXXXXXXXXXXXXXXXXXXXXXLLLXXXXXXXXXXXXXXXXXXXXXXX.......X
X....................,,...,,..,...........,.,...............X..,..........X---------------------LLLLL---------------------X.......X
X....................H,...H,..,...........,.,...............XXXX..........X---XXXXXXXXXXXXXXXXXXX,,,XXXXXXXXXXXXXXXXXXXXX-X.......X
X.....................,...,...,...........,.,...............X--X..........X-XXX.........................................X-X.......X
X.....................,...,...,...........,A,...............X--X..........X-X.,.........................................X-X.......X
X.....................,...,...,...........,.,...............X--X..........X-XXX............,,.,,,.,,.,,,.,,.,,,.,,......X-X.......X
X.....................,...,...,...........,.,...............X--X..........X-XXX............,,.,,,.,,.,,,.,,.,,,.,,......X-X.......X
X.....................,...,...,...........,E,...............XXXX..........X-XXX,...........,E.,E,.,E.,:,.,E.,E,.,E......X-X.......X
X.....................,...,...,...........,.,...............XE,,..........X-XXX.,,.........,,.,,,.,,.,,,.,,.,,,.,,......X-X.......X
X.....................,...,...,...........,.,...............XXXX..........X-XXX.,,.........,E.,E,.,E.,:,.,E.,E,.,E......X-X.......X
X.....................,...,...,...........XXXXXXXXXXXXXXXXXXX--X..........X-XXX.E,,........,,.,,,.,,.,,,.,,.,,,.,,...,,,X-X.......X
X.....................,...,...,...........X--------------------X..........XXXXX..,,..................................,:,X-X.......X
X....................H,...H,..,...........XXXXXXXXXXXXXXXXXXXXXX..........X>,.,.E.,,................................E,:,X-X.......X
X....................,,,,,,,..,...........................................X>XXX..,,..................................,:,X-X.......X
X.............................,...........................................X-XXX.E,,........,,.,,,.,,.,,,.,,.,,,.,,...,,,X-X.......X
X.............................,...........................................X-XXX.,,.........,E.,E,.,E.,:,.,E.,E,.,E......X-X.......X
X.............................,...........................................X-XXX,,..........,,.,,,.,,.,,,.,,.,,,.,,......X-X.......X
X.............................,...........................................X-XXX............,E.,E,.,E.,:,.,E.,E,.,E......X-X.......X
X.............E...............,...........................................X-XXX............,,.,,,.,,.,,,.,,.,,,.,,......X-X.......X
X.............................,...........................................X-XXX............,,.,,,.,,.,,,.,,.,,,.,,......X-X.......X
X.............................,...........................................X-X.,.........................................X-X.......X
X.............................,...........................................X-XXX.........................................X-X.......X
X.............................,...........................................X---XXXXXXXXXXXXXXXXXXXXXXXXXXXXXXXXXXXXXXXXXXX-X.......X
X.............................,...........................................X-----------------------------------------------X.......X
X.............................,...........................................XXXXXXXXXXXXXXXXXXXXXXXXXXXXXXXXXXXXXXXXXXXXXXXXX.......X
-X............................,...................................................................................................X
--XX..........................,.....E.....................................................................................E.......X
----X.........................,...................................................................................................X
-----X........................,...................................................................................................X
------X.......................,...................................................................................................X
-------X......................,...................................................................................................X
--------XX....................,...................................................................................................X
----------X...................,...................................................................................................X
-----------X..................,...................................................................................................X
------------XXXXXXXXXXXXXXXXXXXXXXXXXXXXXXXXXXXXXXXXXXXXXXXXXXXXXXXXXXXXXXXXXXXXXXXXXXXXXXXXXXXXXXXXXXXXXXXXXXXXXXXXXXXXXXXXXXXXXXX
