----------------XXX-XXX-----------------------
----------XX----XHX-XHX---XXXXXXXXX-----------
----------XX----X,X-X,X---X..XX...X-----------
----------XX---TX,XXX,XXX-X..,,.K.X-----------
----------XX---X,.......X-X..XX,,,X-----------
--XXXXX---XXXXXX........XXX,,XX,,,X-----------
--H.HHX-+XX..,,,........,,,.......X-----------
XXX,,,X-+.,..,,,......E.,,,.......X-----------
X.,...X-XXX..,,,........,,,.......X----X------
X.,...X---X,XXXX........XXX,,...,,X--XX.X-----
X.,...X---X.X--X........X-X:,...,:X--X...X----
X.,...XXXXX,XXXX,,,,,,,,X-XXX...,,XXXX,,.X----
X.,.......,.............X---X.....XX.,.XX-----
X.,.......,.,,,,,,,,,,,,X---X.....,,,,,X------
X.,.......,.,.....,HHHHHH---X.....XX...X------
X.,,,,,,,,XXXX+++XXXXXX+X---XX,,,XXX...X------
X.........X--X+++X-XXXX+XXXX-XLLLX-X...X------
XXXXXXXXXXX-XX,,,XXX.......XXX,,,XXX,,,X-XXXXX
------------X.....XX.......XX..........XXX...X
------------X:....,,..,,,..,,..........,,>...X
------------X.....,,..,H,..,,..........,,>...X
------------X...:.XX..,,,..XX..........,,>...X
------------HHHHHHXX.......XX..........XXX...X
------------XXXXXXXX.......XXXXXXXXXXXXX-XXXXX
-------------------X.......X------------------
-------------------X.......X------------------
-------------------X......X-------------------
--------------------X.ttt.X-------------------
---------------------Xt.tX--------------------
----------------------XXX---------------------
