XXXXXXXXXXXXXXXXXXXXXXXXXXXXXXXXXXXXXXXXX--------------------------------
X...................K...................X--------------------------------
X.......................................X--------------------------------
X.......................................X--------------------------------
X.......A...............................X--------------------------------
X.....,,,,,...................E.........X--------------------------------
X.....,...,.............................X--------------------------------
X....A,.E.,A............................X--------------------------------
X.....,...,.............................X--------------------------------
X.....,,,,,...................E.........X--------------------------------
X.......A...............................X--------------------------------
X...............,,,,,,,,................X--------------------------------
X..............,........,...............X--------------------------------
X.............,..........,....E.........X--------------------------------
X............,............,.............X--------------------------------
X...........,..............,.........,,,X--------------------------------
X...........,..............,........,...X--------------------------------
X...........,..............,..E....H,.A.X--------------------------------
X...........,.....,,,,,....,........,...X--------------------------------
X...........,.....,...,....,.....,,,,.A.X--------------------------------
X...........,.....,.E.,....,.....,,,,...X--------------------------------
X...........,.....,...,....,..E..,,,,.W.X--------------------------------
X...........,.....,,,,,....,.....,,,,...X--------------------------------
X...........,..............,.....,,,,.A.X--------------------------------
X...........,..............,.......H,...X--------------------------------
X............,............,...E.....,.A.X--------------------------------
X.............,..........,...........,,,X--------------------------------
X..............,........,...............X--------------------------------
X...............,,,,,,,,................X--------------------------------
X.............................E.........X--------------------------------
X.......A...............................X--------------------------------
X.....,,,,,.............................X--------------------------------
X.....,...,.............................X--------------------------------
X....A,.E.,A..................E.........X--------------------------------
X.....,...,.............................X--------------------------------
X.....,,,,,.............................X--------------------------------
X.......A...............................X--------------------------------
X.......................................X--------------------------------
X.................E.....................X--------------------------------
X.......................................X--------------------------------
XXXXXXXXXXXXXXXXX+++XXXXXXXXXXXXXXXXXXXXX--------------------------------
----------------X+++X----------------------------------------------------
----------------X...X----------------------------------------------------
----------------X.H.X----------------------------------------------------
----------------X...X----------------------------------------------------
----------------X...X----------------------------------------------------
----------------X...X----------------------------------------------------
----------------X...X----------------------------------------------------
----------------X...X----------------------------------------------------
----------------X...X----------------------------------------------------
----------------X...X----------------------------------------------------
----------------X...X----------------------------------------------------
----------------X...X----------------------------------------------------
----------------X...XXXXXXXXXXXXXXXXXXXXX--------------------------------
----------------X...,...................X--------------------------------
----------------X...,.H.......E.E.E.....X--------------------------------
----------------X:..,...................X--------------------------------
----------------XXXXXXXXXXXXXXXXXXXXX,,,X--------------------------------
------------------------------------X...X--------------------------------
------------------------------------X...X--------------------------------
------------------------------------X...X--------------------------------
------------------------------------X...X--------------------------------
------------------------------------X...X--------------------------------
------------------------------------X.E.X--------------------------------
------------------------------------X...X--------------------------------
------------------------------------X...X--------------------------------
------------------------------------X...X--------------------------------
------------------------------------X...X--------------------------------
------------------------------------X...X--------------------------------
------------------------------------X+++X--------------------------------
---------------------XXXXXXXXXXXXXXXX+++XX-------------------------------
---------------------X.......,...,....A..X-------------------------------
---------------------X.......,...,.......X-------------------------------
---------------------X.......,...,.......X-------------------------------
---------------------X.......,...,.......X-------------------------------
XXXXXXXXXXXXXXXXXXXXXX.......,...,.......X-------------------------------
X:.................:XX.......,...,.......X-------------------------------
X...................XX.......,...,.......X-------------------------------
X...................XX.......,...,.......X-------------------------------
X...................XX.......,...,.......X-------------------------------
X...................XX.......,...,.......X-------------------------------
X...................XX.......,...,..E....X-------------------------------
X...................XX.......,...,.......X-------------------------------
X...A.....E.........XX......E,...,.......X-------------------------------
X...................++.......,...,.......X-------------------------------
X.<.W.....E.........++.......,...,..E....X-------------------------------
X...................++.......,...,.......X-------------------------------
X...A.....E.........XX......E,...,.......X-------------------------------
X...................XX.......,...,.......X-------------------------------
X...................XX.......,...,..E....X-------------------------------
X...................XX.......,...,.......X-------------------------------
X...................XX.......,...,.......X-------------------------------
X...................XX.......,...,.......X-------------------------------
X...................XX.......,...,......:X-------------------------------
X:.................:XX.......,...,.......X-------------------------------
XXXXXXXXXXXXXXXXXXXXXX.......,...,......:X-------------------------------
---------------------X.......,...,.......XXXXXXXXXXXXXXXXXXXXXXXXXXXXXXXX
---------------------X.......,...,.......++..AAWXX......................X
---------------------X.......,...,.......++E....XX......................X
---------------------X.......,...,B......++..AAAXX......................X
---------------------XXXXXXXXXXXXXXXXLLLXXXXXXXXXX......................X
------------------------------------XLLLX--------X......................X
------------------------------------X...X--------X......................X
------------------------------------X...X--------X......................X
------------------------------------X...X--------X......................X
------------------------------------X...X--------X......................X
------------------------------------X...X--------X......................X
------------------------------------X...X--------X......................X
------------------------------------X...X--------X......................X
------------------------------------X...X--------X......................X
------------------------------------X...X--------X......................X
------------------------------------X,,,XXXXXXXXXX......................X
------------------------------------X............,......................X
------------------------------------X............,.............:........X
------------------------------------X............,......................X
------------------------------------XXXXXXXXXXXXXX......................X
-------------------------------------------------X......................X
-------------------------------------------------X......................X
-------------------------------------------------X......................X
-------------------------------------------------X......................X
-------------------------------------------------X......................X
-------------------------------------------------X......................X
-------------------------------------------------X......................X
-------------------------------------------------X......................X
-------------------------------------------------X......................X
-------------------------------------------------X......................X
-------------------------------------------------X......................X
-------------------------------------------------X......................X
-------------------------------------------------XXXXXXXXXXXXXXXXXXXXXXXX
