----------------------------------------XX--------------------------------------------------------------------------------------
------------------------------------XXXX..XX------------------------------------------------------------------------------------
--------------------------------XXXX........XX----------------------------------------------------------------------------------
----------------------------XXXX..............X---------------------------------------------------------------------------------
------------------------XXXX...................XX-------------------------------------------------------------------------------
--------------------XXXX.........................XX-----------------------------------------------------------------------------
----------------XXXX...............................X----------------------------------------------------------------------------
-------------XXX...................................X----------------------------------------------------------------------------
-------------X.....................................X----------------------------------------------------------------------------
-------------X.....................................X----------------------------------------------------------------------------
-------------X.....................................X----------------------------------------------------------------------------
-------------X.....................................X----------------------------------------------------------------------------
-------------X.....................................X----------------------------------------------------------------------------
-------------X.....................................X----------------------------------------------------------------------------
-------------X.....................................X----------------------------------------------------------------------------
-------------X.....................................X----------------------------------------------------------------------------
-------------X.....................................X----------------------------------------------------------------------------
-------------X.....................................X----------------------------------------------------------------------------
-------------X.....................................X----------------------------------------------------------------------------
-------------X.....................................X----------------------------------------------------------------------------
-------------X.....................................X----------------------------------------------------------------------------
-------------X.....................................X----------------------------------------------------------------------------
-------------X.....................................X----------------------------------------------------------------------------
-------------X.....................................X----------------------------------------------------------------------------
-------------X.....................................XXX--------------------------------------XXXXX-------------------------------
-------------X.....................................,EX--------------------------------------XEXHH-------------------------------
XXXXXXXXXXXXXX.....................................,,XXXXXXXXXXXXXXXXXXXXXXXXXXXXXXXXXXXXXXXX,XXX-XXXXXXXXXXXX------------------
X.................................................................,,.XX..........A..XXHH.A.AX.,.XXX.......XXEX------------------
X.................................................................,,.X..............BXE,..A.X,,...........XX.X------------------
X.................................................................,,.+..............,,.,....X.............+,.X------------------
X.................................................................,,.+...,,,,,,,,,.B,,.,...AX.,,,,........XX.X------------------
X.................................................................,,.+...,......AH.B,,.,.E..X.,..,......,,AX.X------------------
X.................................................................,,.+...,,,,,,,,,..B,E,.H..X.,.E,...,,,,,XXEX------------------
X.................................................................,,.+.........B..B.B,.,...HXXX,,XXXXXAXXXAX.X------------------
X.................................................................,,.X........B.BB.EXXA,..E.XXX++XXXXXXXXXXX.X------------------
X.................................................................,,.XAXXXXXBXX++XXXXXXH,H,AXX...,...,,...HX.X------------------
X.................................................................,,.XXXXXXXXXX++XXXXXX,,,,XXX...,,,,,,,,,XXEX------------------
X.................................................................,,.,...,,.........,,......+.............XX.X------------------
X...............................................................<.,,.,...,,.........,,......+.............,,.X------------------
X.................................................................,,.,...XX.........,,...B..XX........,:,.,,EX------------------
X.................................................................,,.X+X+XX.........,,,,,,,,XE........,.,.,,.X------------------
X.................................................................,,.+EXEXX.........,,,,,,..XA........,.,.,,.X------------------
X.................................................................,,.XXHXXX.........XH,,,,..XH........,.,.,,EX------------------
X.............................................................B...,,.XXXXXX.........XX,,,,t.XH........,.,.XX.X------------------
X.................................................................,,.X..............XX,,,,,tXH........,,,.XXEX------------------
X.................................................................,,.X.....,+++++,..XX,,,,,.X+.....XX++X..XX.X------------------
X.................................................................,,.X.....,,<:AE,..XX.,,.T,XE.....XXAEX..XXEX-XXXXXXXXXXXXXX---
X.................................................................XXXXXXXXXXXXXXXXXXXXXXXXXXXXXXXXXXXXXXXXXX.X-X............X---
X.................................................................,,KX:.EA.A.E.EXAEAAX,,H,,EX-X..,,.T.H.,tXX,XX,.:..........X---
X.................................................................,ttX,,,,,,,,,,XE.EEX,,,,,EXXX,,,,,,,,,,tXX.,,,.........:H.X---
X.................................................................,,.X...:.....:XE..EX...,E,X,,,,,,.......XX,,,,............X---
X.................................................................,,.X.,:...:...XA.EXX.....,X..........,,,,,.,,,............X---
X.................................................................,,.,.,,.....:.XX..EX.....,X.......,,,,,,,,.,,,............X---
X.................................................................,,.,.,..:..:.:XE.EXX.....,X.......,T,,,,,,.,,,............X---
X.................................................................,,.,A,:.......XX++XXLLXXXXX.......,,,,,,,,.,,,............X---
X.................................................................,,.X......:.:.XX.A,,......X..........,,,XX.,,,...........:X---
X.................................................................,,.X..:::.....,+A.,,......,....,,,,,,,,,XX.,,,............X---
X...............................,,,,,.............................,,.X:.......::XX.<XX......,....,,,,,,:..XX.,,,............X---
X.............................,,.K...,,...........................,,.XXXXXXXXXXXXX,,XX......,....,,,,,,,..XX.,,,............X---
X............................,.........,..........................,,.X..AE,E,,,,,...XA......X.............XX.,,,............X---
X...........................,...........,.........................,,.,..XE,,,,..,...XX,,,,,,X.............,,:,,,............X---
X...........................,...........,.........................,,.,..XX...,H.,...XX,,,,,,X.............,,K,,,......A...E.X---
X..........................,.............,........................,,.,.EXX...,,.,...XX,,,,,,X..ttttttt:...,,.,,,............X---
X..........................,.............,........................,,.,..,,....,,..,,XX,,,,,,X..,....A.,...,,.,,,............X---
X..........................,....:........,........................,,.,.E,,........,.XX,,,ttTX..,,,,,,,,...,,.,,,............X---
X..........................,........T....,........................,,.,..XX.....A..,HXX,,,.,tX.............XX.,,,............X---
X..........................,..:..........,........................,,.,..XX,,:,HHHHHHXXT,,t.,X.............XX.,,,...A........X---
X...........................,...........,.........................,,.X..XX,,,,,,,,,,XX.,,t..X...XXXXXXX..X-X.,,,.H......:...X---
X...........................,....:......,.........................,,,XXXXXXXXXXXXXXXXXXXXXXXXXXXXXXXXXXXXXXXXXX,,,,,,,,,XXXXX---
X............................,.........,..........................,,.X.....,,,,,,...XXK,.E,,X-X,,,,,,,,.......,E,,..,.,H,HH,X---
X.............................,,.....,,...........................,,.X.....,,,,,,...XX,,.,,,XXX,.....,,.......,E,,,,....HH,HA---
X...............................,,,,,.............................,,.X.....,,,,.,...XX...,,,X..,.....,,,,,,...,,,,,,,,,,,,HHX---
X.................................................................,,.X.....,.,,,,...XX...,,,,..,.....,,,,,,...,,,,,,...,,,.WX---
X.................................................................,,.,.....,,,,,,...XX...,,,X..,.........:,...,,,,,,..,.,,,,X---
X.................................................................,,.,.,,,.,,,,,,,,,XX...,,,X..,.........,,...,.,,,,..,,.,E.X---
X.................................................................,,.,.,.,.......,.,XX,,XXXXX..,.........,,...,.,,,,..,,,,,,X---
X.................................................................,,.X.,,,.......,,,XX...,,,X..,.........,,...,.,,,,,,,,,,,,X---
X.................................................................,,.X..,++++++++,..L,......,..,.......E.,,...,A.,..,,,,,,,,X---
X.................................................................,,.X..,,E::.EHH,..XX......,..,...,,,...,,...,..,,,,.,,,,..X---
X.................................................................,,.XXXXXXXXXXXXXXXXX.....,,..,...,.,...,,...,...,,,,,.,,,.X---
X.................................................................,,.X..XX.XXEAE.X..XX...,,.X..,...,,,...,,...,,,.,,....,,,HXXXX
X.................................................................,,.,..XX.XX,,,,X..L,.,,,,,X..,.........,,...,,,.,,.,,,,,,.,,,X
X.................................................................,,.,..XX..........XX,.,,,,X..,.........,,...,,,.,..,,,,T,.,E,X
X.................................................................,,.,.EXX..........XX..,,,,X..,...<.....,,...,.,.,..,....,.,,,X
X.................................................................,,.,..,,..........XX,,,,,,X..,.........:,...,,,..,,,,..,..XXXX
X.................................................................,,.,..,H..........XX,t,,,TX..,.....,,,,,,...H,,,,,,,,.,,.tX---
X.................................................................,,.,.EXX,,,,,.....XXt,,.,,X..,.....,,,,,,...,.,,,,E,,,,.t..X--
X.................................................................,,,,..XXH...,.....XX,,,,.,X..,.....E,.......,..,.E.,,,..t.EXX-
X.................................................................,,AX..HX....,.:..:XX.,,,..X.XX,,,,,,,.......,,H,,,,..,.t..,.EX
X.................................................................XXXXXXXXXXXXXXXXXXXXXXXXXXX,XXXXXXXXXXXXXXXXXXXXXXXXXXXXX,,..X
X.................................................................XXXX-XXXXXXXXXXXX........B,E,,X--------------------------XE.E-
X....................................................................X-X>..................B,,,,X----------------------------XX-
X....................................................................X-X>...................:.:BX-------------------------------
X....................................................................X-X>.............B....B.:.,X-------------------------------
X....................................................................X-X>..................BBBB,X-------------------------------
X....................................................................X-X>.................B....BX-------------------------------
X....................................................................X-X>.................B....,X-------------------------------
X....................................................................X-X>...............BB.....,X-------------------------------
X....................................................................X-X>......................,X-------------------------------
X....................................................................X-X>.............BB.......,X-------------------------------
X....................................................................X-X>............B.........,X-------------------------------
X....................................................................X-X>..........BBB.........,X-------------------------------
X....................................................................X-X>.........B............,X-------------------------------
X....................................................................X-X>..B.BB.BB.............,X-------------------------------
X....................................................................X-X>..>>>EB...............,X-------------------------------
X....................................................................X-X>..B:>B................,X-------------------------------
X....................................................................X-X>..BBB.................,X-------------------------------
X....................................................................X-X>......................,X-------------------------------
X....................................................................X-X>......................,X-------------------------------
X....................................................................X-X>......................,X-------------------------------
X....................................................................X-X,,,,,,,,,,,,,,,,,,,,,,,,X-------------------------------
X....................................................................X-XXXXXXXXXXXXXXXXXXXXXXXXXX-------------------------------
XE...................................................................X----------------------------------------------------------
XXXXXXXXXXXXXXXXXXXXXXXXXXXXXXXXXXXXXXXXXXXXXXXXXXXXXXXXXXXXXXXXXXXXXX----------------------------------------------------------
--------------------------------------------------------------------------------------------------------------------------------
