-------------------------XXXXXXEX----XHXXXXXXXXXXXXXXX------
-------------------------X:.....X----X...............X------
-------------------------X......X----X...............X------
-------------------------X......X--XXXE..............X------
-------------------------X..A...XXX,,,...............X------
-------------------------X......X,HXXX...............X------
-------------------------X......XXX--X...............X------
-------------------------XE....EX----X...E...........X------
-------------XXXXXXXXXXXXXXX,XXXXXXXXXHXXXXXX,,,,,...X------
-------------X,,,,....,,,,XX,XXE....X---XXXXX,,,,,...X------
-------------X,,,,.H.,,,,,XX,XX.....X-XX<.,W,..H,,...X------
-------------X,A,,...,,W,,XX,XX.....XX..<.,,,...,,...XXXXXXX
-------------X,,,,...,,,,,,,.,,...,,XXW.<.,.....,,...,.,,E.X
-------------X,,,.,,,,,,,.,,:,,...,WXX..<.,.....,,...XXXXXXX
XEXXXXXXXXXXXX...,,A,,....XX,XX...,,X-X...,.....,,...X------
X..........,.,.H.,,.,,.H..XX,XX.....X--XA.,:...H,,...X------
X..........,.,...,,W,,...EXX,XXE...:XXXXXXX,,,,,,,...X------
X..........,.,,,XXXXXXXXXXXX,XXXXXXXXH...E...........X------
X..........,W...X--------XE....EX----X...............X------
X..........,,,,,X--------X......X----X...............X------
X.........E.....X--------X......XXXXXX...............X------
X,..............X--------X......XXH,XXE..............X------
X.,,............X--------X..A...,XXXX,...............X------
X,..,,..........X--------X......XX--XX...............X------
X.,,..,,,.......X--------X......X----X...............X------
XE..,,.,.,......X--------X:....EX----H...............X------
X.:.,,,W.,,.....X--------XXXXXXXX----XXXXXXXX,XXXXXXXX------
X..,H.,.,.,.....X----------------------X.............X------
X....,...,.,....X----------------------X.............X------
X......,,,..XXXEX----------------------X,,,,,,,,,,,,,X------
X....,,,T,,.X--------------------------X.A,.,.W.,.,A.X------
XXXXXX,XXXXX---------------------------X,,,,,,,,,,,,,X------
-----X,X-------------------------------X.............X------
-----XAX-------------------------------X.............X------
----->>X-------------------------------X,,,,,,,,,,,,,X------
---------------------------------------X.W,.,.E.,.,H.X------
---------------------------------------X,,,,,,,,,,,,,X------
---------------------------------------X.,,K,,.......X------
---------------------------------------X.,,.,,....tttX------
---------------------------------------X.,,,,,....tHtX------
---------------------------------------X..........tttX------
---------------------------------------X..........,,,X------
---------------------------------------XXXXXXXXXXXXXXX------
