---------------------------------------------------------------------------------------------------------------------------------------------HX--XAX-----HX--XHX-------------------------------------
--------------------------------------------------------------------------------------------------------------------------------------------XXXXXX,XX---XXXXXX,XX------------------------------------
-------------------------------------------------------------------------------------------------------------------------------------------HX.......X---X.......AX-----------------------------------
-------------------------------------------------------------------------------------------------------------------------------------------XX......:X---X.......XX-----------------------------------
--------------------------------------------------------------------------------------------------------------------------------------------X...E...X---X.......X------------------------------------
--------------------------------------------------------------------------------------------------------------------------------------------X......,X:X:X,......X------------------------------------
-------------------------------------------------------------------------------------------------------------------------------------------XX......,,..,,,......XX-----------------------------------
-------------------------------------------------------------------------------------------------------------------------------------------H,.......,,,,,.....E.WX-----------------------------------
-------------------------------------------------------------------------------------------------------------------------------------------XX...,,..,..,,.,,,...XX-----------------------------------
--------------------------------------------------------------------------------------------------------------------------------------------XXXXX,,,,..,,,,,XXXXX------------------------------------
--------------------------------------------------------------------------XXXXXXX---------------------------------------------------------------:.,......,.:X----------------------------------------
------------------------------------------------------------XXXXXXXXXXXXXX......X---------------------------------------------------------------X.,......,..X----------------------------------------
----------------------------------------------XXXXXXXXXXXXXX....................X---------------------------------------------------------------X,........,,X----------------------------------------
--------------------------------------XXXXXXXX..................................X---------------------------------------------------------------X,........,,X----------------------------------------
--------------------------------------X........................................X----------------------------------------------------------------X.,......,..X----------------------------------------
--------------------------------------X.,,,,,,,,,,,,,,,,,,,,,,,,,,,,,,,,,,,,...X--XXXXXXXXXXX---------------------------------------------------:.,......,.:X----------------------------------------
--------------------------------------X.,...................................,,,X-X,.,.,.,.,.,X--------------------------------------------------XXXX,,,,XXXXX----------------------------------------
--------------------------------------X.,.....................................X-X..,,.,.,.,,..X----------------------------------------------------X++++XX-------------------------------------------
--------------------------------------X.,....................................X-X.,.,,.,.,.,,.,.X-------------------------------------------------XX.......XX--------------XXXXXXXXXXXXXXXXX----------
--------------------------------------XXXXXXX...............................X-X...,,,.,.,.,,,...X----------------------------------------------XX.....E.....X-----------XXX,,,,,,,,,,,,,,:XXXXXXX----
--------------------------------------------X...............................XX.....,,.,.,.,,...,.X--------------------------------------------X..............XX---------X:..,.......,,,,E.,.+...X----
--------------------------------------------X..............................XX.......XXXXXXX...,..,X-------XXXXXXXXXXXXXXXXXXXXXXXXXXX--------X.....XXXXXXXX....X--------X...,..E....,,,,..,.+...X----
--------------------------------------------X.............................XX.......X-------X.,,,,.X-------X.,.,.,,,.,,,.,,,.,,,...,.X-------X....XX--------X...X--------X,,,......,,,,,...,.+.:.X----
------------------------------------XXXXXXXXX...........................,XX.......X---------X,,,,,X-------X:,.,.,.,.,.,.,.,.,.,,...,:X-----X....X----------X....X-------X,,.......,,E.,E.XXXX...X----
------------------------------------X...............................,,,,XX.......X----------X,,,,,XX:-----X.,E,.,E,.,E,.,E,.,E,,...,XX-----X...X------------X...X--XXXXXX,,........,,,,,.:--X...X----
------------------------------------X...........................,,,,...XX.......X-----------X,,,,,XXXXX---XXXHXXXHXXXHXXXHXXXHXXX.,.X-----X....X------------X....X-X....,.,.......,,,,....XXX...X----
------------------------------------X.......................,,,,......XX.......X-----------X.,..,.,...,X----X,X-X,X-X,X-X,X-X,X-X.,.X-----X...X--------------X...X-X...,,,,,,.....,,,,....,.+...X----
------------------------------------X...................,,,,.........XX.......X-----------X.,....,.....,XXXXX,XXX,XXX,XXX,XXX,XXX,,,XXX---X...X--------------X....XX...,,H..,........,,.E.,.+...X----
------------------------------------X...............,,,,...........XXX.......X------------X,............,.,.....................,.,.,.X---X,,,X---------------X...+,...,,....,.......,,...,.+...X----
------------------------------------X...........,,,,..............X-X.E.....X------------XX...........E.,.,.....................,.,.,.XXXXX,,,X---------------X...+,...,,....,.......,,,,XXXX...X----
------------------------------------X.......,,,,.................X-X.......X-------------:X.............,.,.............E.......,.,.,.,.......X---------------X...+,...,,.A..,...,,,,,,,,:--X...X----
--------------------XXXXXXXXXXXXXXX-X...,,,,....................X-X.......X---------------X...E........,,.,.....................,.,.,.XXXXX+++X---------------X...+,...,,....,...,,,.,,,..XXX...X----
------------------XX..............X-XXX,,,,,,,,,,,,,,,,,,,,,,,,X-X.,.....X----------------X,.......E..,.,.,.....................,.,.,.X---X,,,X---------------X...XX...,,H..,......,,,,,E.,.+...X----
----------------XX..,,,,,,,,,,,,,,X---X,,,,,,,,,,,,,,,,,,,,,,,,,X.,.,...X-----------------X.,,.......,..XXXXX,XXX,XXX,XXX,XXX,XXX,,,XXX---X...X---------------X...XX...,,,,,,.....E,,.,,..,.+...X----
---------------X..,,..............X---X..........................,...,.X-------------------XE.,.....,..X----XHX-XHX-XEX-XHX-XHX-X.,.X-----X...X--------------X...X-X...,,,,........,,..,..,.+...X----
-------------XX.,,................X---X...........................,.,.X---------------------X..,...,..X---XXX,XXX,XXX,XXX,XXX,XXX..,XX----X...X--------------X...X-X....,.,.......,,.,,,.XXXX...X----
-----------XX.,,..................X---X,,,,,,,,,,,,,,,,,,,,,,,,..E.,.X-----------------------X..,,,..X----X.,E,.,E,.,.,.,E,.,E,.,..,:X-----X...XX-----------X...X--XXXXXX,,.......,,.,,E.:--X...X----
----------X.,,...................,X---X,,,XXX,,,XXX,,,XXXXXXXXX,....X-------------------------XXX:XXX-----X.,.,.,.,.,E,.,.,.,,,,...,XX-----X.....XX--------X....X-------X,,........,,,,,..XXX...X----
--------XX.,.....................,X---X,,,X-X,,,X-X,,,X--------X....X--------------------------XXXXX------XA,,,.,,,.,,,.,,,.,,.,..,.X-------X......XX----XX.....X-------X,,,.......,,,.,.A,.+...X----
------XX.,,......................,XXXXX,,,XXX,,,XXX,,,XXXXXXXXX-X.E.X----------------------XXXX.....XXXX--XXXXXXXXXXXXXXXXXXXXXXXXXXX--------X.......XXXX......X--------X...,.E...,,..,,..,.+...X----
-----X.,,........................,,...........................X-X...X----------------------XX.E.....,,..X-------------------------------------X.....E........XX---------X:..,.....,,..,.E:,.+...X----
---XX,,..........................,,...........................X-X...X------------------------X....,,..,,.X-------------------------------------XX...........X-----------XXXXXXXXXXXXXXXXXXXXX+++X----
-XX,,............................,,...........................X-X...X-------------------------X..,......,X---------------------------------------XXX,,,,XXXX--------------XXXXXXXXXXXXXXXXX-X,,,X----
X.,..............................,,,,,,,,,,,,,,,,,,,,,,,,,,...X-X...X--------------------------XE,......,.X----------------------------------------X++++X----------------------------------:X,..X:---
X.,.............................,.,...........,,..........,...X-X...X--------------------------X.,.......,.X-----------------------------------XXXXX,,,,XXXXXXX----------------------------XX,E,XX---
X.,.............................,.,...........,,..........,...X-X...X---------------------------X.ttt....,.X---------------------------------XX..............H.X---------------------------:X...X:---
X.,.............................,.,.<.........,,..........,...X-X...X---------------------------X.,.t....,.X--------------------------------X.,,,,,,,,,,,,,,,,,.X--------------------------XX,.EXX---
X.,.............................,.,...........,,..........,...XXX...X---------------------------X.ttt....,.X-------------------------------X.,..,,........,,..,..X-------------XXXXXXX-----:X...X:---
X.,............................,.,............,,..........,...,,,...X---------------------------X.,.......,.X------------------------------X,..,,,,......E,,,..,.X-------------X:,E,:X-----XX,..XX---
X.,...........................,.,.............,,..........,...,,,...X--------------------------X.,........,E.X----------------------------X.,.,,,,,,....,,,,,,E.,.X---------XXXX,,,,,XXXXXXXX,,,XXX--
X.,..........................,.,..............,,..........,...,,,...X-------------------------X.,.........,...XX----------------------XXXXX.,,,,,,,,,,,,,,,,,,E,,.X---------XE,.......HHX-X.......X--
X.,.........................XX,.<.............,,,.........,...XXX...X------------------------X.,..........,E...:X--------------------X,,.+,.,,,,,,,,,,,,,,,,,,,,,.X---------X,..E......H,X.......EX--
X.,.........................XX,..............,,,.,........,...X-X...X--------------------XXXX.,..........,......XX------------------X,XXXXX.,.,,,,,,....,,,,,,..,.X---------X...........,.........X--
X.,.........................,.,.............,,,,,,........,...XXX...X------------------XX,,,.,,,,,,,,,,,,.E...E.+-------------------X,X---X.,..,,,,...:..,,,,...,.X---------X,,.........,.........X--
X.,.........................,.,,,,,,,,,,,,,,,,,,,,,,,,,,,,,...,,,...X----------------XX.,,,,T,,,,,,:,,,,,.E.E...+-------------------X,X---X.,,..,,........,,E..,..X---------X,,,........,.........X--
X.,.........................,.,<,,,,,,,,,,,,,,,A,,,,,,E,,,,...,,,.E.X----------------X,,,,,,.,..........,.E...E.+-------------------X..X---X.E,.E,..E...E.,,..,..X----------X,..,.......,.........X--
X.,.........................,.,............,.,,,.,,.......,...,,,...X---------------X,,,XXXXX.,..........,...A..XX-----------------X.E.X----X..,,,,,,,,,,,,,,,..X-----------X.,.,.......,.........X--
X.,.........................,.,.............,,,,,,........,...XXX...X---------------X,,,X----X.,.........,.....:X------------------X...X-----XX................X------------X.,.,,......,.........X--
X.,.........................XX,...............,,,.........,...X-X...X---------------X,,,X-----X.,.........,E..XX--------------------XEXX-------XXXXXXXXXXXXXXXX-------------X.,.,,......,.........X--
X.,.........................XX,.<.............,,..........,...XXX...X---------------X,,,X------X.,........,..X----------------------X,X-------------------------------------X.,.,,......XXX.....XXX--
X.,..........................,.,..............,,..........,...,,,...X---------------X,,,X------X.,........,.X-----------------------X,X-------------------------------------X,..,.......XXX.....XXX--
X.,...........................,.,..:..........,,..........,...,,,...X-----------XXXXX,,.X-------X.ttt.....,.X-----------------------X,X-------------------------------------X,,,........,,,,,,,,,,X--
X.,............................,.,............,,..........,...,,,...X---------XX,,,,,,.X--------X.,.t....,.X-----------------------X...X------------------------------------X,,................,HHX--
X.,.............................,.,...........,,..........,...XXX...X-------XX.,,,,,,,.X--------X.ttt....,.X-----------------------X.H.X------------------------XXXXXXXXXXXXX...................,.X--
X.,.............................,.,...........,,..........,...X-X...X-------X,,,,,,,,.X---------X.,......,.X-----------------------X...X----------------------XX,..........,,....E...............,XXX
X.,.............................,.,...........,,..........,...X-X...X------X,,,XXXXXXX---------XE,.......,X-------------------------XXX-----------X:---------X..,..........,,.........E..........,,:X
X.,.............................,.,...........,,..........,...X-X...X------X,,,X--------------X..,......,.X---------------------------------------XXXX------X...,..........,,....................,,,X
X.,..............................,,,,,,,,,,,,,,,,,,,,,,,,,,...X-X...X------X,,,X-------------X....,,,,,,.X--------------------------------------XX,,.EX-----X...XXXXXXXXXXXXX....................,,EX
-XX,,............................,,...........................X-X...X------X.,,.XXXXXX-----XX...E.......X---------------------------------------H.,.,.X----X,,,X------------X....................,,,X
---XX,,..........................,,...........................X-X.E.X-------X..,,,,,,.X----XXXXXXXXXXXXX--XXXXX--------------------------------X..,,,..XXXXX...X------------X....................,,:X
-----X.,,........................,,...........................X-X...X--------X.,,,,,,,.X-----------------X...HXXXX-----------------------------A..,,.,.,..++...X------------X,.........,.........,XXX
------XX.,,......................,XXXXX,,,XXX,,,XXX,,,XXXXXXXXX-X...X---------XX,,,,,,,X----------------X.E.EH+.HX-----------------------------XH,.,.,.XXXXX...X------------XH,.......,.,.......,HX--
--------XX.,.....................,X---X,,,X-X,,,X-X,,,X--------X....X-----------XXXXX,,,X--------------X....EHXXXX-----------------------------X.,,...,X---X,,,X------------XHH,,,,,,,HH.,,,,,,,HHX--
----------X.,,...................,X---X,,,XXX,,,XXX,,,XXXXXXXXX....,X---------------X,,,X-----XXXXXXX-X.E.XXXXX---------------------------------XX....X----X,,,X------------XXXX,,,,,XXXXX,,,,,XXXX--
-----------XX.,,..................X---X..........................E.,,X--------------X,,,X----X.......X.,.X----------------------------------------XXXX----X,,,,,X--------------X:,E,:X---X:,E,:X-----
-------------XX.,,................X---X...........................,.,,X-------------X,,,X---X.....E...,.X---XXXXXXXXXXXXXXX--------------XXXXXXXXXXXXXXXXXX.....X--------------XXXXXXX---XXXXXXX-----
---------------X..,,..............X---X.........................,,...,.X------------X,,,X--X...........X----X--X.X--X.X--XX--------------X-X-X-X-X-X-X-X-X,.....X------------------------------------
----------------XX..,,,,,,,,,,,,,,X-XXX,,,,,,,,,,,,,,,,,,,,,,,,XX,,.,...X-----------X,,,X-X...E.E...E.E.X---X--X.X--X.X--XX--------XXXXX-XX.X.X.X.X.X.X.X.,.....XXXXX--------------------------------
------------------XX..............X-X...,,,.....................XX,,.....X----------X.,,.XX.............X---XXX...XX...XX.X--------X,:,X-X................,.....,,,.X--------------------------------
--------------------XXXXXXXXXXXXXXX-X......,,,...................XX...E...X----------X..,,,.............X---X,,,,,,,,,,,,,X------XXX,,,XXX................,.....,.E,X--------------------------------
------------------------------------X.........,,,.................XX.......X----------X.,,,E...........BX---X.............X------XE,,,,,.,................,.....,,,,X--------------------------------
------------------------------------X............,,,...............XX.......X----------XX,,.......E.E..BX---X............EX------X.,...,.,................,.....,,,.X--------------------------------
------------------------------------X...............,,,.............XX.......X-----------XX............BX---X....>>>>.....X------X.,...,.,................,.....,..,X--------------------------------
------------------------------------X..................,,,..........X-X.......X-----------X.............X---X...>....>....XXXXXXXX.,...,.,,,,,,,,,,,,,,,,.,.....,.E,X--------------------------------
------------------------------------X.....................,,,........X-X.......X-----------X...........X---XX..>......>...,......,,.....,,,.............,.,.....,,,.X--------------------------------
------------------------------------X........................,,,......X-X.......X-----------X,,,,,XXXXX----X,..>......>...,....,,,,.....,,,.............,.,.....,,,.X--------------------------------
------------------------------------X...........................,,,....X-X.......X----------X.....X--------X,..>......>...,....,,,,.....,,,.............,.,.....,.E,X--------XXXXXXXXX---------------
------------------------------------X..............................,,,..X-X.......X---------X,,,,,X--------X,..>......>...,......,,.....,,,.............,.,.....,,,,X-------X..,,...,,X--------------
------------------------------------X.................................,,,X-X.......X-------X.,,,,.X--------XX...>....>....,......,,.....,,,.............,.,.....,,,.X------X..,,,,.,,,,X-------------
------------------------------------XXXXXXXXX............................,X-X.......XXXXXXX...,..,X---------X....>>>>.....XXXXXXXX,.....,,,,,,,,,,,,,,,,,.,.....,..,X-----X.E,.,,.,E,,.,X------------
--------------------------------------------X..............................X-X.....,,.,.,.,,...,.X----------X.............X------X.,...,.,................,.....,.E,X-----X..,,,,,,,,,,,X------------
--------------------------------------------X...............................X-X...,,,.,.,.,,,...X-----------X............EX------X.,...,.,................,.....,,,.X-----X.,,,,,,,,,E,AX------------
--------------------------------------------X................................X-X.,.,,.,.,.,,.,.X------------X.............X------XE,,,,,.,................,.....XXXXX-----X,.,.E,.,.,,.,X------------
--------------------------------------XXXXXXX.................................X-X..,,.,.,.,,..X-------------XXX,,,XX,,,XX,X------XXX,,,XXX................,.....XXXXXXXXXXX,,,,,,,,,,,,,X------------
--------------------------------------X.,......................................X-X,.,.,.,.,.,X--------------X--X.X--X.X--XX--------X,:,X-X................,.....,,,......,,,,,,,,,E,,,,,X------------
--------------------------------------X.,,,,....................................X-XXXXXXXXXXX---------------X--X.X--X.X--XX--------XXXXX-XXXXXXXXXXXXXXXXX,.....,,,......,,,.,.,,.,.,,.EX------------
--------------------------------------X.....,,,,,,,,.............................X--------------------------XXX...XX...XX-X--------------XXXXXXXXXXXXXXXXX,.....,,,......,,,,,,,,,,,,,,,X------------
--------------------------------------XXXXX.........,,,,,,,.......................X-------------------------XXXXXXXXXXXXXXX--------------XXXXXXXXXXXXXXXXXX.....,,,......,,,,,,,,,,,,,,,X------------
-------------------------------------------XXXXXXXX........,,,,,,,.................X----------------------------------------------------------------------X.....XXXXXXXXXXX,.,.,,.,.,,.,X------------
---------------------------------------------------XXXXXXXX.......,,,,,,,,..........XXX-------------------------------------------------------------------XXXXXXX---------X.,,,,E,,,E,,AX------------
-----------------------------------------------------------XXXXXXXX.......,,,,,,,...,.X-----------------------------------------------------------------------------------X..,,,,,,,,,,,X------------
-------------------------------------------------------------------XXXXXXXX......,,,,.X-----------------------------------------------------------------------------------X..,E,,.,.,,.,X------------
---------------------------------------------------------------------------XXXXXXXX...X------------------------------------------------------------------------------------X..,,,,.,,,,X-------------
-----------------------------------------------------------------------------------XXXX-------------------------------------------------------------------------------------X..,,.E.,,X--------------
-----------------------------------------------------------------------------------------------------------------------------------------------------------------------------XXXXXXXXX---------------
