-------------------------------------------------------------------------------------------------------------------------------------------------------XXXXXXXXXXXXXXXXXXXXXXXXXXXXXXX---------------------------------------------------------------
-------------------------------------------------------------------------------------------------------------------------------------------------------X.............ttt.............X---------------------------------------------------------------
-------------------------------------------------------------------------------------------------------------------------------------------------------X.............tTt......:......X---------------------------------------------------------------
-------------------------------------------------------------------------------------------------------------------------------------------------------X..:....:.....ttt..:..........X---------------------------------------------------------------
-------------------------------------------------------------------------------------------------------------------------------------------------------X.........................:...X---------------------------------------------------------------
-------------------------------------------------------------------------------------------------------------------------------------------------------X.....:.XXXX,,,,,,,XXX........X---------------------------------------------------------------
-------------------------------------------------------------------------------------------------------------------------------------------------------X.......XXXX,,,,,,,XXX..:.....X---------------------------------------------------------------
----------------------------------------------------------------------------------------------------------XXXXXXXXXXXXXXXXXXXXXXXXX--------------------X.......XXE,,,,,,,,,EX........X---------------------------------------------------------------
----------------------------------------------------------------------------------------------------------X......E....E....E......X--------------------X..:....XX.,,,,,,,,,.X........X---------------------------------------------------------------
----------------------------------------------------------------------------------------------------------X,,,,,,,,,,,,,,,,,,,,,,.X--------------------X.......,,.,,.++,.,,.,....:...X---------------------------------------------------------------
----------------------------------------------------------------------------------------------------------X.:..................:,.X--------------------X.......,,.,,,,,,,,,.,........X---------------------------------------------------------------
----------------------------------------------------------------------------------------------------------X,,...,,,,,,,,,,,,,...,.X--------------------X...:...,,...........,........X---------------------------------------------------------------
----------------------------------------------------------------------------------------------------------X.,...H,,,,,,,,,,H,...,.X--------------------X.......XX...........X........X---------------------------------------------------------------
----------------------------------------------------------------------------------------------------------X,,...,,,,,,,,,,,,,...,.X--------------------XXXXX..WX:..........:XH...XXXXX---------------------------------------------------------------
----------------------------------------------------------------------------------------------------------X.,...,H,,,,,,,,H,,...,.X-------------------------XXXXXXXXX,,,XXXXXXXXX--------------------------------------------------------------------
----------------------------------------------------------------------------------------------------------X,,...,,,,.,,,.,,,,...,.X---------------------------------X+++X----------------------------------------------------------------------------
----------------------------------------------------------------------------------------------------------X.,...,H,,.,,,.,H,,...,.X----------------------------XXXXXX,,,XXXXXX-----------------------------------------------------------------------
----------------------------------------------------------------------------------------------------------X,,...,,,,.,,,.,,,,...,.X----------------------------XTX:......:XX.X-----------------------------------------------------------------------
----------------------------------------------------------------------------------------------------------X.,...,H,,,,,,,,H,,...,.X----------------------------XtXX,,,,,,,X..X-----------------------------------------------------------------------
----------------------------------------------------------------------------------------------------------X,,...,,,.......,,,...,.X----------------------------XE,,.,..,..,.EX--------------------------------------------------------------XXXXX----
----------------------------------------------------------------------------------------------------------X.,.........E.........,.X----------------------------X.,,.,..,..,..X--------------------------------------------------------------X...X----
----------------------------------------------------------------------------------------------------------X,,...................,.X----------------------------X.,,.,,,,..,..X--------------------------------------------------------------X...X----
----------------------------------------------------------------------------------------------------------X.,...................,.X----------------------------XE,,.,.:,..,.EX--------------------------------------------------------------X...X----
----------------------------------------------------------------------------------------------------------X,,...................,.X----------------------------X.,,.,,,,..,..X--------------------------------------------------------------X...X----
----------------------------------------------------------------------------------------------------------X.E..................E,.X----------------------------XE,,.,..,..,..X--------------------------------------------------------------X...X----
----------------------------------------------------------------------------------------------------------XXXXXXXXXXX,,,XXXXXXXXX+X----------------------------X.,,,,,,,,,,.EX--------------------------------------------------------------X...X----
--------------------------------------------------------------------------------------------------------------------X+++X-------X+X----------------------------X.XX.......X..X--------------------------------------------------------------X...X----
--------------------------------------------------------------------------------------------------------------------X,,,X---XXXXX,XXXXX------------------------XXXX.......XXXX----XXXXXXXXX-------------------------------------------------X...X----
--------------------------------------------------------------------------------------------------------------------X...X---X:......:,X------------------------XX-X.......X-------X,,,H,,AX-------------------------------------------------X...X----
-------------------------------------------------------------------------------------------------------------------XX,,,XX--X,.......,X------------------------XXXX...E...X-------:......,X-------------------------------------------------X...X----
-------------------------------------------------------------------------------------------------------------------X,,.,,X--H,.......HX------------------------XH,,.......X-------X....E.,X-------------------------------------------------X...X----
-------------------------------------------------------------------------------------------------------------------A,,:,AX--X,.......,X------------------------XXXH......HX-------X......,X-------------------------------------------------X...X----
-------------------------------------------------------------------------------------------------------------------X,,.,,X--H,.E...E.HX---------------------------XXX,,,XXX-------X......,X-------------------------------------------------X...X----
-------------------------------------------------------------------------------------------------------------------XX,,,XX--X,.......,X-----------------------------X+++X---------X......HX-------------------------------------------------X...X----
--------------------------------------------------------------------------------------------------------------------X,,,X---X,,H,H,H,,X-----------------------------X+++X---------X......,X-----------------XXXXXXXXXXXXXXXXX---------------X...X----
------------------------------------------------------------------------------------------XXXXXXXXXXXXXXXXXXXXXX----X+++X---XXXXXXXXXXX-----------------------XXXXXXX,,,XXXXXXX---X......,X---------XXXXXXXXX,,,,,,,,,,,,,,,XXXXXXXXX-XXXXXXX,,,XXXXX
------------------------------------------------------------------------------------------H..,.,...............X----X++++---------------XXXXXXXXXXX-----------XE.............:XXXXX......,X---------:.....,.,.,.,.,.,.,.,.,.,.,....:X-XB....,...,..:X
------------------------------------------------------------------------------------------X.,.,........:.......XXXXXX,,,XXXXX---------XX.........,X-----------X,,,,,,,,,,,,,,.,+,.......:,X---------X.....,.,.,.,.,.,.,.,.,.,.,.....X-X...:.,...,...X
------------------------------------XXXXXXXXX---------------------------------------------X,.,.....:.......:...X:..........:X-------XX..H....E.:.,X-----------:............A,.XXXXXXXXXXXXX---------X.....,.,.,.,.,.,.,.,.,.,.,.....X-XB....,...,...X
--XXXXXXXXXXXXXXXXXXXXXXX-----------:...E..:X---------------------------------------------X.,.................HXX...........XXXXXXXX.............,X-----------X.,,,,,,,..,,.,.X---------------------X.....,.,.,.,.,.,.,.,.,.,.,.....X-X.....,...,...X
---X...................X------------X,,,,,,,X---------------------------------------------X,.:.....XXXX,,,,,XXXXX......E.E..+,...E.....XXXXX,,,,,XX-----------X.,.....,..,,.,.X---------------------X.....,.,.,.,.,.,.,.,.,.,.,.....X-XB....,...,...X
---X...:...:.....:.....X----------XXX,,,,,,,XXX-------------------------------------------X.......,.XXX,,,,,XXXXX...........XXXXXXXXXXX---XX,,,,,XX-----------X.,,,,,,,..,,.,.XX-XXXXXXXXXXXXXXXXX--X.....XXXXXXXXXXXXXXXXXXXXX.....XXX.....,...,...X
----X.................X----------X.............X------------------------------------------X......,.,.........,+,,....E......X------------X.........X----------X..........,,.,.,X-X...............X--X.....X-------------------XE.E.E,.,....:,...,...X
----X.....:...........X---------X.....E...E.....X-----------------------------------------X.....,.,..........,+,,...........X-----------X...........X--------XX.E.....E..,,.,.,X-X...............X--X.....X-XXXXXXXXXXXXXXXXXXX.....,.,.....,...,...X
-----X........:....:.X---------X.................X--------------------XXXXXXXXX-----------X.:..X.,...........,+,,..E........X----------X.............X-------X,.............,.,X-X...............X--X.....X-:....,,,,,,,...:XX,.....,.,.....,...,...X
-----X...............X--------X...................X---------------XXXXX:,A,H,AXXXXX-------X....XX.......XXXXXXXXX..,,,,,,,..X---------X...........E...X------XX.,,,......,,,,.XX-X...............X--X.....XXX....,.....,....XH,.....,.,.:...,...,...X
------XXX,,,XXX,,,XXX--------X.....................X--------------:..............:X-------X....XX......X--------X..,,,,,H,..X--------X.................X------X.,.,E.....H,,,.X--X...............X--XE.E.E,.,.<..,,,,,,,....XX,.....,.,.....,...,...X
------XXX,,,XXX,,,XXX-------X.......,,,,,,,,,.......X-------------X.,,,,,,,,,,,,,.X-------X....XX.E...X---------X..,,...,,..X-------X.......,,A,,.......X-----X.,.,......,,,,.X--X...............X--X.....,.,...,,,,,,,,,...XXX.....,.,.....,...,...X
-----X...............X-----X........,.,.,.,.,........X------------X.,...........,.X-------X....,,....X----------X..,,...,,..X------X.......,.,,,.,.......X----X.,.,.........,.X--XXXX,,,,,,,,,,XXX--X.....,.,...,.......,...X-X.....,.,.....,...,...X
XX--X...,,,,,,,,,,,...XXXXX.........,,,,,,,,,.........XXXXXXXXXXXXX.,...........,.XXXXX---X....,,...X--XXXXXXXXXX..,,...,,..XXXXXXX.......,.,...,.,.......XXXXX.,.,.,,,,,,,,,.XXXXXXX,,,,,,,,,,XXXXXX.....,.,...,.:,,:,.,...XXX.....,.,.....,...,,,,X
X.XXX...,.........,...,+++,.........,.,,,,,.,.............,+++,.....,...........,..tttX---X....,,,..XXXX,ttt..,+,.,,,...,,....+,..........,,.,,,.,,.........,L,.,.,.,,,,,,,,,..,+,E..............,++,.....,.,...,.,...,.,...++,.....,.,.ttt.,...,,,,X
X.,,,...,.......:.,...,+++,...E...:.,,,,K,,,,...E.........,+++,.....,...........,:.tTtX---X..:.,,,E.,..X,tTtE.,+,.,,,.W.,,....+,......E...H,.,,,.H,...E.....,L,.,.,:,,,,,,,,,W.,+,...............,++,....:,.,.<.,:,.H.,.,.<.++,.....,.,.tTt.,...,,H,X
X.XXX...,.........,...,+++,.........,.,,,,,.,.............,+++,.....,...........,..tttX---X....,,,..XXXX,ttt..,+,.,,,...,,....+,..........,,.,,,.,,.........,L,.,.,.,,,,,,,,,..,+,E..............,++,.....,.,...,.:..:,.,...++,.....,.,.ttt.,...,,,,X
XX--X...,,,,,,,,,,,...XXXXX.........,,,,,,,,,.........XXXXXXXXXXXXX.,...........,.XXXXX---X....,,...X--XXXXXXXXXX..,,...,,..XXXXXXX.......,.,...,.,.......XXXXX.,.,.,,,,,,,,,.XXXXXXX,,,,,,,,,,XXXXXX.....,.,...,.,,,,,.,...XXX.....,.,.....,...,,,,X
-----X...............X-----X........,.,.,.,.,........X------------X.,...........,.X-------X....,,....X----------X..,,...,,..X------X.......,.,,,.,.......X----X.,.,.........,.X--X...............X--X.....,.,...,.......,...X-X.....,.,.....,...,...X
------XXX,,,XXX,,,XXX-------X.......,,,,,,,,,.......X-------------X.,,,,,,,,,,,,,.X-------X:...XX.E...X---------X..,,...,,..X-------X.......,,A,,.......X-----X.,.,......,,,,.X--X...............X--X.....,.,...,,,,,,,,,...XXX.....,.,.....,...,...X
------XXX,,,XXX,,,XXX--------X.....................X--------------:..............:X-------X....XX......X--------X..,,,,,H,..X--------X.................X------X.,.,E.....H,,,.X--X...............X--XE.E.E,.,.<..,,,,,,,....XX,.....,.,.....,...,...X
-----X...............X--------X.......E...E.......X---------------XXXXX:,A,H,AXXXXX-------X....XX.......XXXXXXXXX..,,,,,,,..X---------X...........E...X------XX.,,,......,,,,.XX-X...............X--X.....XXX....,,,,,,,....XH,.....,.,.:...,...,...X
-----X.:.....:...:...X---------X.................X--------------------XXXXXXXXX-----------X....X.,...........,+,,..E........X----------X.............X-------X,.............,.,X-X...............X--X.....X-:....,,,,,,,...:XX,.....,.,.....,...,...X
----X.................X---------X...............X-----------------------------------------X.....,.,..........,+,,...........X-----------X...........X--------XX.E.....E..,,.,.,X-X...............X--X.....X-XXXXXXXXXXXXXXXXXXX.....,.,.....,...,...X
----X..........:......X----------X.............X------------------------------------------X......,.,.........,+,,....E......X------------X.........X----------X..........,,.,.,X-X...............X--X.....X-------------------XE.E.E,.,....:,...,...X
---X......:........:...X----------XXX,,,,,,,XXX-------------------------------------------X.......,.XXX,,,,,XXXXX...........XXXXXXXXXXX---XX,,,,,XX-----------X.,,,,,,,..,,.,.XX-XXXXXXXXXXXXXXXXX--X.....XXXXXXXXXXXXXXXXXXXXX.....XXX.....,...,...X
---X...................X------------X,,,,,,,X---------------------------------------------X,..:....XXXX,,,,,XXXXX......E.E..+,...E.....XXXXX,,,,,XX-----------X.,.....,..,,.,.X---------------------X.....,.,.,.,.,.,.,.,.,.,.,.....X-XB....,...,...X
--XXXXXXXXXXXXXXXXXXXXXXX-----------:...E..:X---------------------------------------------X.,.............:...HXX...........XXXXXXXX....H........,X-----------X.,,,,,,,..,,A,.X---------------------X.....,.,.,.,.,.,.,.,.,.,.,.....X-X.....,...,...X
------------------------------------XXXXXXXXX---------------------------------------------X,.,...:.....:.......X:..........:X-------XX.......E.:.,X-----------:.............,.XXXXXXXXXXXXX---------X.....,.,.,.,.,.,.,.,.,.,.,.....X-XB....,...,...X
------------------------------------------------------------------------------------------X.,.,................XXXXXX,,,XXXXX---------XX.........,X-----------X,,,,,,,,,,,,,,.,+,.......:,X---------X.....,.,.,.,.,.,.,.,.,.,.,.....X-X...:.,...,...X
------------------------------------------------------------------------------------------H..,.,...............X----X+++X---------------XXXXXXXXXXX-----------XE.............:XXXXX......,X---------:.....,.,.,.,.,.,.,.,.,.,.,....:X-XB....,...,..:X
------------------------------------------------------------------------------------------XXXXXXXXXXXXXXXXXXXXXX----X...X-------------------------------------XXXXXXX,,,XXXXXXX---X......,X---------XXXXXXXXX,,,,,,,,,,,,,,,XXXXXXXXX-XXXXXXX,,,XXXXX
--------------------------------------------------------------------------------------------------------------------X...X-------------------------------------------X+++X---------X......,X-----------------XXXXXXXXXXXXXXXXX---------------X...X----
----------------------------------------------------------------------------------------------------------------XXXXX,,,XXXXX-------------------------------------XXX,,,XXX-------X......HX-------------------------------------------------X...X----
----------------------------------------------------------------------------------------------------------------X...........X-------------------------------------:......:X-------X......,X-------------------------------------------------X...X----
----------------------------------------------------------------------------------------------------------------X.....,,,...X-----------------------------------XXX.......XX------X......,X-------------------------------------------------X...X----
----------------------------------------------------------------------------------------------------------------X.....,.,...X-----------------------------------X.,.......,X------X....E.,X-------------------------------------------------X...X----
--------------------------------------------------------------------------------------------XXXXXXXXXXXXXXXXXXXXX.,,,.,,,...XX----------------------------------X.,.,,,,,.,X------:......,X-------------------------------------------------X...X----
--------------------------------------------------------------------------------------------X...............,+..,.,.,.......,X----------------------------------X.,.,...,.,X------X,,,H,,AX-------------------------------------------------X...X----
--------------------------------------------------------------------------------------------X.....,,,.......,+..,.,,,...,,,.,X----------------------------------XA,.,.:.,.WX------XXXXXXXXX-------------------------------------------------X...X----
--------------------------------------------------------------------------------------------X.....,.,.......,+..,.......,.,.,X----------------------------------X.,.,...,.,X----------------------------------------------------------------X...X----
--------------------------------------------------------------------------------------------X.,,,.,,,...XXXXXXXXX...,,,.,,,.XX----------------------------------X.,.,...,.,X----------------------------------------------------------------X...X----
--------------------------------------------------------------------------------------------X.,A,.......X-------X...,.,.....X-----------------------------------X.,.,,,,,.,X----------------------------------------------------------------X...X----
--------------------------------------------------------------------------------------------X.,,,...,,,.X-------X...,,,.....X-----------------------------------XXX.......XX----------------------------------------------------------------X...X----
--------------------------------------------------------------------------------------------X.......,K,.X-------X...........X-------------------------------------:......:X-----------------------------------------------------------------X...X----
--------------------------------------------------------------------------------------------X,,.....,,,.XX------XXXXX,,,XXXXX-------------------------------------XXX,,,XXX-----------------------------------------------------------------X...X----
--------------------------------------------------------------------------------------------X.,.........,X----------XXXXX-------------------------------------------X+++X-------------------------------------------------------------------X...X----
--------------------------------------------------------------------------------------------X,,.,,,.....,X------------------------------------------------------XXXXX,,,XXXXX---------------------------------------------------------------XXXXX----
--------------------------------------------------------------------------------------------X..E,.,E...E,X------------------------------------------------------X....,,.....X------------------------------------------------------------------------
--------------------------------------------------------------------------------------------X...,,,.....,X---------------------------------------------------XXXX....,,.....XXXX---------------------------------------------------------------------
--------------------------------------------------------------------------------------------XE...E...E..,X---------------------------------------------------:.,,....,,.....,,:X---------------------------------------------------------------------
--------------------------------------------------------------------------------------------X.....,,,...,X---------------------------------------------------X.,,....,,.....,,.X---------------------------------------------------------------------
--------------------------------------------------------------------------------------------X.....,.,...,X---------------------------------------------------XE,,....,,.....,,EX---------------------------------------------------------------------
--------------------------------------------------------------------------------------------X.,,,.,,,...XX---------------------------------------------------X.,,....,,.....,,.X---------------------------------------------------------------------
--------------------------------------------------------------------------------------------X.,.,.......X----------------------------------------------------X.,,....,,.....,,.X---------------------------------------------------------------------
--------------------------------------------------------------------------------------------X.,,,.......X----------------------------------------------------XE,,....,,.....,,EX---------------------------------------------------------------------
--------------------------------------------------------------------------------------------X..........:X----------------------------------------------------X.,,....,,.....,,.X---------------------------------------------------------------------
--------------------------------------------------------------------------------------------XXXXX,,,XXXXX----------------------------------------------------X.,,....,,.....,,.X---------------------------------------------------------------------
------------------------------------------------------------------------------------------------XXXXX--------------------------------------------------------XE,,....,,.....,,EX---------------------------------------------------------------------
-------------------------------------------------------------------------------------------------------------------------------------------------------------X.,,....,,.....,,.X---------------------------------------------------------------------
-------------------------------------------------------------------------------------------------------------------------------------------------------------:.,,....,,.....,,:X---------------------------------------------------------------------
-------------------------------------------------------------------------------------------------------------------------------------------------------------XXXX....,,.....XXXX---------------------------------------------------------------------
----------------------------------------------------------------------------------------------------------------------------------------------------------------X....,,.....X------------------------------------------------------------------------
----------------------------------------------------------------------------------------------------------------------------------------------------------------XXXXX,,,XXXXX------------------------------------------------------------------------
----------------------------------------------------------------------------------------------------------------------------------------------------------------XXXXX...X----------------------------------------------------------------------------
----------------------------------------------------------------------------------------------------------------------------------------------------------------Tt.,,,K,X----------------------------------------------------------------------------
----------------------------------------------------------------------------------------------------------------------------------------------------------------XXXXX,.,X----------------------------------------------------------------------------
--------------------------------------------------------------------------------------------------------------------------------------------------------------------:XX:X----------------------------------------------------------------------------
