-------XXXXXXXXXXXXXXXXXXXXXXXXXXXXXXXXX--------------------------------------------------------------------------------------------------------
-------X...............................X--------------------------------------------------------------------------------------------------------
-----XXX...............................XXX--------------------------------------------------------------XAXHXXAXHX------------------------------
-----X..................................EX--------------------------------------------------------------X,,,XX,,,X------------------------------
-----X...................................X--------------------------------------------------------------XE.EXX...X-----------XXX----------------
-----X.,.................................X--------------------------------------------------------------X...XXE.EX-----------XEX----------------
-----X.,...................E.............X--------------------------------------------------------------XE.EXX...X-----------X.X----------------
-----X.,.................................X--------------------------------------------------------------XE.EXXE.EX-----------XEX----------------
-----X.,.....,,,,,,,,,,,,,,,,,,,,,.......X--------------------------------------------------------------X...XXE.EX-----------X.X----------------
-----X.,.....,.....E.,...,.......,.......X--------------------------------------------------------------XE.EXX...X-----------XEX----------------
-----X.......,,,,,,,,,,,,,,,,,,,,,.......X--------------------------------------------------------------XE.EXXE.EX-----------X.X----------------
-----X.......,.,...............,.,.......X--------------------------------------------------------------X...XX...X-----------XEX----------------
-----X.......,.,...............,.,.......X---------------------------------------------------------XXXXXXtttXXtttXXXXXXX-----XEX----------------
-----X.......,.,...............,.,.......X---------------------------------------------------------XE,...........E.....X-----X.X----------------
-----X.......,,,...............,,,.......X---------------------------------------------------------X,XXXXXXXXXXXXXXX...X-----XEX----------------
-----X.......,.,...............,.,.......X---------------------------------------------------------X.X-E..E--------X...X-----XtX----------------
-----X.....E.,E,.,,,,,,,,,,,,,.,E,.......X---------------------------------------------------------X,X-H..H----XXX:X+++:XX-XXX,X:X--------------
-----X.......,.,.,....E......,.,.,.......X---------------------------------------------------------X.X-X..X----X.,.......X-XE....X--------------
-----X.......,,,.,.H.......H.,.,,,......AX-:XXXXXXXX-XXXXXXXXXXXXXXX---------------------XXXX:X-XXXX,XXX..X----X.,.......XXX.....X--------------
-----X,,,,...,.,.,.+++++++++.,.,.,.......X-X.....,EX-X,..,.,....,.AX---------------------XHH..X-XH.....,..X---X..,.E.............HX-------------
XXXXXX,,,,...,.,.,.+.......+.,.,.,.......XXX....,..XXX...,.,..T..,.XXX-----------------XX:....XXX......,.EXXXX...,................HX:X----------
XH.E.,..,,...,.,.,.+...E...+.,.,.,.......,,.....,....,..,...,....,A.AX-----------------X......,,.......,..XX.....:,,,,:,,,,,.........X----------
XA...,..,,...,,,.,.+.......+.,.,,,.......,,....,.....,..,...,....,...X-----------------X.....E,,.......,..XX.....,,,,,,,,,,,,........X----------
XA.E.,..,,...,E,.,E+.E.K.E.+E,.,E,.......,.....,.....,.,..E..,...,,..X-----------------X....,,:,.......,..XX................,:.......X----------
XA...,..,,...,,,.,.+.......+.,.,,,.......,,....,.....,..,.....,..,,..X-----------------X....,,,,.......,..XX.................,,......X----------
XH.E.,..,,...,.,.,.+...E...+.,.,.,.......,,.....,....,..,.....,..,,.EX-----------------X...E,,,,.......,..XX......E...E...E...,,.....X----------
XXXXXX,,,,...,.,.,.+.......+.,.,.,.......XXX....,..XXX...,...XXX.,,XXX-----------------X....,,:,.......,..XX...E...............,.....X----------
-----X,,,,...,.,.,.+++++++++.,.,.,.......X-:.....,EX-X...,..EX-X,..X-------------------X......,,.......,.EXX.......,,,,,,,.....,.....X----------
-----X.......,,,.,.H.......H.,.,,,......AX-XXXXXXXXX-XXXXXXXXXXX,..XXX-----------------X.....E,,.......,..XX......,..,,,,,.....,.....X----------
-----X.......,.,.,....E......,.,.,.......X-------------------X.,,.E..X-----------------X......,,.......,..XX......,..,...,,....,....AX----------
-----X.....E.,E,.,,,,,,,,,,,,,.,E,.......X----------------XXXX.,,....X----------------XX......XXX......,,XXXXX...,...,.T.,,....,...XXX----------
-----X.......,.,...............,.,.......X----------------XEt,,.,....X----------------:X.....:X-XE.......X---X...,...,...,,....:..:X------------
-----X.......,,,...............,,,.......X----------------X.t,,.,...:X-----XXXXXXX-----X.XXXXXX-XXXXXX...X-XXX..,....,,,,,,....,...XXX----------
-----X.......,.,...............,.,.......X----------------XHt,,.,....X-----X..E..X-----X.X-----------X...X-X....,..........,...,.....X----------
-----X.......,.,...............,.,.......X----------------X.t,,.,....X---XXX.XXX.XXX---X.X---XXXXXXX:X,,,:XX...,...........,...,.....X----------
-----X.......,.,...............,.,.......X----------------XEt,,.,....X---X........HX---XEX---X...A........,,...,...........,...,.....X----------
-----X.......,,,,,,,,,,,,,,,,,,,,,.......X----------------XXXX.,,....XXXXX.........X---X.X-XX:.E..........,,..,.............,..,.E...X----------
-----X.......,.....E.,...,.......,.......X-------------------X.,.,.E.,..,,........AX---X.X-X..............,,.,..............,..,....:X----------
-----X.......,,,,,,,,,,,,,,,,,,,,,.......X-------------------XXX.,...,..,,.........X-:XX.XXX.............E,,.,.............,...,.....X----------
-----X...................................X---------------------X.,.E.,..,,........AX-X.....,,.........,,,,:,,..............,...:,,...X----------
-----X....................E..............X---------------------XXXXXXXXXXX.........X-A......:,.......,.,,,,,,.............,....,,,,,,X----------
-----XA..................................X-------------------------------XW.......AX-A......,,......,.,....,..............,.....,,...X----------
-----X...................................X-------------------------------XXX.....XXX-X......,,.....,.,.....,.............,......,,,,,X----------
-----X..................................EX---------------------------------X.....X---XT.....,,....,:,.....,..............,......,,...X----------
-----XXX...............................XXX-------------------------------XXX..E..XXX-X......,,...,.,.....,..............,.......,,,,,X----------
-------X...............................X---------------------------------XA.......AX-W......:,..,.,......,..............,......:,,...X----------
-------XXXXXXXXXXXXXXXXXXXXXXXXXXXXXXXXX------------------------------XXXX..,,,,,..X-A....E.,,..,,......,..............,.......,,,,,,X----------
---------------------------------------------------------------------X..,,..,...,..X-:.E...,,...,,......,..............,.......,.E...X----------
---------------------------------------------------------------------XAK,,..,.E.,..X-XXXXXXX....,,.....,..............,........,....:X----------
---------------------------------------------------------------------X..,,..,...,..X-------X....,,.....,..............,........,.....X----------
----------------------------------------------------------------------XXXX..,,,,,..X-------XXX.E,,....,..............,.........,.....X----------
-------------------------------------------------------------------------XE.......EX---------X..,,....,..............,.........,...XXX----------
-------------------------------------------------------------------------XXX..E..XXX-------:XX..,,...,..............,..:,,,,,,,:...X------------
---------------------------------------------------------------------------X.....X---------X..,,:,...,..............,..,...........XXX----------
---------------------------------------------------------------------------XXX.XXX---------X,,,,,,...,.............,...,.E..........AX----------
-----------------------------------------------------------------------------X.X-----------X..,.....,..............,...,..........E..X----------
-----------------------------------------------------------------------------X.X-----------X,,,.....,.............,....,............:X----------
-----------------------------------------------------------------------------X.X-----------X..,.....,.............,....,.....:,,,:,,,X----------
-----------------------------------------------------------------------------X.X-----------X,,,.....,.............,....,.....,,,,,,,,:XXXXAX----
-----------------------------------------------------------------------------X.X-----------X..:....,..............,....,.....,.............X----
-----------------------------------------------------------------------------X.X-----------X,,,....,.............,.....:.....,.E...........X----
-----------------------------------------------------------------------------X.X-----------X.......,.............,.....,.....,.......X..T..X----
-----------------------------------------------------------------------------X.X-----------XXX.....,.............,.....,.....,......X-X....X----
-----------------------------------------------------------------------------X,XXXXXXXXXXXXX-X....,..............,.....,.....,.....X--X...HX----
-----------------------------------------------------------------------------X.............XXX....,.............,...E..,.....,......XXXXXXXXXX--
-----------------------------------------------------------------------------X...............A....,.............,......,.....,.E....:XX.......X-
-----------------------------------------------------------------------------X.E...E..............,.............,......,.....,.......XX..E..E.X-
-----------------------------------------------------------------------------X.............XXX...,...............,.....,.....:.......L,........>
-----------------------------------------------------------------------------XXXXXXXXXXXXXXX-X...,...............,.....,.....,.......L,........>
-------------------------------------------------------------------------------------------XXX...,...............,.....,.E...,.......L,..E..E..X
-------------------------------------------------------------------------------------------X.....,................,....,.....,...E...XX........X
-------------------------------------------------------------------------------------------X......,...............,....:.....,......:XXXXXXXXXX-
-------------------------------------------------------------------------------------------X......,...............,....,.....,......X-XXXX------
-------------------------------------------------------------------------------------------X......,................,...,.....:.....X--X..X------
---------------------------------------------------------------------------------XXXXXXXXXXX......,................,...,.....,,,,...XXXA.X:X----
--------------------------------------------------------------------------------Xt......X--X.......,..............,....,.....+,,,..........X----
--------------------------------------------------------------------------------X.t....X---X.......,..............,....,.....:,,,..........X----
-------------------------------------------------------------------------------X..tt..X----X.......,.............,.....,.....,.............X----
------------------------------------------------------------------------------X.....tX-----X.......,...,,,,,....,......:,,,,,,,,,,,,,:.....X----
------------------------------------------------------------------------------X.....X------X........,..,...,...,....................<,.....X----
-----------------------------------------------------------------------------X.....X-------:,,,,:,..,..,.T.,...,.....................,.....X----
-----------------------------------------------------------------------------X....X--------X....,,..,..,...,..,......................,.....X----
-----------------------------------------------------------------------------X,,,X---:XXXXXX....,,..,..,,,,,,,......................:,.....X----
-----------------------------------------------------------------------------X.E,X---X..........,,...,..,,,,.........................,.....X----
-----------------------------------------------------------------------------X..,X---XE......E..,,...,,,.............................,.....X----
-----------------------------------------------------------------------------X..,X---X..........,,......A.A..........................,...XXX----
-----------------------------------------------------------------------------X.E,X---X..........,,...................................,..:X------
-----------------------------------------------------------------------------X..,X---X.......E..,,...................................,...XXX----
-----------------------------------------------------------------------------X.E,X---X..........:,,,,,,,,:,,,,,,,,:,.................:.....X----
-----------------------------------------------------------------------------X..,X---X............................,,.................X.....X----
-----------------------------------------------------------------------------X..,X---X...XXXXX:.E...E.............,,.............W.XXX.....X----
-----------------------------------------------------------------------------X.E,X---X..XXA.HXX...................,,..............X--X.....X----
-----------------------------------------------------------------------------X..,X---X.X-X.A.X-X..................,,...XXX.......X---X.....X----
-----------------------------------------------------------------------------X.E,X---X.X-X...X-X..................:,...X-X.....A.X---XE....X----
-----------------------------------------------------------------------------X..,X---X.X-XE.EX-X........T.........,XXXXX-XXXXXXXXX---X.....X----
-----------------------------------------------------------------------------X..,X---X..XX,,,XX....................X------XXXXX------X....EX----
-----------------------------------------------------------------------------X.E,X---X...X,,,X.....................XXXXXXXX..,XXXXXXXX.....X----
-----------------------------------------------------------------------------X..,X---X.E.E..............:.......:..,......,.E,.......,....:X----
-----------------------------------------------------------------------------X.E,X---:.......XXXXXXXXXXXXXXXXXXXXXXXXXXXXXX,,,XXXXXXXX...XXX----
-----------------------------------------------------------------------------X..,X---X......:X----------------------------XXXXX------X:..X------
-----------------------------------------------------------------------------X..,X---X.......X---------------------------------------XXXXX------
-----------------------------------------------------------------------------X.E,X---X.......X--------------------------------------------------
-----------------------------------------------------------------------------X..,X---X.......X--------------------------------------------------
-----------------------------------------------------------------------------X.E,X---X.......X--------------------------------------------------
-----------------------------------------------------------------------------X..,X---X.......X--------------------------------------------------
-----------------------------------------------------------------------------X,,,X---X.......X--------------------------------------------------
-----------------------------------------------------------------------------XXXXX---X.......X--------------------------------------------------
-------------------------------------------------------------------------------------X.......X--------------------------------------------------
-------------------------------------------------------------------------------------X.......X--------------------------------------------------
-------------------------------------------------------------------------------------X.......X--------------------------------------------------
-------------------------------------------------------------------------------------:......:X---------------------XXXXXXXXXXXXXXXXX------------
-------------------------------------------------------------------------------------X.......X--------------------X.,..,.,.,.,.,E,,X------------
-------------------------------------------------------------------------------------X.......X-------------------X.E.XXXXXXXXXXXXX,XXXXXXXXX----
-------------------------------------------------------------------------------------XXX...XXX------------------X.,.X------------XE,.......X----
---------------------------------------------------------------------------------------X...X-XXXXXXX-----------X.E.X-------------X.,.......X----
-------------------------------------------------------------------------------------XXX...XXX...,.X----------X.,.X--------------XE,......+X----
-------------------------------------------------------------------------------------X,...,.....,.,XXXXXXX---X.E.X---------------XXXXXXX.+.X----
-------------------------------------------------------------------------------------X,...,.....,.,.,...EX--X.,.X----------------------X+..X----
-------------------------------------------------------------------------------------X...,.....,.,.,.....XXX...X-----------------:XXXXXX...X----
-------------------------------------------------------------------------------------X....,....,.,.,.....,.,,.X------------------X.........X----
-------------------------------------------------------------------------------------X....,....,.,.,.....,.,.X-------------------XE........X----
-------------------------------------------------------------------------------------X,....,..,.,..,.....,.,X--------------------X.........X----
-------------------------------------------------------------------------------------X,....,..,.,..,.....XXX---------------------X.........X----
-------------------------------------------------------------------------------------X.,...,.,.,....,...EX-----------------------XE........X----
-------------------------------------------------------------------------------------XXX.EE.,,.,...XXXXXXX-----------------------X.........X----
---------------------------------------------------------------------------------------:....,.,...HX-----------------------------X.........X----
---------------------------------------------------------------------------------------XXXXXXXXXXXXX-----------------------------X.........X----
---------------------------------------------------------------------------------------------------------------------------------XA.......AX----
---------------------------------------------------------------------------------------------------------------------------------XXX.....XXX----
-----------------------------------------------------------------------------------------------------------------------------------X.....X------
---------------------------------------------------------------------------------------------------------------------------------XXX,....XXX----
---------------------------------------------------------------------------------------------------------------------------------X.,,.....,X----
---------------------------------------------------------------------------------------------------------------------------------X.,.,....,X----
---------------------------------------------------------------------------------------------------------------------------------X.,.,.....X----
---------------------------------------------------------------------------------------------------------------------------------X.,..,....X----
---------------------------------------------------------------------------------------------------------------------------------X.,..,....X----
---------------------------------------------------------------------------------------------------------------------------------X..,.,....X----
---------------------------------------------------------------------------------------------------------------------------------X..,..,...X----
---------------------------------------------------------------------------------------------------------------------------------X..,..,...X----
---------------------------------------------------------------------------------------------------------------------------------X..,...,..X----
---------------------------------------------------------------------------------------------------------------------------------XXX,...,XXX----
-----------------------------------------------------------------------------------------------------------------------------------X,....X------
---------------------------------------------------------------------------------------------------------------------------------XXX,....XXX----
---------------------------------------------------------------------------------------------------------------------------------X..,....,.X----
---------------------------------------------------------------------------------------------------------------------------------X..,.....,X----
---------------------------------------------------------------------------------------------------------------------------------X..,.....,X----
---------------------------------------------------------------------------------------------------------------------------------X..,......X----
---------------------------------------------------------------------------------------------------------------------------------X...,.....X----
---------------------------------------------------------------------------------------------------------------------------------X...,.....X----
---------------------------------------------------------------------------------------------------------------------------------X...,.....X----
---------------------------------------------------------------------------------------------------------------------------------X...,....,X----
---------------------------------------------------------------------------------------------------------------------------------X...,....,X----
---------------------------------------------------------------------------------------------------------------------------------XXX,,,,,XXX----
-----------------------------------------------------------------------------------------------------------------------------------X.....X------
---------------------------------------------------------------------------------------------------------------------------------XXX.....XXX----
---------------------------------------------------------------------------------------------------------------------------------X.........X----
---------------------------------------------------------------------------------------------------------------------------------X.........X----
---------------------------------------------------------------------------------------------------------------------------------X.........X----
---------------------------------------------------------------------------------------------------------------------------------X..E...E..X----
---------------------------------------------------------------------------------------------------------------------------------X.........X----
---------------------------------------------------------------------------------------------------------------------------------X.........X----
---------------------------------------------------------------------------------------------------------------------------------X..,,,,...X----
---------------------------------------------------------------------------------------------------------------------------------X.A,,,,.A.X----
---------------------------------------------------------------------------------------------------------------------------------X..,,E,...X----
---------------------------------------------------------------------------------------------------------------------------------XXX,,,,.XXX----
-----------------------------------------------------------------------------------------------------------------------------------X.,K..X------
-----------------------------------------------------------------------------------------------------------------------------------XXXXXXX------
