------------XXXLLXX------------------------------------------------------------------------------------------------
------------X:,.,:X------------------------------------------------------------------------------------------------
------------X.,.,.X------------------------------------------------------------------------------------------------
------------X.,E,.X------------------------------------------------------------------------------------------------
------------X.,.,.X------------------------------------------------------------------------------------------------
------------X.,.,.X------------------------------------------------------------------------------------------------
------------X.,.,.X------------------------------------------------------------------------------------------------
------------X.,.,.X------------------------------------------------------------------------------------------------
------------X.,.,.X-------------XXXXX------------------------------------------------------------------------------
------------X.,.,.X-------------XE.EX------------------------------------------------------------------------------
----------XXX,,,,,XXX-----------X...X-----XXXXXXX------------------------------------------------------------------
----------X........,X-----------X,,,X-----XE.E.EX------------------------------------------------------------------
XXXXXXXXXXX.,,,,,,,,XXXXXXXXXXX-X,,,XXXXXXX,,,,,X---XXXXX----------------------------------------------------------
X:.......<,.,..:..,,,:...+...:X-XH.....H,.......X---XH,.X----------------------------------------------------------
X,,,,,,,,,,.,.,,,.,,,....+..A.XXX......H,.......XXX-XXX.X-----------------XXX--------------------------------------
X........<,.,:,K,:,,,..E.+..H.,,.A......,.......,EX---X.X-----------------X.X--------------------------------------
X,,,,,,,,,,.,.,,,.,,,....+....XXX......H,.......XXX---X.X-----------------XHXXXXXXX--------------------------------
X:.......<,.,..:..,,,:...+E..:X-XA..XXXXXXX....:X-----X+X-----------------X,,......X-------------------------------
XXXXXXXXXXX.,,,,,,,,XXXXXXXXXXX-X...XXXXXXX.....XXXXXXX,XXX-----------XXXXX,,..,,,,.XXXXX--------------------------
----------X........,X-----------X.......E.X.....,,,,,,E.,AX-----------X...+A,..,,E,.,..EX--------------------------
----------XXX,,,,,XXX-----------X++++.....L.....,,,,,,,.,.XXXXXXXXXXXXX...+.,..,,,,.,...XXXXXXX-XXX----------------
------------X.,.,.X-------------X...+...E.X:....,,,,,,.A,.+...,E..,.++,..H+A,..,,E,.,.......A.X-XWX----------------
------------X.,.,.X-------------X+++XXXXXXXXXXXXXXXXXXX.,.XXXXX.XXXXXXX...+.,..,,,,.,...XXXXX+X-X,XXX--------------
------------X.,.,.X-------------X...X-----------------XLLLX---X.X-----X...+A,..,,E,.,..EX---X+X-B..EX--------------
------------X.,.,.X-------------XB..X-XXXXXXXXXXX-XXXXXLLLXXX-X,X-----XXXXX,,..,,,,.XXXXX-XEX,XXX...XXXXXXXXXXXXXXX
------------X.,.,.X-------------X.B.X-X,,,,A.A.AX-X.........X-X,X---------XH.......X------X....E...E,A,...........X
------------X.,.,.X-------------B...X-X...,.XXX.XXX.+++++...X-X,X---------XXXXXXXXX-------X....B....XXX,,,,,,,,,,.X
------------X.,E,.X-------------X...X-X,,,,.X-X.,,,.+...+...X-X,X-------------------------:.....B..:X-X......E.E,.X
------------X.,.,.X-------------X...X-X,,,..X-XE,,,.+...+...X-X,X----XXXXX----------------XXXXX,XXXXX-X,,,,,,,,.,.X
------------X:,.,:X-------------X...X-X,.,..X-X.,,,.+...+...X-X,X----X...X--------------------XEX-----X......H,E,.X
------------XXXXXXX-------------X..:XXX,,,..XXX.,,,.+...+...X-X,X-XXXX,,,XXXX-----------------X.X-----X.,,,,,,,E,.X
--------------------------------X...,A,..<......,,,.+...+...X-X.X-X..,...,..X-----------------X.X-----X.,A.A,.,.,.X
--------------------------------X...,A,.........XXX.+++++.,.>-X.XXX..,..E,E.X---------XXX-----X,X-----X.,...,.,A,.X
--------------------------------X...,A,.,,,,,...X-X.......,.>-XE++,..,...,..X---------X.X-----X.X-----X.,.E.,K,.,.X
--------------------------------X..:XXX.,...,...X-XXXXXXXXXX>-X,XXX..,..E,E.X-XXXXXXXXXtXXX---X,X-----X.,...,,,E,.X
--------------------------------X...X-X.,...,E..X-------------X.X-X..,...,..X-XA,,,,,,,.,AX---X.X-----X.,...EE..,.X
--------------------------------X...X-X.,,,,,..EXXXXXXXXXXXXXXXEX-X..,...,..X-X,,,,,,,,.,.XXXXX.X-----X.,,,,,,,,,.X
--------------------------------X.A.X-X.........,.,..........E,.X-X..,...,W.X-X,,.......,.++,..HX-----X...........X
--------------------------------X,,,X-XXX+++XXXXXXX,,,,,,,,,,.XXX-X..,...,..X-X,,.X,,XX.,.XXXXXXX-----XXXXXXXXXXXXX
--------------------------------X,,,X---X..HX------X.E,E,E,,,..X--X..,...,..X-X.,.,...,.,.X------------------------
--------------------------------X,,,X---X.E.X-------XXX,XXXXX...XXX..,...,E.X-X.,.,.E.,.,.X------------------------
--------------------------------X,,,X---X...X---------X.X----X..++,.A,...,..X-X.,.X..XX.,.X------------------------
--------------------------------X,,,X---X.,,XXXXXXXXXXX.X-----XXXXX..,...,..X-X.,.X,,XX.,.X------------------------
--------------------------------X,,,X---X.,.,..A.A..,++.X---------X.A,...,..X-X.,.......,.X------------------------
--------------------------------X,,,X---XXXXXXXXXXXXXXX.X-XXXXXXX-X..,...,E.XXX.,...E...,.X------------------------
--------------------------------X,,,X-----------------X.X-X.,E,.X-X..,...,TA++,.,.......,.X------------------------
--------------------------------X,,,X---------XXX-----X.X-X.,,,BX-X..,...,..XXX.,.....E.,.X------------------------
--------------------------------X...X---------X.X-----X.X-XA.H.AX-X..,..E,.AX-X.,.......,.X------------------------
--------------------------------X...XXXXXXXXXXX,XXXXXXX.X-X,,,,,X-XXXX,,,XX,X-X,,.X,,XX.,.X------------------------
--------------------------------XE.A,,,,,.....,.,...,A+.X-X.....X----X...XX.X-X,,.,...,.,.X------------------------
--------------------------------XXXXXXXXX...A.,.,...XXXXX-XXX,XXX----XXXXXX,X-X,,.,.E.,.,.X------------------------
----------------------------------------X.....,.,...X-------X,X-----------X.X-X,,.X..XX.,.X------------------------
--------------------------------------XXX,,,,,,.,...X-------X,X---XXXXX---X.X-X,,.X,,XX.,.X------------------------
--------------------------------------X.,.E....H,..EX-------X,X---XT..X---X.X-X,,.......,.X------------------------
--------------------------------------XXX,,,,,,,,...X-------X,X---XXX.X---X.X-X,,.,,,,,,,.X------------------------
----------------------------------------X...........X-------X,X-----X.X---X.X-X,,.,T......X------------------------
----------------------------------------X...........XXXXXXXXX,X-----XAX-XXX.X-XXXtXXXXXXX,X------------------------
----------------------------------------XE.XX.E.X...,,,,,,,...X-----X.X-XE,.X---X.X-----X:X------------------------
----------------------------------------XXXXX,,,XXXXXXXXXXX.A.XXXXXXX,XXX,,.XXX-XXX-----X.X------------------------
--------------------------------------------X...X---------X...,...++,H......,EX---------XEX------------------------
--------------------------------------XXXXXXXA.AXXXXXXX---X,,,XXXXXXX,XXXXX,XXX---------X.X------------------------
--------------------------------------X....E,...,.E..AX---XK.EX-----X.X---XEX-----------X.X------------------------
--------------------------------------X.,,,,,...,,,,,.XXXXX...X-----X.X---X,XXXXXXXXXXXXX.X------------------------
--------------------------------------X.,B..........,.,.,.,E..X-----X.X---X.,.,.,.,.,.,.,TX------------------------
--------------------------------------X.,....E......,EXXXXXXXXX-----X.X---XXXXXXXXXXXXXXXXX------------------------
--------------------------------------X.,...........,.X-------------X.X--------------------------------------------
--------------------------------------X.,..E...E....,AX-------------X.X--------------------------------------------
--------------------------------------X.,...........,.X-------------X.X--------------------------------------------
--------------------------------------X.,...ttt,,,.B,.X-------------X.X--------------------------------------------
--------------------------------------X.,...t.t,,,.B,.X-------------X.X--------------------------------------------
--------------------------------------X.,.E.ttt,,,..,.X-------------X.X--------------------------------------------
--------------------------------------X.,...........,.X-------------X.X--------------------------------------------
--------------------------------------X.,,,,,,,,,,,,,.XXXXXXXXXXXXXXX.X--------------------------------------------
--------------------------------------X.....E..E....E.,.,.,.,.,.,.,...X--------------------------------------------
--------------------------------------XXXXXXXXXXXXXXXXXXXXXXXXXXXXXXXXX--------------------------------------------
