------------------------------------------------>>X----------------------------------------------------------
-----------------------------------------------X...X---------------------------------------------------------
----------------------------------------------X:.:..X--------------------------------------------------------
----------------------------------------------X..:..X--------------------------------------------------------
----------------------------------------------X.....X--------------------------------------------------------
-----------------------------------------------X...X---------------------------------------------------------
-----------------------------------------------X.:.X---------------------------------------------------------
-----------------------------------------------X...X---------------------------------------------------------
-----------------------------------------------X...X---------------------------------------------XXXXXXXXXXXX
------------------------------------------------X.X----------------------XXXXXXXXXXXXXXXXXXXXXXXX...........X
------------------------------------------------X.X---------XXXXXXXXXXXXX,,,,,,,,,,,,,,,,,,,,,,,,,,,,,,,,,,.X
------------------------------------------------XLX---------X.............................................,.X
------------------------------------------------XLX---------X.............................................,.X
------------------------------------------------X.X---------X.............................................,.X
XXXXXXXXXXXXXXXXXXXXXXXXXXXXXXXXXXXXXXXXXXXXXXXXX,XXXXXX-XXXX,,,,,,,,,,,,,,,,,,,,,,,,,,,,,,,,,,,,,,,,,,,..,.X
XH..............,..............,...................XX..X-X.,.....,,,.....E..,,,..,,,......,,,........W.,..,.X
X...,,,,,,,,,..,.,........E...,.,......H.....:.....XXH.XXX,,.,,,.,.,...,,,..,.,..,.,.,,,..,.,.,E,.,,,..,..,.X
X...,.......,.,.,.,...:......,.,.,........E...,....XX....,...,.,.,,,:..,.,..,,,..,,,.,.,..,,,.,.,.,.,..,..,.X
X...,.XXXXX.,..,:,............,:,............,.,...XX.:..,...,,,,,,....,,,.E...,,,,,,,,,,,,E..,,,.,,,..,..,.X
X...,.X---X.,.,.,.,..........,.,.,..........,.,.,..XX....,......,.,............,.,,.,...,.,........,,,.,..,.X
X.E.,.X---X.,..,.,............,.,.,,,,,,,,,..,:,...XX....,......,,,..,,,..,,,..,,,,,,...:,,,,,.,,,.,.,.,..,.X
X...,.X---X.,...,...,,,,,,,,,..,..,.......,.,.,.,..XX....,..,,,......,.,..,.,..E......E....,.,.,.,.,,,.,..,.X
X...,.XXXXX.,.......,.......,.....,.XXXXX.,..,.,...XX.E..,..,.,......,,,..,,,.....H........,,,.,:,.,,,.,..,.X
X...,.......,.......,.XXXXX.,.....,.X---X.,...,....XX+++XX..,,,...,,,...E.....,,,............E.....,.,.,..,.X
X...,,,,,,,,,....H..,.X---X.,.....,.X---X.,........XX+++XX,.......,.,.....,,,.,.,...,,,.,,,........,,,.,..,.X
X................E..,.X---X.,..H..,.X---X.,.H......XX...XX.,...,,,:,,.....,.,.,,,,,.:.,.,.,.,,,.E......,..,.X
X...:...............,.X---X.,.....,.XXXXX.,....XXXXXX...XXXXX..,.,........,,,...,.,.,,,.,,,.,.,...,,,..,..,.X
X.......,,,,,,,,,...,.XXXXX.,.:...,.......,....XXXXXX...XXXXXX.,,,...,,,....,,,.,,,...,,,...,,,...,.,..,..,.X
X.......,.......,...,.......,.....,,,,,,,,,....XX............XX......,.,....,.,.......,.,,,,....,,,,,..,..,.X
X.......,.XXXXX.,...,,,,,,,,,........,.,.......XX.............XX.....,,,....,,,..:....,,,,.,....,.,.,,,,..,.X
X...,...,.X---X.,...................,.,.,......XX...:.........,XX.,,,...,,,..............,,,,,,.,,,.,.,,..,.X
X..,.,..,.X---X.,...............E....,:,.......XX.E......E.,,,.XX.,.,...,.,..,,,.,,,........,.,.....,,,,..,.X
X.,.,.,.,.X---X.,.........,.........,.,.,..:...XX.......,,,....XX.,,,.E.,,,..,.,.,.,..,,,...,,,E.......,..,.X
X..,:,..,.XXXXX.,........,.,.........,.,.......XX....,,,.....,,XX............,,,.,,,..,.,..........,,,.,..,.X
X.,.,.,.,.......,.......,.,.,.........,........XX.,,,......,,..XX.....................,,,...,,,....,.,.,..,.X
X..,.,..,,,,,,,,,........,:,......,,,,,,,,,....XX,.......,,....XXXX,,,,,,,,,,,XXXXXX........,.,.,,,,,,.,..,.X
X...,..............:....,.,.,.H...,.......,....XX......,,......XXXX,,,,,,,,,,,XXXXX-XXX.....,,,.,.,....,..,.X
X............H...........,.,......,.XXXXX.,....XX,,..,,........++....:..,.,.,.,.,E.XXXX..,,,....,,,..H.,..,.X
X.........E....E.....E....,.......,.X---X.,....XX..,,....:.....++.H.....,.,.,.,.,...,XX..,.,.,,,.......,..,.X
X....:............................,.X---X.,....XX,,..,,........++...E...,.,.,.,.,..,.XX..,,,.,.,..,,,..,..,.X
X................,.....,,,,,,,,,..,.X---X.,....XX......,,......XXXXXXXXXXXXXXXXXX.,.H.XX.....,,,..,:,..,..,.X
X...............,:,....,.......,..,.XXXXX.,....XX,.......,,E...X-----------------X....XX..,,,.....,,,E.,..,.X
X....,,,,,,,,,.,.,.,...,.XXXXX.,..,.......,....XX.,,,......,,..X------------------X,,,XX..,.,..,,,.....,..,.X
X....,.......,..,:,....,.X---X.,..,,,,,,,,,....XX....,,,.....,,X------------------E...XX..,,,..,.,.....,..,.X
X....,.XXXXX.,.,.,.,...,.X---X.,.......,.......XX...E...,,,....X----XXXXXXX-------X,,,XX.......,,,,,,..,..,.X
X.H..,.X---X.,..,.,....,.X---X.,......,.,......XX.....H....,,,.X---X...<...X------X...XX..........,.,..,..,.X
X....,.X---X.,...,.....,.XXXXX.,.....,.,.,.:...XX.............,X--X.........X-----X,,,XX,,,...,,,.,,,E.,..,.X
X....,.X---X.,.........,.......,......,:,......XX.............X---X,,..W....X-----X...XX,.,...,.,......,..,.X
X....,.XXXXX.,...E.....,,,,,,,,,.....,.,.,.....XX............X----X..,......X-----X,:,XX,,,...,:,......,..,.X
X....,.......,...................E....,.,......XXXXXX,,,XXXXX-----X...,,....X-----X...XX..........,,,..,..,.X
X....,,,,,,,,,...............H.........,.......XXXXXX,,,XXXXXXXXX-X.....,...X-----X,,,XX,,,,,,,,,.,.,..,..,.X
X...........................................H......XX...XX..,.,.X-X......,..X-----X...XX,.,,.,,.,.,,,..,..,.X
X..E.........:.....,,,,,,,,,.......................XXLLLXX.,.,.,X-X.......,,X-----X,,,XX,,,,,,,,,......,..,.X
X..................,.......,......,,,,,,,,,........XXLLLXX..,:,.X-X.:.......X-----X+++XX............,,,,..,.X
X..................,.XXXXX.,......,.......,...,....E.......,.,.,X-X.........X-----X+++XX...,,,..,,,.,.,,..,.X
X..,,,,,,,,,...,...,.X---X.,..,...,.XXXXX.,..,.,............,.,.X-X........,.X----X...XXX..,.,..,.,.,,,,..,.X
X..,.......,..,.,..,.X---X.,.,.,..,.X---X.,.,.,.,...,,,,,,,,,,..X-X......,,...XXXXX...XXXX.,,,,.,,,....,..,.X
X..,.XXXXX.,.,.,.,.,.X---X.,,.,.,.,.X---X.,..,:,....,.......,...X-X.....,....,..,..E.....XX.,.,..,,,,,,,..,.X
X..,.X---X.,..,:,..,.XXXXX.,.,:,..,.X---X.,.,.,.,...,.XXXXX.,...X-X....,....,....,........XX,,,..,.,,.,,..,.X
X..,.X---X.,.,.,.,.,.......,,.,.,.,.XXXXX.,..,.,....,.X---X.,...X-X...,.....,.....,.......XX.....,,,,,,,..,.X
X..,.X---X.,..,.,..,,,,,,,,,.,:,..,.......,...,:....,.X---X.,...X-X.,,.....,H......,...E..XX...........,..,.X
X..,.XXXXX.,...,..............,...,,,,,,,,,.........,.X---X.,...X-X,......,.......:,......XX.........W.,..,.X
X..,.......,........................................,.XXXXX.,...X-X......,..........,..:..XX...H..E....,..,.X
X..,,,,,,,,,..........H.....E.......E...........H...,.......,...X--X....,............,....XX.:.........,..,.X
XK,.........E..........................H....:.......,,,,,,,,,.W.X---X...,.........H..E,...XX........E..,..,.X
X,,.............................................................X----X.,...............,.X-X.....K.....,..,.X
XXXXXXXXXXXXXXXXXXXXXXXXXXXXXXXXXXXXXXXXXXXXXXXXXXXXXXXXXXXXXXXXX-----X+X+X+X+X+X+X+X+X+X--X,,,,,,,,,,,,..,.X
----------------------------------------------------------------------X.X.X.X.X.X.X.X.X.X--X..............,.X
----------------------------------------------------------------------X.X.X.X.X.X.X.X.X.X--X..............,.X
----------------------------------------------------------------------XHXHXHXHXHXHXAXAXHX--X..............,.X
----------------------------------------------------------------------XXXXXXXXXXXXXXXXXXX--XXXXX,,,,,,,,,,,.X
------------------------------------------------------------------------------------------------XXXXXXXX....X
--------------------------------------------------------------------------------------------------------XXXXX
