-----------------------------------------XXXXXXXXXXXXXXXXXXXXXXXXXXXXXXXXXXXXXXXXXXXXXXXXXX--------------------------------------------------------------------------------------
---------------------------------------XX,.....,...,..........,......,.....,,...........E.X--------------------------------------------------------------------------------------
--------------------------------------X..,.....,...,..........,......,.....,,.............X--------------------------------------------------------------------------------------
------------------------------------XX...,.....,...,..........,......,.....,,.............X--------------------------------------------------------------------------------------
-----------------------------------X.....,.....,...,..........,......,.....,,.............X--------------------------------------------------------------------------------------
---------------------------------XX......,...E.,...,..........,......,.....,,.............X--------------------------------------------------------------------------------------
--------------------------------X........,.....,...,..........,......,.....,,........E....X--------------------------------------------------------------------------------------
------------------------------XX.........,.....,...,..........,......,.....,,.............X--------------------------------------------------------------------------------------
-----------------------------X...........,.....,...,..........,......,.....,,.............X--------------------------------------------------------------------------------------
---------------------------XX............,.....,...,..........,......,.....,,.............X--------------------------------------------------------------------------------------
--------------------------X..............,.....,...,..........,......,.....,,.............X--------------------------------------------------------------------------------------
------------------------XX...............,.....,...,........E.,......,.....,,.............X--------------------------------------------------------------------------------------
-----------------------X.................,.....,...,..........,......,.....,,.............X--------------------------------------------------------------------------------------
---------------------XX..................,.....,...,..........,......,..E..,,.............X--------------------------------------------------------------------------------------
-------------------XX....................,..E..,...,..........,......,.....,,.............X--------------------------------------------------------------------------------------
------------------X.........E.....E......,.....,...,..........,......,.....,,.............X--------------------------------------------------------------------------------------
----------------XX.......................,.....,...,..........,......,.....,,.............X--------------------------------------------------------------------------------------
---------------X.........................,.....,...,..........,......,.....,,.....E.......X--------------------------------------------------------------------------------------
-------------XX..........................,.....,...,..........,......,.....,,.............X--------------------------------------------------------------------------------------
------------X............................,.....,...,..........,......,.....,,.............X--------------------------------------------------------------------------------------
----------XX.............................,.....,...,..........,......,.....,,.............X--------------------------------------------------------------------------------------
---------X.............E.................,.....,...,..........,......,.....,,.............X--------------------------------------------------------------------------------------
-------XX................................,.....,...,..........,......,.....,,.............X--------------------------------------------------------------------------------------
------X..................................,.....,.H.,..........,......,.....,,.............X--------------------------------------------------------------------------------------
----XX...................................,.....,...,..........,......,.....,,.............X--------------------------------------------------------------------------------------
---X.....................................,.....,...,..........,......,.....,,.............X--------------------------------------------------------------------------------------
-XX..............H...........E...........,.....,...,..........,......,.....,,.............X--------------------------------------------------------------------------------------
X........................................,.....,...,..........,......,.....,,.............X--------------------------------------------------------------------------------------
X.....................................,,,XXXX,,XXXXXXXXXXX,XXXX,,,,,,,,,,,,,,,,,,,,,,,,,,,X--------------------------------------------------------------------------------------
X.....................................,,,XXXX,,XXXXXXXXXXX,XXAX,,,,,,,,,,,,,,,,,,,,,,,,,,,X--------------------------------------------------------------------------------------
X.....................................,,.XX:,...E.X,,XX:.,...AX...........,,,,............X--------------------------------------------------------------------------------------
X.....................................,,.XX,,,,,..X,.XX,,,...,X...........,,,,..E.........X--------------------------------------------------------------------------------------
X.....................................,,.XX,,:,,..K,.XX......,,...........,,,,............X--------------------------------------------------------------------------------------
X.....................................,,.,,....,..X,.XX.A....,,...........,,,,............X--------------------------------------------------------------------------------------
X.....................................,,.,,.:..,..X,HXX..E....X............,,,,,,,,,,,,,,,X--------------------------------------------------------------------------------------
X................................E....,,.XX,,,,,..XX+XX.......X............,,.............X--------------------------------------------------------------------------------------
X.....................................,,.XX.......X..XX......,X............,,.............X--------------------------------------------------------------------------------------
X.....................................,,HXX.......X..++.,,,..,X............,,.............X--------------------------------------------------------------------------------------
X.....................................,,.XX.......+..XX.,HH..,X............,,.............X--------------------------------------------------------------------------------------
X.....................................,,.XXXX+XXXXX..XXXXXXX+XX............,,.........E...X--------------------------------------------------------------------------------------
X.......................E.............,,.XXXX+XXXXX..XA.:XXH.AX............,,.............X--------------------------------------------------------------------------------------
X.....................................,,.XXW.HXW.E+..XXX+XXXXXX............,,.....E.......X--------------------------------------------------------------------------------------
X.....................................,,.XXXXXXXXXX..XX.......X........E...,,.............X--------------------------------------------------------------------------------------
X..............................,,,,,,,,,,XXXXX,,,,X.E++......<X............,,.............X--------------------------------------------------------------------------------------
X..............................,..,,,,,..XX..X,,ET+..XX,......X............,,.............X--------------------------------------------------------------------------------------
X...........E..................,..,,,,,.EXA.AX,,,,X..XX,,,...<,H...........,:.............X--------------------------------------------------------------------------------------
X...B...........:..............,..,,,,,..XX+XXXXXXX..XX,<,....,............,,.............X--------------------------------------------------------------------------------------
X.......B......................,..,,,,,,,XX+XXXXXXX..XX,.....<,E...........,,.............X--------------------------------------------------------------------------------------
X............................:.,,,,,,,,..XX.......,..XX,,,,,,,X............,,.............X--------------------------------------------------------------------------------------
X.B..B.......................:.,,,,,.....++.......,..XX,:,,,:,X............,,.............X--------------------------------------------------------------------------------------
X........B.....................,,,,,.....++.......X..XX,,W,,,,X............,,.............X--------------------------------------------------------------------------------------
X,,,,,,,,,,,,,,,E,,,,,,,,,,,,,,,,,,,.....XX.....,:X,,XXXXXXXXXX............,,.....H.......X--------------------------------------------------------------------------------------
X..................................,.....XX,....,,X.........AAX............,,.............X--------------------------------------------------------------------------------------
X...............................,,,,.....XX:....,,X...........X........E...,,.............X--------------------------------------------------------------------------------------
X..E............................t.,B....E,,.....,,X...,,,,,.AA,............,,.............X--------------------------------------------------------------------------------------
X............E..................,,,,.....,,...W.,,X...,,,,,...,............,,.............X--------------------------------------------------------------------------------------
X...............................,T,,.....,,,....,EX...,,,,,...,............,,.............X--------------------------------------------------------------------------------------
X,,,,,,,,,,,,,,,,,,,,,,,,,,,,,,,,,,,.....,,,....,,X...,.W.,.HH,............,,.............X--------------------------------------------------------------------------------------
X..............................,,,,,.....XX,,...,,X...,,,,,...X............,,.............X--------------------------------------------------------------------------------------
X.....E........................,,,,,,,,,,XX,,,,,,,X...,,,,,.HHXB...........,,.............X--------------------------------------------------------------------------------------
X..............E...............,..,,,,,,,XX.,,,,,:X...,,,,,...X,,,,,,,,,,,,,,,,,,,,,,,,,,,X--------------------------------------------------------------------------------------
X..............................,..,,.BB..XXXX,,,XXXX++XXX,,,XXX,,,,,,,,,,,,,,,,,,,,,,,,,,,X--------------------------------------------------------------------------------------
X..............................,..,,.....,......,,,.....,.....,..,.........,,....,........X--------------------------------------------------------------------------------------
X..............................,..,,.....,......,,,.....,.....,.,..........,,,,,,,,,,,,,,,X--------------------------------------------------------------------------------------
X..............................,,,,,,,,,,,,,,,,,,,,,,,,,,,,,,,,,...........,,....,........X--------------------------------------------------------------------------------------
X.....................E........,...,.....,.......:,...........,............,,....,........X--------------------------------------------------------------------------------------
X.............................,....,.....,........,...........,............,,....,........X--------------------------------------------------------------------------------------
X.............................,....,.....,........,...........,............,,..:.,........X--------------------------------------------------------------------------------------
X............................,.....,.....,........,...........,............,,....,.E......X--------------------------------------------------------------------------------------
X............................,.....,.....,........,...........,............,,....,........X--------------------------------------------------------------------------------------
X............................,.....,.....,........,...........,............,,....,........X--------------------------------------------------------------------------------------
X...........................,......,.....,........,...........,............,,,,,,,,,,,,,,,X--------------------------------------------------------------------------------------
X...........................,......,..E..,........,...........,............,,.............X--------------------------------------------------------------------------------------
X...........................,......,.....,........,...........,.......E....,,.............X--------------------------------------------------------------------------------------
X..........................,.......,.....,........,...........,............,,.............X--------------------------------------------------------------------------------------
X...........E..............,.......,.....,....E...,...........,............,,.............X--------------------------------------------------------------------------------------
X.........................,........,.....,........,...........,............,,.............X--------------------------------------------------------------------------------------
X.........................,........,.....,........,...........,............,,.............X--------------------------------------------------------------------------------------
X.........................,........,.....,........,......E....,............,,.......H.....X--------------------------------------------------------------------------------------
X........................,.........,.....,........,...........,............,,.............X--------------------------------------------------------------------------------------
X........................,.........,.....,........,...........,............,,.............X--------------------------------------------------------------------------------------
X........................,.........,.....,........,...........,............,,.............X--------------------------------------------------------------------------------------
X.......................,..........,.....,........,...........,............,,.............X--------------------------------------------------------------------------------------
X.......................,..........,.....,........,...........,............,,.............X--------------------------------------------------------------------------------------
X......................,...........XXXXXXXXXXXXXXXXXXXXXXXXXXXXXXXXXXXXXXXXXXXXXXXXXXXXXXXX--------------------------------------------------------------------------------------
X......................,...........X---------------------------------------------------------------------------------------------------------------------------------------------
X.E....................,...........X---------------------------------------------------------------------------------------------------------------------------------------------
X.....................,............X---------------------------------------------------------------------------------------------------------------------------------------------
X.....................,............XXXXXXX---------------------------------------------------------------------------------------------------------------------------------------
XK....................,.................HX---------------------------------------------------------------------------------------------------------------------------------------
XXXX.................,..................HX---------------------------------------------------------------------------------------------------------------------------------------
----XXXXXXX..........,........XXXXXXXXXXXX---------------------------------------------------------------------------------------------------------------------------------------
-----------XXXXXX...,...XXXXXX---------------------------------------------------------------------------------------------------------------------------------------------------
-----------------XXXXXXX---------------------------------------------------------------------------------------------------------------------------------------------------------
---------------------------------------------------------------------------------------------------------------------------------------------------------------------------------
---------------------------------------------------------------------------------------------------------------------------------------------------------------------------------
---------------------------------------------------------------------------------------------------------------------------------------------------------------------------------
---------------------------------------------------------------------------------------------------------------------------------------------------------------------------------
---------------------------------------------------------------------------------------------------------------------------------------------------------------------------------
---------------------------------------------------------------------------------------------------------------------------------------------------------------------------------
---------------------------------------------------------------------------------------------------------------------------------------------------------------------------------
---------------------------------------------------------------------------------------------------------------------------------------------------------------------------------
---------------------------------------------------------------------------------------------------------------------------------------------------------------------------------
---------------------------------------------------------------------------------------------------------------------------------------------------------------------------------
---------------------------------------------------------------------------------------------------------------------------------------------------------------------------------
--------------------------------------------------------------------------------------------------------------------X------------------------------------------------------------
-------------------------------------------------------------------------------------------------------------------X,X-----------------------------------------------------------
------------------------------------------------------------------------------------------------------------------X.,.XX---------------------------------------------------------
-----------------------------------------------------------------------------------------------------------------X..,...X--------------------------------------------------------
-------------------------------------------------------------------------------XXXXXXX-------------------------XX...X....X--------------------------------------------X----------
-------------------------------------------------------------------------------X..E..X------------------------X....X-X....XX----------------------------------------XX.X---------
-------------------------------------------------------------------------------X:...:X-----------------------X....X---XX....X--------------------------------------X....X--------
-------------------------------------------------------------------------------X.E....X---------------------X....X------X....X-----------------------------------XX......X-------
----------------------------------------------------------------XXXXXXXXXXXXXXXX..:...X--------------------X...XX--------X....X---------------------------------X.....E...X------
----------------------------------------------------------------XH..AL...LL....L......X-------------------X...X-----------XX...XX------------------------------X...........X-----
----------------------------------------------------------------X..A.L...LL....L:.E...X------------------X...X--------------X....X-----------------------------X...........X-----
----------------------------------------------------------------X....L...LL....L....:.X----------------XX...X----------------X....X---------------------------X.............X----
------------------------------------------XXXXXXXX-XXXXXXXXXXXX-X...:L...LL....L......X---------------X....X------------------X....XX------------------------X..E............X---
------------------------------------------XH.X,,,X-X....E....EX-X.H..L...L,,...L.:..E.X--------------X....X--------------------XX....X-----------------------X...............X---
------------------------------------------XE.X,,.X-X..,,,,,..XX-X....L...L,,...L......XXXXXXXXXXXXXXX....X-----------------------X....XXXXXXXXXXXXXXXXXXXXXXX.................XXX
------------------------------------------X..X...XXX.,.HHH.,.X--X....L...L,,...L......,.............,..XX-------------------------X...,.....................,.................>.X
------------------------------------------X..X...LKX.,.HHH.,.X--X.H.AL...L,,...L..E:..,.............,.X----------------------------XX.,.....................,.E.......E.....E.>.X
------------------------------------------X..X,XXXXX.,,,,,,,.XX-X....L...L,,...L......,.............,X-------------------------------X,.....................,.................>.X
------------------------------------------X..X,XXXXX,,,.......X-X....L...LL....L......XXXXXXXXXXXXXXX---------------------------------XXXXXXXXXXXXXXXXXXXXXXX.................XXX
------------------------------------------X........,,.,.......X-XA.A.L...LL....L:..E..X----------------------------------------------------------------------X...............X---
------------------------------------------X........,,:,......XX-X.A.AL...LL....L......X----------------------------------------------------------------------X..E............X---
------------------------------------------X........,,.,......X--X....L...LL....L......X-----------------------------------------------------------------------X.............X----
------------------------------------------X........,,,,......X--X....XXXXXXXXXXX..E.:.X------------------------------------------------------------------------X...........X-----
------------------------------------------X........,,........XX-X....X---------X......X------------------------------------------------------------------------X...........X-----
------------------------------------------X...................X-X.....X--------X....E.X-------------------------------------------------------------------------X.....E...X------
------------------------------------------X..................XX-X.....X--------X.E....X--------------------------------------------------------------------------XX......X-------
------------------------------------------X..,,,,,,..,,,,,...X--X......X-------XXXXXXX-----------------------------------------------------------------------------X....X--------
-------------------------------------XXXXXX..,,,,,,..,,..,...X-X.......X--------------------------------------------------------------------------------------------XX.X---------
-------------------------------------X:W:XX..,,T,E,..,,..,...XXX........X---------------------------------------------------------------------------------------------X----------
-------------------------------------X,:.XX..,,,,,,..,,:.,....XX........X--------------------------------------------------------------------------------------------------------
-------------------------------------X,.:XX..,,,E,,..,,..,....XX.........X-------------------------------------------------------------------------------------------------------
-----------------------------------XXX,,,XX......,,.H,,..,...XXX.........X-------------------------------------------------------------------------------------------------------
-----------------------------------X,.:::XX......,,,,H,A,W,..X-X..........X------------------------------------------------------------------------------------------------------
-----------------------------------XE,.:.:X......,,,,,,,,,,,,XXX..........X------------------------------------------------------------------------------------------------------
-----------------------------------X,....XX......,,E..........XX........ttX------------------------------------------------------------------------------------------------------
-----------------------------------XXXXLXXX......,,.......XXX,XX........t.t------------------------------------------------------------------------------------------------------
-----------------------------------X.....XX......,,.......XXX.XX........ttX------------------------------------------------------------------------------------------------------
-----------------------------------X.....,,......,,....T..XXX.XX..T.......X------------------------------------------------------------------------------------------------------
-----------------------------------X,,,..,,......,,.......XEX.XX..........X------------------------------------------------------------------------------------------------------
-----------------------------------X,T,..,,......,,.......XXX,XX..........X------------------------------------------------------------------------------------------------------
-----------------------------------X,,,..,,...............LWX.XX.........XX------------------------------------------------------------------------------------------------------
-----------------------------------X,.t..,,...............XXX.XX......XXX--------------------------------------------------------------------------------------------------------
-----------------------------------XE,,..XX,,,,,,,,,,,,,,,XXX,XX....XX-----------------------------------------------------------------------------------------------------------
-----------------------------------XXXXXXXXAA.A.AA.A,,,.,,,,..XX.XXX-------------------------------------------------------------------------------------------------------------
------------------------------------------XXXXXXXXXXXXXXXXXXXXXXX----------------------------------------------------------------------------------------------------------------
