XXXXXXXXXXXXXXXXXXXXXXXXXXXXXXX-------------------------------------------------------------
X.........E.E.E.......,,....H.X-------------------------------------------------------------
X..,,,,,,,,,............,.....X-------------------------------------------------------------
X..,........,,,,,,,,,....,....X-------------------------------------------------------------
X...,....H....:.....,...,.....X-------------------------------------------------------------
X,E.,,,,,,,,,,,,,,,,,E..,.....X-------------------------------------------------------------
X,.................E...,......X-------------------------------------------------------------
X.,E,,,,,,,,,,,,,,,,,,,....E..X-------------------------------------------------------------
X.........,,,,,..............X--------------------------------------------------------------
X.........,,,,,..............X--------------------------------------------------------------
X.........,,,,,.........,,,..X--------------------------------------------------------------
X.........,,,,,........,,..,.X--------------------------------------------------------------
X.....................,,.,.,,X--------------------------------------------------------------
X.E.................,,,.,,,.,X--------------------------------------------------------------
X....................,.,,.,..X--------------------------------------------------------------
X....................,.,E,.,X---------------------------------------------------------------
X.....................,,,,WX----------------------------------------------------------------
X....E...................,X-----------------------------------------------------------------
X.................E......X------------------------------------------------------------------
X.......................X-------------------------------------------------------------------
X......................X----------------------------XXXX-XXXXX-XXXXXXXX---------------------
X.....................X----------------------------XA.X--X...X-XE.....X---------------------
X....................X----------------------------X...X--X.T.X-X...E.EX---------------------
X....................X---------------------------X.AHX---X...X-X......X---------------------
X....................X--------------------------X+++X----X...X-XE.XXXXX---------------------
X....................X-------XXXXX--------------X.E.X----XEE.X-X..X-------------------------
X....................X-------X...X--------------X,..,X---X...X-XE.X-------------------------
X....................X-------XAH.X--------------X,..,A---XE..X-X..XXXXX---------------------
X....................X-------X+++X--------------XEXXX,X--X..EX-X......X---------------------
X....................X-------X...X--------------X,X-XEX--X...X-XH..H.TX---------------------
X..........E.........X-------X.EHX--------------XHX-XEX--X.H.X-X..XXXXX---------------------
XXXX,XXXXX...XXXXX.E.X-------X+++X--------------X.X--XX--XE.EX-X,,X-------------------------
XXHX,XHXXX...X---X...X-------X,,,XXXXXXXXXXX----X,X--EX--X...X-X..X-------------------------
XX.X,XXXXX...X---X...X-------H......E..A..HX----XEXXXtX--XE..X-X,,XXXXX---------------------
XXHX,XXHXX,E,X---X,E,X-------X...AE..E.E.E.X----X,Xt.Xt--XtttX-X......+---------------------
XX.X,XXXXX+++XXXXX,,,X-------XA,,,,,,,,,,..X----X.E,tX---X.t.X-XE.E.E.+---------------------
XX.....XXXH.HHHHHHHHHX-------X.,H.......HE.X-XXXX+++XXXX-XXXXX-XXXX,,,+---------------------
XX.EEE.XXXHHHHH+HHHHHX-------X.,........,..X-X.........X----------X+++X---------------------
XX.....XXX.....H.....X-------XE,........,A.X-XA......A.X----------Xtt.XXX>>XX---------------
XX.EEE.XXX.AAAAAAAAAAXXXXXXXXXA,........,,,XXX.........X----------X.t.XX....X---------------
XXX,..,XXX.....+.....,...E..+,E,...........E++.........X----------XXXXXX....X---------------
X.,,E.,,.X.H..H+..H.H,E....A+,.,..........E,++....T....X---------------X.H..X---------------
XH,,E.,,KX.....+.....,..E...+,.,...........E++......<..XXXXXXXXXXXXXXXXX..XXX---------------
XXX,..,XXXAAAAAAAA.AAAXXXEXXXXE,........,,,XXX.........+..............A...X-----------------
XXE....EXXHH.H.+.....X-------XA,..,,,...,A.X-X.........+....EEA...E....E.AX-----------------
XX.....XXX..H..HHHHHHH-------X.,..,.,...,.EX-XA......A.+.EA...A.E...EA....X-----------------
XX.....XXXHHHHH+HHHHHH-------W.,H.,H,..H,..X-XXXXXXXXXXXXXXXXXXXXXXXXXXXXXX-----------------
XX.....XXX,,,XXXXX,,,X-------X.,,,,,,,,,,E.X------------------------------------------------
XX..A..XXX,,,X---X,,,X-------+...AEE.E.A...X-XXXX-XXXXXXXXXXX-------------------------------
XX..E..XXX.E.X---X.E.X-------HXXXX,,,XXXXXHX-X..X-X....E....X--------------------XXXXX------
XX.E..EXXX...X---X...X-------XXXXX,,,XXXXXXX-X.EX-X.E.....E.X--------------------X...X------
XX.....XXX...XXXXX.E.X-------X..AA.A.......X-X..X-XXX...XXX.XXXXXXXX-------------X...X------
XXXX,XXXXX.E.........X-------XH.......AAAH.X-X..X---X.E.X-X.,....ttX-------------X+++X------
X....................X-------X,,,,,,,,,,,,,XXX..X---X...X-XH,.H..t.X------------XX+++XX-----
X....................X-------X,,.,.........,+,..X-XXX...X-X.XXX..ttX-----------X..E...EX----
X....................X-------X.,,,.........,+,..X-XH....X-XXX-X....X--X-------X..E..E.E.X---
X....................X-------X,,,,.........,+,..XXX.....X-XXX-XXXXXX-X.X-----X.T..XXXX...X--
X.....................X------X.,,,.........XXX.......XXXX-XAX--------X.X----X-X.XX----X.E.X-
X.....................X------X,,,,,,,,,,,,,X-X...E...X----X.X-------X.T.X-XXtX-X-------X..X-
X.....................X------X...E.EE.E.E..X-X.......XXXXXXAX--------X.EEX.t.tX--------X.EX-
X.....................X------XXXXXXXXXXX++XX-X..XXX.........X---------XE,.EttX---------XE.X-
X.....................X----------------------XE.X-X.E...E..AX----------XE.H.X----------X.EX-
X........,,,,,,,,,....X----------------------XXXX-XXXXXXXXXXX---------Xttt.X----------XHttX-
X........,A.,H..H,....X-----------------------------------------------Xt.t.X----------Xt.tX-
X........,..,,EE.,....X----------------------------------------------X.tttX----------X.ttX--
X........,A.,,...,.....X--------------------------------------------X....X----------X-X..X--
X....,,,,X,,XH,,H,.....X-------------------------------------------X.XX.X----------X.XX.X---
X....,,,,XttXX,,,,......X-----------------------------------------X..X-X---------XX.TX-X----
X....,,,,X.tXX,,,,.......X---------------------------------------X..T.X---------X.....X-----
X....,,,,XXXXX,,,,.......X---------------------------------------X...X---------X.E...,.X----
X....,,,,XXXXX,,,,........X-------------------------------------X.E.X--------XXE....X.H.X---
X....H..H,,,,,HEH,.........X-----------------------------------X...XXXXXXXXXX.....XXX....X--
X....,E.E,,,,,...,.........X----------------------------------X..........,...E..XX---X....X-
X....,...,,,,,HE.,..........XXXXXXXXXXXXXXXXXXXXXXXXXXXXXXXXXX-XXE.....E.,.E..XX-----X..H..X
X....,H,H,,,,,,,H,...........+...H..,.E..,......,....H...,...X---X..E....,..XX--------X....X
X............................,+....E,....,E.E.E.,.HH....H,.E.X----XXXXXXXXXX----------X....X
X.............................+..H..,....,......,........,...X------------------------X....X
X..............................XXXXXXXXXXXXXXXXXXXXXXXXXXX...XXXXXXXXXXXXXXXXXXXXXXXXXX,,,,X
X....H..........................X------------------------X...,........,.........,..........X
X.............................H.X------------------------X.E.,H.E.H..E,....E.A.E,.E..E..E..X
XXXXXXXXXXXXXXXXXXXXXXXXXXXXXXXXXX-----------------------X...,........,.E.......,..........X
---------------------------------------------------------XXXXXXXXXXXXXXXXXXXXXXXXXXXXXXXXXXX
