------------XXXXXXXXXXXXXXXXX--------------------------------------------------------------------------------------------------
------------X...............X--------------------------------------------------------------------------------------------------
------------X........A......X--------------------------------------------------------------------------------------------------
------------X..A........W...X--------------------------------------------------------------------------------------------------
------------X...............X--------------------------------------------------------------------------------------------------
------------X...............X--------------------------------------------------------------------------------------------------
------------X...............X-------------------XXXXXXXXX----------------------------------------------------------------------
------------X...............X-------------------X.......X----------------------------------------------------------------------
------------X.......XXXXXXXXX-------------------X.......X----------------------------------------------------------------------
------------X....A..X---------------------------X.......X----------------------------------------------------------------------
------------X.......X---------------------------XW....<.X----------------------------------------------------------------------
------------X.......X---------------------------X.......X----------------------------------------------------------------------
------------X.......X---------------------------X.......X----------------------------------------------------------------------
------------X..A....X---------------------------X.......X----------------------------------------------------------------------
------------X.......X---------XXXXXXXXXXXXXXXXX-X,,,XXXXX----------------------------------------------------------------------
------------X.......X---------X...............X-X...X--------------------------------------------------------------------------
------------X.......X---------X...............X-X...X--------------------------------------------------------------------------
------------X.......X---------X.......W.......X-X...X--------------------------------------------------------------------------
------------XLLLLLLLX---------X...............X-X...X--------------------------------------------------------------------------
------------X.......X---------X...............X-X...X--------------------------------------------------------------------------
------------XLLLLLLLX---------X...............X-X...X--------------------------------------------------------------------------
------------X.......X---------X...............X-X...X--------------------------------------------------------------------------
------------X.......XXXXXXXXXXX...............XXX...X--------------------------------------------------------------------------
------------X.......,...............................X--------------------------------------------------------------------------
------------X.......,...............................X--------------------------------------------------------------------------
------------X.......,...............................X--------------------------------------------------------------------------
------------X.......,...............................X--------------------------------------------------------------------------
------------X.......,...............................X--------------------------------------------------------------------------
------------X.......,...............................X--------------------------------------------------------------------------
------------X.......,...............................X--------------------------------------------------------------------------
------------X.......,,,,,,,,,,,,,,,,,,,,,,,,,,,,,,,,X--------------------------------------------------------------------------
------------X........................................X-------------------------------------------------------------------------
------------X.........................................X------------------------------------------------------------------------
------------X..........................................X-----------------------------------------------------------------------
------------X...............................E...........X----------------------------------------------------------------------
------------X............................................X---------------------------------------------------------------------
------------X.............................................X--------------------------------------------------------------------
------------X..............................................X-------------------------------------------------------------------
------------X...............................................X------------------------------------------------------------------
------------X................................................X-----------------------------------------------------------------
------------X.................................:...............X----------------------------------------------------------------
------------X..................................................X---------------------------------------------------------------
------------X...................................................X--------------------------------------------------------------
------------X....................................................X-------------------------------------------------------------
------------XXXXXXXXXXXXXXXXX.....................................X------------------------------------------------------------
----------------------------X......................................X-----------------------------------------------------------
----------------------------X...............XXXXXXXXXXX,,,,.........X----------------------------------------------------------
----------------------------X...............X---------X....,,,,,,,,..X---------------------------------------------------------
----------------------------X............E..X---------X............,,,X--------------------------------------------------------
----------------------------X...............X---------X................X-------------------------------------------------------
----------------------------X...............X---------X................X-------------------------------------------------------
----------------------------X...............X---------X.................X------------------------------------------------------
----------------------------X...............X---------X.................X------------------------------------------------------
----------------------------X...............X---------X..................X-----------------------------------------------------
----------------------------X...............X---------X..................X-----------------------------------------------------
----------------------------X...............X---------X...................X----------------------------------------------------
----------------------------X...............X---------X...................X----------------------------------------------------
----------------------------X...............X---------X....................X---------------------------------------------------
----------------------------X....A.......A..X---------X....................X---------------------------------------------------
----------------------------X...............X---------X.....................X--------------------------------------------------
----------------------------X...............X---------X.....................X--------------------------------------------------
----------------------------X...............X---------X......................X-------------------------------------------------
----------------------------X...............X---------X.......................X------------------------------------------------
----------------------------X...............X---------X.......................X------------------------------------------------
----------------------------X.......K.......X---------X......E.................X-----------------------------------------------
----------------------------X...............X---------X........................X-----------------------------------------------
----------------------------X...............X---------X.........................X----------------------------------------------
----------------------------X...............X---------X.........................X----------------------------------------------
----------------------------XXXXXXXXXXXXXXXXX---------X..........................X---------------------------------------------
------------------------------------------------------X..........................X---------------------------------------------
------------------------------------------------------X...........................X--------------------------------------------
------------------------------------------------------X...........................X--------------------------------------------
--------------------------------------------X-----XXXXX............................X-------------------------------------------
------------------------------------------XXX-----X................................X-------------------------------------------
-----------------------------------------X..X-----X...........................K.....X------------------------------------------
---------------------------------------XX...X-----XA....:..........................,.X-----------------------------------------
-------------------------------------XX.....X-----X................................,.X-----------------------------------------
------------------------------------X.......X-----X...............................,...X----------------------------------------
----------XXXX--------------------XX........X-----X.................H.............,....X---------------------------------------
----------X...XXXXXX-------------X..........X-----X..............................,......X--------------------------------------
---------X..........XXX--------XX...........X-----X..............................,......X--------------------------------------
---------X............X------XX.............X-----X.............................,........X-------------------------------------
---------X............X-----X...............XXXXXXX.............................,.........X------------------------------------
--------X.............X-----X...............,.L.L.,............................,...........X-----------------------------------
--------X.............XXXXXXX...............,.L.L.,.............E.............,............X-----------------------------------
--------X.............,.L.L.,...............,.L.L.,...........................,.............X----------------------------------
-------X..............,.L.L.,...............,.L.L.,..........................,...............X---------------------------------
-------X..............,.L.L.,...............,.L.L.,..........................,...............X---------------------------------
-------X..............,.L.L.,.......K.......,.L.L.,.........................,.................X--------------------------------
------X...............,.L.L.,...............,.L.L.,.........................,..................X-------------------------------
------X...............,.L.L.,...............XXXXXXX...E....................,....................X------------------------------
------X...............,.L.L.,...............X-----X.......................,.....................X------------------------------
-----X................XXXXXXX...............X-----X.......................,......................X-----------------------------
-----X................X-----X...............X-----X......................,........................X----------------------------
-----X................X-----X...............X-----X......................,.........................X---------------------------
----X.................X-----X...............X-----X.....................,..........................X---------------------------
----X.................X-----XXX.............X-----X.....................,.........................,,X--------------------------
----X.................X--------XXXX.........X-----X.A..................,.....................,,,,,..X--------------------------
---X.................,X------------XXXX.....X-----X....................,................,,,,,.......X--------------------------
---X...............,,..XX--------------XXXX.X-----X...................,............,,,,,............X--------------------------
---X.............,,......X-----------------XX-----XXXXXXXXXXXXXXXXX..,..........X,,.................X--------------------------
--X............,,.........X---------------------------------------X..,..........XX..................X--------------------------
--X..........,,............XX-------------------------------------X.,..........X--X.................X--------------------------
--X.......,,,................X------------------------------------X.,..........X---X...............X---------------------------
-X......,,....................X-----------------------------------X,...........X----X..............X---------------------------
-X....,,.......................XX---------------------------------X,...........X-----X.............X---------------------------
-X..,,...........................X-----------------------------XXXX...........X-------X............X---------------------------
X.,,..............................X---------------------XXXXXXX...,...........X-------X,...........X---------------------------
X,.................................XX------------XXXXXXX...........,..........X-------X,...........X---------------------------
-X...................................X----XXXXXXX..................,..........X-------X.,..........X---------------------------
--X...................................XXXX..........................,........X--------X..,.........X---------------------------
---X..................................,.............................,........X-------X....,........X---------------------------
----X.................................,..............:...............,.......X-------X....,........X---------------------------
-----X...............................,...............................,......X--------X.....,.......X---------------------------
------X..............................,................................,.....X--------X......,......X---------------------------
-------X.............................,................................,.....X--------X.......,.....X---------------------------
--------X............................,.................................,....X--------X.......,....X----------------------------
---------X...........................,.................................,...X---------X........,...X----------------------------
----------X.........................,.....................E.............,..X---------X.........,..X----------------------------
-----------X........................,...................................,..X--------X...........,.X----------------------------
------------X..........E............,....................................,.X--------X...........,.X-----------------X----------
-------------X......................,....................................,X---------X............,X----------------XX----------
--------------X.....................,....................................XX---------X.............X----------------X.X---------
---------------X...................,...................................XX---------XX.............X----------------X..X---------
----------------X..................,.................................XX----------X..............X----------------X....X--------
-----------------X.................,..............................XXX----------XX..............X----------------X.....X--------
------------------X................,............................XX-----------XX...............X-----------------X......X-------
-------------------X...............,..........................XX------------X................X-----------------X.......X-------
--------------------X.............,........................XXX------------XX................X-----------------X.........X------
---------------------X............,......................XX--------------X.................X------------------X.........X------
----------------------X...........,....................XX--------------XX.................X------------------X...........X-----
-----------------------X..........,.................XXX--------------XX..................X------------------X............X-----
------------------------X.........,...............XX----------------X...................X------------------X..............X----
-------------------------X.......,..............XX------------------X..................X-------------------X..............X----
--------------------------X......,...........XXX--------------------X.................X------------------XX................X---
---------------------------X.....,.........XX-----------------------X..................X---------------XX..................X---
----------------------------X....,.......XX-------------------------X..................X------------XXX..........E..........X--
-----------------------------X...,....XXX----------------------------X..................X--------XXX........................X--
------------------------------X.,...XX-------------------------------X...................X-----XX............................X-
-------------------------------X,.XX---------------------------------X..........E........X--XXX..............................X-
--------------------------------XX-----------------------------------X....................XX.................................XX
---------------------------------------------------------------------X....................................................XXX--
---------------------------------------------------------------------X..................................................XX-----
---------------------------------------------------------------------X...............................................XXX-------
---------------------------------------------------------------------X............................................XXX----------
---------------------------------------------------------------------X..........................................XX-------------
----------------------------------------------------------------------X......................................XXX---------------
----------------------------------------------------------------------X...................................XXX------------------
----------------------------------------------------------------------X................................XXX---------------------
----------------------------------------------------------------------X..............................XX------------------------
----------------------------------------------------------------------XXX.........................XXX--------------------------
-------------------------------------------------------------------------XXXX..................XXX-----------------------------
-----------------------------------------------------------------------------XXXXX...........XX--------------------------------
----------------------------------------------------------------------------------XXXX....XXX----------------------------------
--------------------------------------------------------------------------------------XXXX-------------------------------------
