--------------------XXX----------XXX-------------------------------------------------------------------------------------------------------------------------
-------------------X,A.X--------X,,,X------------------------------------------------------------------------------------------------------------------------
------------------X,,,,.X------XA,.,AX-----------------------------------------------------------------------------------------------------------------------
------------------XA,A,AX------X,,,,,,X----------------------------------------------------------------------------------------------------------------------
------------------X,,,,,,X-----XA,.,A,X----------------------------------------------------------------------------------------------------------------------
-----------------X,.,.,..X----X,.,.,..X----------------------------------------------------------------------------------------------------------------------
-----------------X,.,.,..X----X,:,E,.:X----------------------------------------------------------------------------------------------------------------------
-----------------X,:,E,.:X----X,.,.,..X----------------------------------------------------------------------------------------------------------------------
-----------------X,.,.,..X----X,.,.,.AX----------------------------------------------------------------------------------------------------------------------
-----------------X,.,.,..X-----XA,,,,,X----------------------------------------------------------------------------------------------------------------------
------------------X,,,,,,X-----X.,.E.,X-----XXX--------------------------------------------------------------------------------------------------------------
------------------X,,.,.X------X,,,,.X-----X.A,X-------------------------------------------------------------------------------------------------------------
-------------------X,,,,X-------X...,X----X.,,,,X------------------------------------------------------------------------------------------------------------
------------------XXX,,XXX-----XXX,,XXX---X.,.,,X----------------XXX-----------------------------------------------------------------------------------------
-----------------X,,...,.,XX--X,,....,,XXX,,,,,,X--------------XXX,XX----------------------------------------------------------------------------------------
----------------X.H.....,..,XX.,.E...,..,X..,.,.,X-------------X,AAAX-------------------------------------------------XXX------------------------------------
---------------X,,,,,,,,,,,.,,,,,,,,,,,,.,,,,.,,,X-------------X,AAAX-------------------------------------------------X,X------------------------------------
---------------XA.,.E.E.,.,.,,E,...E.,.,.,,E,E,E,X----------XXXXXA.AXXXX----------------------------------------------XXX------------------------------------
---------------X,,H,,,,,,,,.X,,,,,,,,,,,.X,,,.,,,X----------X,,XX,,,X,,XX-------------------------------------------XXXXXXX----------------------------------
----------------X,,......,,X-X,,.E...,.,XX..,.,.,X---------XXH.H,..,,.H,X-----------------------------------------XX.......XX--------------------------------
-----------------XXX,,,,XXX---XXX,,,,XXX-X,,,,,,X----------X,...,.<,,..,X---------XXXXXXXXX---------------------XX..:,,+,:...X-------------------------------
--------------------X,XX---------X,,X-----X.,.,,X----------XXH,H,,,,,,H,X---------X.......X-------------------XX.....,>>>.....XX-----------------------------
--------------------X+XX--------X,,,X------X,,,X------------XXXXX,W,XXXXX---------X,,,,,,,X-------------XXXXXX..................X----------------------------
--------------------X+XX-------X,,.,.X------X,X----------------X,..,X-------------X.......X------------AA.AAXX,................,X----------------------------
-------------------XX,XXX------X,,,,,,X----XX+X----------------X,.W,X-------------X.E.E.E.X-----------A.AAAAAX.,..............,.X----------------------------
-------------------XX..XX------X.,.,.,X--XXXX+X-X--------------XX.W,X-------------X.......X-----------AA,...,,..,,..........,,..X----------------------------
------------------X,,,,,XX--XXX,.,.,.:X--X:XX,XX:--XXXX---------XX,XX-----------XXX,,,,,,,X-----------A.HWHH,:....,....E...,....X----------------------------
------------------X.....XX-X..,,E,.,..X---X....,X-XWHHX---------XX,X-----------XXX,.......X-----------AAAAAAA,.....,......,.....X----------------------------
----------------XXX.....,XX,,,X,.,E,..X--XX.,,,,XX..H.HX------XXX..XXXX--------XXX,.......X-----------XAAAAA,X......,,,,,,......X----------------------------
---------------X,,+.....,,,E.,X,.,.,.:X--X,.E,,,,+W...HX-----X,,.....,XX-------XXX,.......X------------X,...,X..................X----------------------------
--------------X.,,.+,,,.XXX,,,XXA,,,A,X--X,E,,E,,+A.H.HX----XX........X-X-------XXX.......X-------------XXXXXX..................X----------------------------
--------------X.,,.+,.,.XXXH.:XXA,.,A,X--X,.,,,,,+..H.HX----X,.........XX---------X.......X------------------X..................X----------------------------
--------------X.,,.+,,,.,XX,,,XX,,,,.X---XX.,,E,XX.AHH.X---XX...,,,,...,X------XXXX.......X------------------X,,,,,,,,,,,,,,,,,,X----------------------------
--------------X.,,+.....,,,E.,X-X,,,X-----X....,X-XX..X-----X,A,,..,,A,,X------XXX,.......X-------------------X................X-----------------------------
--------------X.XXX.....XXX,,,X--XXX------X,,,,XX---XXX-----X,,,,...,,,,X------XXX,.......X-------------------X................X-----------------------------
--------------X,X-X,,,,,XX-X..X-----------X,,,,,X-----------XXXX,,,,,XXXX-------XXX.......X--------------------X..............X------------------------------
--------------XXX-XXXXXXXX--XXX-----------X.....X-----------XXXX,,,,,XXXX---------X.......X---------XXXXXXX-----X...,,,,,,,...X------------------------------
--------------X.X-----------------------XXX,,,..X-----------XXX,,,,,,XX,X---------X......X----------XH.A.AX------X.,.......,.X-------------------------------
--XAX---------X.X-XXX-------------------XXX,,,,,XXXXXXX-XXXXX...,,,,,...XXXXX---XXX,,,,,XXXXXXXXX--X.......X--X++X.,...HH..,.X-------------------------------
-X,.AX--------X..X..X------------------X,,,,,,,.,,...:XXX..,,,..,,,,,..,,,..X--X........X.......X--X.H.H.A.X--X.X-X,,,,,,,,,X--------------------------------
X,.,.AX-----XX......X-----XXX----:XX:-X.,....,,.,,,,,,XXX..,,.,.,,,,,.,.,,..XXX.........,.......XXX,,,,,,,,,XXX.XXX,,,,,,,,,XXX------------------------------
X,.,.E.X----X......,X----X..XXXXXXXXXXX.,....,,.,,,,,T,,,..,,.,.,,,,,.,.,,..,.,.........,...E...,............,,.,.,.........,WX------------------------------
X.,A....X---X,.....X-----X..,,,,.,,,,.,.,....,,.,,,,,,XXX..,,.,.,,,,,.,,,,..XXX.........,.......XXX,,,,,,,,,XXX,XXX,,,,,,,,,XXX------------------------------
-XXX.....X--XX.....X-----X..,,,,.,,,,.,.,....,,.,,,,,:X-XXXXX,..,,,,,...XXXXX--X........X.......X-X.........X-X.X-X.AAAAAAA.X--------------------------------
----XX.E.X----X...X------X..,,,,,.,,.,,.,,,,,,,.XXXXXXX-----:...........X-XX----XXX,,,,,XXXXXXXXX--X.H.A.A.X--X,X-X,.......,X--------------------------------
------XX,X--X-X...X------X..XXXXXXXXXXX........X------------X..........:X---------X......X---------X.......X--X.XX.,.......,.X-------------------------------
---XXXXX..XX.X.....X------X,XXXXXX----X,,,,,,,X-------------XXX......XXXX---XAXXXXX.......X---------XXXXXXX---X,XX,,,,,,,,,,,X-------------------------------
--X..,,,.E.E.......X------X,,,.E..X---H,,,,..AX----------------X....X-------XE.EE,,.......X-------------------X.XX...........X-------------------------------
--X..,,,........E...X-XX--XX.,.....X--XXX,,,XXX----------------X,,,,X-------X...XXX.......X-------------------X,XXH,,.....,H.X-------------------------------
-X-X,,,,............XH.HX---XX,,,,,X----X,,,X------------------X,..,X-------XE.HX-X.......X-------------------X.XX.,,.....,,.X-------------------------------
-X,X,,,,.E..........,...X-XXXXX,,,XXXXX-X...X-------------------+++++-------X.XXX-X.......X------X------------X,XX...........X-------------------------------
-X-X,,,,............,....XX.XXX...XX..X-X.E.X---XXXXX---XXXXX---XXXXX-------X,X---X.......X----XX.X-----------X.XX...........X-------------------------------
--X.,,,,...........,,E.EX-X.,,,,,,,,,.X-X...X-XXX,,,XXXXX,,,XXXXX,,,XXX---XXX,XXXXX,,,,,,,XXXXX...X-----------X,XX...........X-------------------------------
---X.,,,....E.....:XX...X-X.,.......E.X-X...XXX....E.......E......E...X--X...................X,..E.X----------X.XXH,,.....,H.X-------------------------------
----XXXX.E.........X-X.X--X.,.......,.X-XXXXXX,.,,,,,.E.,,,,,..E,,,,,.X-X.....................,,....X---------X,XX.,,.....,,.X-------------------------------
--------X.....XXX.X---X---X.,.......,.X------X,.,...,...,...,...,...,.X-X......................,,.XX----------X.X-X.........X--------------------------------
---------:...:---X--------XEE.......,.X------X,.,,,,,.E.,,,,,.E.,,,,,.XXX.......................,X------------X,X--X.......X---------------------------------
---------XX,XX------------XEE......E,EX------XX.E.....................,L,........................X------------X.X---XXXXXXX----------------------------------
---------XX,XX------------X.,..E...E,EX-------XXX,,,XXXXXXXXXXXXXXXXXXXXX....,,,,,,,..............XXXXXXXXXXXXX,XXXXXXXXXXXXXX-------------------------------
---------X,,,X------------XEE.......,.X---------X...X-------------------X....,,,,,,,...................,,.E..XX.X...........,X-------------------------------
------XXX.....XXX---------XE,,,,,,,E,EX-------XXX,,,XXXXX-XXXXXXXXXXXXXXX....,,,,,,,.................E.,,....,,.,...........,X-------------------------------
------X,,.....,,X---------X,,.......E,X-------X.........X-X.,.....,.,........,,,,,,,...................,,....,,.,...........,X-------------------------------
------X,,.....,,X---------X.,.......,.X-------X.........X-X.,.....,.,...,,,,,,.....,,..................,,....,,.,...........,X-------------------------------
------X,,.....,,X---------X.,.......,.X-------X.........X-X.,.....,.,..,.....,.....,.,...............E.,,....,,.,...........,X-------------------------------
------X.,.....,,X---------X.,.......,.X-------X,,,,,,...XXX.,:....,.,.,,......,...,...,................,,.E..,,,,...........,X-------------------------------
------X.,..A..,,X---------X.,.......,.X-------X,,,,,,.E.,.,.,.....,.,.,.,.....,,,,,...,................,,....XX.X...........,X-------------------------------
------X,,,A.A,,,X---------XXX,,,,,,XX,X-------X,,,,,,...XXX.,.....,.,.,.,.............,.A...........XXXXXXXXXXX,XXXXXXXXXXXXXX------XXXXXX-------------------
------X,.,.H.,,,X---------XXX,.....XX,X-------X,,,,,,...X-X.,.....,.,.,.,.....,,,,,...,.............X--------X,,.X--HHXHHXHHXX----XX......XX-----------------
------X,,.,,,,,XX---------X,,,,,,,,,,,X-------X,,,,,,...X-X.,.....,.,.,,...E..,...,...,.............X-XXXXXXXX,,,XXX,,,,,,,,HX--XX..........X----------------
------X:,....,:X----------X.,.......,.X-------X,,,,,,...X-X.,.....,.,..,......,...,...,.............X-A,,E,,,,,,,,..........,X-X.............X---------------
------X,,.....,XX---------X.,.......,.X-------X,,,,,,...XXX.,.....,.,...,,,...,...,...,.A...........XXX,,,,,,,,.....E.......HXX,,,,,,,,,,,,,,,X--------------
------X,,,...,,,X---------X..,.....,..X-------X.....,.E.,.,.,.....,.,,,,,,,,.E,..,..E.,.............LL,......,.,............HXX.,...........,.X--------------
-----XE,,,,,,,,,EX--------X..,.....,..X-------X.....,...XXX.,.....,.,,XXXXXX,.,..,....,.............LL,.......,,.E......E...,XX.,...........,.X--------------
-----X,,......,,.X--------X...,...,...X-------X..A..,...X-X.,.....,.,,X.,,XX,.,..,....,.............LL,.......,,............HXX.,.E.........,.X--------------
------X,,....,,XX-------XXX,,..,,,....X-------X.A.A.,...X-X.,.....,.,,X,,.,,,.,,,,....,.............XXX.......,,......E.....HXX,,,,,,,,,,,,,,,X--------------
------X:,....,:X------XXX,,,,,........X-------XH.AA.,...X-X.,.....,.,,,.,.,,,........,.........,,,..X-X.......,,............,XX.,...........,.X--------------
------X,,.....,XX---XXX,,XX,,,........X-------X.....,.E.XXX.,..:..,.,,X,,.,,,..,,,..,...XXX....,.,..X-X..E.E..,,..,,,,,....EHXX.,.........E.,.X--------------
------X,,,...,,,X--X...,XXX,,.........X-------XH.AA.,...,.,.,.....,.,,XXXXXX,.,...,.,..X---X..,...,.X-X.......,,..,...,.....HXX.,...........,.X--------------
----XXX...,,,..,XXX...E.X-X...........XXX-----XH.AA.,...XXX.,,,,,,,,,,XXXXXX,.,.K.,.,.X-----X.,:..,.XXX.E.....XX..,,,,,.....,XX,,,,,,,,,,,,,,,X--------------
----XK,........,L,,.....X-XX.........XXEX-----X.....,...X-X.,.....,.,..,,...,.,...,.,.X-----X.,...,.,XX,,,,,E,XX..,...,.E..EHXX.,...........,.X--------------
----XXX........,XXX.....X--XXXX,,,XXXXXtX-----XXXXXXXXXXX-XXXXXXXXXXXXXXX...,..,,,..,.X-----X.,...,.XXX,,,E,,,,,E.,,,,,.....HXX.,...E.......,.X--------------
------X..X,,XX.,X--X...X------X,,,X---X.X-------------------------------X...,.......,.X-----X.,...,.X-X,E,,,,,,,..,,,,,.E..E,XX.,...........,.X--------------
------X,,X,,XX,,X---XXX-XXXXXXX,,,XXXXXXX---------------------------XXX-X,..,.......,.X-----X.,...,.X-X,,,,,,,,,.,,,,,,,....X-X,,,,,,,,,,,,,,,X--------------
------X..X.KXX..X------X...,........,....XX-------------------------X-X-X,..,.......,.X-----X.,...,.X-X,,,,,,,,,,,.....,....X-X.,...........,.X--------------
------XXX-XXX-XXX----XX....,...E...,.......X------------------------X,X-X,..,..,,,..,.X-----X.,..:,.XXX,E,E,,,XX,.....,,,,,,XXX.,...........,.X--------------
--------------------X,,,,,,,,,,,,,,,,,,,,,,,X-----------------------X-X-X,...,.,.,.,..X-----X.,...,.,XX......XX,,.....,.,.,.,.,.,........E..,.X--------------
--------------------XXXXXXXXXXXXXXXXXXXXXXXXX-----------------------XXX-X.,...,,,,,...X-----X.,,,,,.XXX.....X-X,,..E..,.,.,.,.,.E...........,.X--------------
------------------------------------------------------------------------X.,..........HX-----XA......X-XX..XX-XX,,.....,.,.,.,.,.,...........,.X--------------
------------------------------------------------------------------------X,,,,,,,,,,,,,X-----X,,,,,,,X--XX,X-XH,,,.....,,,,,,XXX.,,,,,,,,,,,,,.X--------------
------------------------------------------------------------------------X.,...........X-----X.....,.X---X+X-X.,,.,.....,....X-X...............X--------------
------------------------------------------------------------------------X,,,,,,,,,,,,,X-----X,,,,,,,X---X,X--XX,..,,,,,.....X-X.......T.......X--------------
------------------------------------------------------------------------X.,...........X-----X.....,.X--X,,,X--X,........E...X-X...............X--------------
------------------------------------------------------------------------X.,....E......X-----X..E..,.X-X.,.,.XXX,............X-X.............XXX-XXXXXXXXXXXXX
------------------------------------------------------------------------X.,...........X-----X.....,.X-X.,.,..E,,.E.E.E...E..X-X,,,,,,,,,,,,X----X...........X
------------------------------------------------------------------------X.,,,,,,,,,,,,X-----X,,,,,,.XXX.,.,..,,,.......E...EX-X,,,,,,,,,,,X-----X...........X
------------------------------------------------------------------------X...,.........X-----X.......XX,.,.,..E,,,,,,,,,,,,,,X-X...,..,T...X----XXtttttttttt.X
------------------------------------------------------------------------X...,.XXXXXXXXX-----XXXXXXXXXXX.,.,.XXXXXXX,,,,,,,,XX-X..T,T.,....XXXXX.t.........t.X
-------------------------------------------------------------------------X..,.X---------------XXXXXXX-X.,.,.XXXXXX-XXXXXXXX---X...,..,....,,,,X.tE.E..E..Et.X
--------------------------------------------------------------------------X.,X---------------XX,,,,,XXX.,.,.XXXXXXX-----------X,,,,,,,....XXXXXXXtttttttttt.X
---------------------------------------------------------------------------X,X--------------X...........,,,.......,X----------X,.....,....X-----X...........X
----------------------------------------------------------------------------X--------------XX..E..................,,XXXXXXXXXXX,,,,,,,....X-----X...........X
-------------------------------------------------------------------------------------------X,........,,,,,........,,,,,.,,,,,,,,,XXX,,.....X----X...........X
-------------------------------------------------------------------------------------------X,,,......,...,........,,,,,.,,,,,,,,,X-X,,......XXX-XXXXXXXXXXXXX
-------------------------------------------------------------------------------------------X,H.XX....,.E.,........,,X,,.,,,,,XX,,XXX,,........X--------------
-------------------------------------------------------------------------------------------XXH.XX....,...,.......,,,XXXXXXXXXXX,,,,,XXXXX,,,,,X--------------
--------------------------------------------------------------------------------------------X..XX....,,,,,....,,,.,X----------X,,,,,X---X:,,,:X--------------
---------------------------------------------------------------------------------------------XX-XX.,,,......XXXXXXX-----------XXXXXXX---X,,,,,X--------------
------------------------------------------------------------------------------------------------XX,,,,.XX,XXX-----------------XXXXXX----X,,.,,X--------------
-----------------------------------------------------------------------------------------------X,,,,,..XXXXXX----------------XX,,,,XX---X:,.,:X--------------
----------------------------------------------------------------------------------------------X.,.,,...XXX-XX----------------X,....,X---X,,.,,X--------------
----------------------------------------------------------------------------------------------X,..,,.,,,.XXXX----------------X,..H.,X---X:,,,:X--------------
----------------------------------------------------------------------------------------------X....,,,,,.AXXX----------------XX,,,,,X---X,,,,,X--------------
----------------------------------------------------------------------------------------------X,...,.,,,.XXXX-----------------X,,,,,XXXXX,,,,,X--------------
----------------------------------------------------------------------------------------------X.,..,,X,..XXXX----------------X,,,,,,....,.....X--------------
-----------------------------------------------------------------------------------------------X.,,XX-XXXXXXX---------XXXXXXX.,....,....,.....X--------------
------------------------------------------------------------------------------------------------XXX-------------------X........,...,...,......X--------------
---------------------------------------------------------------------------------------------------------------------X.........,..,....,......X--------------
---------------------------------------------------------------------------------------------------------------------X..........,.,....,......X--------------
---------------------------------------------------------------------------------------------------------------------X..,,,,,...XXX....,......X--------------
---------------------------------------------------------------------------------------------------------------------X..,...,..X---X..,......X---------------
----------------------------------------------------------------------------------------------------------------------XXX,,,XXX-----XXX,,,XXX----------------
------------------------------------------------------------------------------------------------------------------------X...X---------X...X------------------
-----------------------------------------------------------------------------------------------------------------------XX...X--------XX...X------------------
-----------------------------------------------------------------------------------------------------------------------XX.H.X--------XX.H.X------------------
------------------------------------------------------------------------------------------------------------------------XA.AX---------XA.AX------------------
------------------------------------------------------------------------------------------------------------------------X...X---------X...X------------------
------------------------------------------------------------------------------------------------------------------------XXXXX---------XXXXX------------------
