---------------------------------------XXXXXXXXXXXXXXXXXXXXXXXXXXXXXX----------------------
--------------------------------------X.............................,X---------------------
-------------------------------------X...............................,X--------------------
------------------------------------X.................................,X-------------------
----------------------------------XX,.....,,,,,,,,,,,,,,,,,,,,,,,,.....,X------------------
---------------------------------X.,.....,........................,.....,X-----------------
--------------------------------X.,.....,..........................,.....,X----------------
-------------------------------X.,.....,............................,.....,X---------------
-------------------------------X,.....,.....,,,,,,,,,,,,,,,,,,,......,.....X---------------
-------------------------------X,....,.....,...................,......,....X---------------
-------------------------------X,...,.....,.....................,......,...X---------------
-------------------------------X,...,.....,......................,.....,...X---------------
-------------------------------X,...,....,........................,....,...X---------------
-------------------------------X,...,...,..........................,...,...X---------------
-------------------------------X,...,...,..........................,...,...X---------------
-------------------------------X,...,...,..........................,...,...X---------------
-------------------------------X,...,...,..........................,...,...X---------------
-------------------------------X,...,...,..........................,...,...X---------------
-------------------------------X,...,...,..........................,...,...X---------------
--------------------------------X...,...,.........XX,,,XXX.........,...,...X---------------
--------------------------------X...,...,.........XX,,,X-X.........,...,...X---------------
--------------------------------X...,...,.........XX,:,X-X.........,...,...X---------------
--------------------------------X...,...,.........X,,,,,XX.........,...,...X---------------
--------------------------------X...,...,.........,,,H,,,,.........,...,...X---------------
--------------------------------X...,...,.........,E,,,,,,.........,...,...X---------------
--------------------------------X...,...,.........,.,E,.,,.........,...,...X---------------
--------------------------------X...,...,.........X.....XX.........,...,...X---------------
--------------------------------X...,...,.......XXX:....XXXX.......,...,...X---------------
--------------------------------X...,...,..XXXXX--X,,,,,X---XXXXX..,...,...X---------------
--------------------------------XXXXXXXXXXX------X...H...X-------XXXXXXXXXXX---------------
-------------------------------------------------X.......X---------------------------------
------------------------------------------------X....H....X--------------------------------
------------------------------------------------X,........XX-------------------------------
-----------------------------------------------X,,,,....,,,XX------------------------------
----------------------------------------------X,.,,,E,,,,,,,X------------------------------
----------------------------------------------X,,,.,,,,,,,,,X------------------------------
----------------------------------------------XH.,,,.,,E,,.HX------------------------------
----------------------------------------------XH.E.,,,,,..EHX------------------------------
----------------------------------------------X.,,,..,..,,,,X------------------------------
----------------------------------------------XH,:,.....,:,,X------------------------------
----------------------------------------------X.,,,.....,,,.X------------------------------
----------------------------------------------X.............X------------------------------
----------------------------------------------X.............X------------------------------
----------------------------------------------XH.:.........HX------------------------------
----------------------------------------------XXX..........XX------------------------------
-------------------------------------------------XXX,,,,XXX--------------------------------
--------------------------------------------------X:,,,,:----------------------------------
--------------------------------------------------X.....X----------------------------------
--------------------------------------------------X.....X----------------------------------
-------------------------------------------------X.......X---------------------------------
-------------------------------------------------X.......X---------------------------------
-------------------------------------------------X.......X---------------------------------
----------------------------------------------XXXX,,,,,,,XXXX------------------------------
---------------------------------------------X..............BX-----------------------------
--------------------------------------------X................HX----------------------------
-------------------------------------------X................B.WX---------------------------
------------------------------------------X.H.................B.X--------------------------
------------------------------------------X......,B,,,,,,,......X--------------------------
------------------------------------------X.....XX,,,,,,,XX.....X--------------------------
-----------------------------------------X......XX,,,,,,,XX,....X--------------------------
------------------------------------XXX-X.<.....,,.......,,,....X--------------------------
-----------------------------------X..X-X<......,,.......,,,....X--------------------------
----------------------------------X....XX.......,,.:.....,,,...HX--------------------------
----------------------------------X.W..+,<.:....,,.......,,,....X--------------------------
----------------------------------X....XX<......,,.......,,,..:.X--------------------------
-----------------------------------X...XX.......,,.......,,,....X--------------------------
------------------------------------XXX-XX......,,.......,,,....X--------------------------
------------------------------------------X.....XX.......XX,...BX-XXXXX-XXXX---------------
----------------------------XXXXX---------X.H...XX.......XX.....XXX,,,XXX,,,X--------------
----------------------------X,,,,XXXXX-----X....,,.......,,.....,,..........XXXX-----------
----------------------------X,.......X-----X,...,,.......,,.....,,............,X-----------
----------------------------X,.......X-----X.,...,,.B...,,......,,............,X-----------
----------------------------X,.......X-----X,,,XXX,,XXX,,XXXXXXXXXXXXXXX......,X-----------
----------------------------X,.......XXXEEXE+++XXX,,XXX,,XXXXX----------XXX,,,XX-----------
----------------------------X,.........,A..,...,..............X-----------X,,,XX-----------
----------------------------X,.........,E...,,,...............X-----------X...,X-----------
----------------------------X,........,E....................:..X----------X.:.XX-----------
----------------------------X,........,........................X----------X,,,X------------
----------------------------X,........,A...........,,,,........X----------X,,,X------------
----------------------------X,........,.......,,,,,...,........X----------X...XX-----------
-----------------------------X.......,........,........,.......X----------X...,X-----------
-----------------------------X.......,........,........,.......X---XXXXXX-X...XXXXXXXXXXXX-
-----------------------------X......,........,..........,.....,XXXXX,,,,XXX,,,XXX,,,,,H,,X-
-----------------------------X......,........,..........,....,.,,..,,E.,..,,,,,......,..,X-
-----------------------------X......,........,.....W....,....,.,,..,,.,...,,,,,.......,.,X-
-----------------------------X......,........,..........,....,.,,..,,,.................,,X-
-----------------------------X......,.......,...........,....,.,,..,,...,,,,......,,,,..,X-
-----------------------------X......,.......,....H......,....,.,,..,,...,A,,......,,,,:.,X-
-----------------------------X.....,........,...........,....,.,,..,,...,,,,......,,,,..,X-
-----------------------------X.....,........,...........,....,.,,..,,...,,,,......,W,,..,X-
-----------------------------X..,,.,.........,......A...,....,.,,..,,...,,,,......,,,,E.,X-
-----------------------------XXXXXX,.A.......,..........,....,.,,..,,...,,,,......,,,,..,X-
-----------------------------------XX,,,.....,..........,....,.,,..,,...,,,,......,,,,..,X-
-------------------------------------XX,.....,.........,.....,.,,..,,...................,X-
----------------------XXXXXXXXXXXXXXXXX,......,........,.....,.,,..,,...................,X-
----------------------XA......,.,.,...,,......,........,.....,.,,..,,.:........:........,X-
----------------------X.......,.,.,...,,......,,......,......,.,,..,,....,,,,,,,,,,,,...,X-
----------------------X.......,.,.,...,,........,,..,,.......,.,,..,,....,,........,,...,X-
----------------------X...,,,,XXXXXXXXX,..........,,..........,XXXXXX....,,,,,.,,,.,,...,X-
----------------------X...,..X-------XX,.......................X----X....,,,H,E,H,.,,...,X-
----------------------X...,.X------XX,........................XX----X....,,,.XXX:,.,,...,X-
----------------------X...,X-XXXXXX,.A.....................XXX------X....,,,HX-XH,.,,...,X-
----------------------X...XX-X.....,......................X---------X....,,,,XXX,,,,,...,X-
----------------------X...,X-X.....,......................X---------X.........E.........,X-
----------------------XE,,,X-X......,....................X----------X.E...........:.....,X-
----------------------X..:,X-X......,....................X----------X,.................,,X-
----------------------X.H.,X-X......,...................X-----------X.,...............,.,X-
----------------------X...,X-X......,...................X-----------X..,.............,..,X-
----------------------X,,,,X-X.......,..................X-----------XXX,,,XXX,,,,,,,,,,,,X-
----------------------X...,X-X.......,..................X-------------X,,,X-XXXXXXXXXXXXXX-
----------------------X,,,X--X........,.................X-------------X,,,X----------------
----------------------X...,X-XXXXXXX..,.................X-------------X,,,X----------------
----------------------X,,,,.X------X..,.................X-------------X,,,X----------------
----------------------X...,,.X------X..,.........,,,,,,,X------X------X,,,X----------------
----------------------X,,,,,,,XXXXX-X..,........,.......X------XX-----X,,,X----------------
-----------XXXXXXXXXX-X...,.,.,..AX--XXXXXXXXXXXX,,,,,,,X------XX-----X...X----------------
----------X...:.....HXX.:.,.,.,...X---------XXXXX,,,,,,,XX-----X------X,,,X----------------
---------XH......E.E.HXAE.,.,.,...X--------X.....,.....,..X----XX-----X...X----------------
--------X...........A.XXXXX,,,,,,,X-------X......,..,,.,..,:----------X...X----------------
-------X..............X----X.,,...X------X,...,,,.,.,.,...,.X---------X...X----------------
-------X............:.X-----X.,,,,X-----XA.,.,,,,,.,...,,,.E.X--------X,,,X----------------
-------X.....XXX,,,,,X-------X,...X-----X..,.,,W,,.,.....,..AX--------X...X----------------
-------X....HX-X,,,,,:--------X,,,X-----X..,.,,,,,,........:..XXXXXXEXX,,,X----------------
--XXX-:,.....XXXE,,,,XXX------X,,,X----X...,..,,,.,...........,.,,..,.,...X----------------
-X.AX-X,.....,.,.....,,.XXXXXXX,,,XXXXXX....,....,....,........,E,E.,.,...X----------------
>....XX,.....,.,.....,,..,,A....:E..,E,,....,,...,....,,,......,,,..,.,...X----------------
>HE..+,,..E..,.,.....,,..,,..E......,,,,......,,,....,...,......XXXXXXX,,,X----------------
>....XX,.....,.,.....,,..,,........E,,,,........,....,....,.....X-----X...X----------------
-X.A.X:,.....,.,E....,,.XXXXXXXXXXXXXXXX.....:......,......,....X-----X,,,X----------------
--XXX-X,.....XXX,,,,,:XX---------------X....,,......,......,....X-----X,:,X----------------
-------X.....X-X,,,,,X------XEXXXEX-----X.,,..,,...,........,..EX-----X,,,XX---------------
-------X.....XXX,,,,,XX-----X.....H-----X,......,,.,..,,,...,...X----X.H.H.X---------------
-------X.:..........W.X-----X,,,,,X-----X.,,......,..,,,,,...,:X----X.......X--------------
--------X.............X-----X.....X-----X,E.,........,,A,,...,.X----XH.H.H.HX--------------
---------XH......E.EAHX-----X,,,,,XXXXXX,A...,.......,++,,....X-----X.......X--------------
----------X...:.....HX------X...E.......,...:,........,,,....X-------X.H.H.X---------------
-----------XXXXXXXXXX------X...........E.,..E,..............X---------X...X----------------
---------------------------X..........XXXXXX..,............X-----------X+XX----------------
---------------------------X.E.......X------XXXX......XXXXE.X---------X.A..X---------------
---------------------------X.......XX-----------XXXXXX---X...X--------X.:..X---------------
----------------------------X,XXXXX-----------------------XH.X--------X....X---------------
----------------------------X.X---------------------------X...X--------XWXX----------------
----------------------------X,X----------------------------XE..X--------X------------------
----------------------------X.X---------------------------X....X---------------------------
----------------------------X..X-------------------------X..H.X----------------------------
----------------------------X..XXX-------XXXXXXXXX-----XX.....X----------------------------
-----------------------------X....XXXXXXX.........XXXXX..,,..X-----------------------------
-----------------------------XA...........H..HE..H.......H.,.X-----------------------------
-----------------------------X......H..E...........E.......XX------------------------------
-----------------------------XXX........XXXXXXXX....H....XX--------------------------------
--------------------------------XXXXXXXX--------XXXX...XX----------------------------------
----------------------------------------------------XXX------------------------------------
