----------XXXXXX>>XXXXXXX---------------------------XXXXXXXXXXXXXXXXXXXX--------------------------------
----------X.............X---------------------------X.........+........X--------------------------------
----------X.E....E....E.X---------------------------X.........X........X--------------------------------
----------X.............X---------------------------X....W....X........X--------------------------------
----------X.....E.E.....X---------------------------XE........X.B.B.B.BX--XXXXXXXXXXXXXXXXXXXXXXXXXXX---
----------X.............X---------------------------X.......E.X........X--XA........................X---
----------XX.....E......X---------------------------X.........X.E.....EX--X...E...............A.A.A.X---
------------XX........XX----------------------------X....E....X........X--X..........E..............X---
--------------XX....XX------------------------------X.........X....E...X--X.E.....E.......E.......A.X---
--------XXXXXXXXX+XXXXXXXXX-------------------------X.........X........X--X..H.W.......E.....E......X---
--------X.....,.,,,.,.....X-------------------------X..E....E.X........X--X.E.....E.......E.......A.X---
--------XH....,..W..,....HX-------------------------X.........X.H.E.E..X--X..........E..............X---
--------X...T.E.....E.T...X-------------------------X.........X.E.....EX--X...E................E.E..X---
--------XH....,..T..,....HX-------------------------X.........XA.A.A.AAX--XA........................X---
--------X,XXXXX,,,,,XXXXXXX-------------------------X...E.E...XXXXXXXXXX--XXXXXXXXXXXXXXXXXXXXX.....X---
--------X.X---X,,,,,X-------------------------------X.........X-------------------------------X.....X---
--------XHX---X,,,,,X---------XXXXXXXXXXXXXXXXXXXXXXX,,,,,,,,,XXXXXXXXXXXXXXXXXXXXXXXX--------X.E.E.X---
--------X.X---X,,,,,X-------XX......................,E.E..E.E.,.......................XX------X.....X---
-------X..X---X,,,E,X-----XX..H.H.H.H.H.H.H.H.H.H.H.,.........,.H.H.H.H.H.H.H.H.H.H.H...X-----X.....X---
-------X...X--X,,,,,X----X..........................,.........,..........................X----X..E..X---
-------X...X--X,,,,,X---X...H................E......,E.E..E..E,.......E...............H...X---X.....X---
-------X...X--X,,,,,X---X...........................,.........,...........................X---X.....X---
-------X...X--X,E,,,X--X..H..E......,,,,,,,,,,,,,,,,,,,,,:,,,,,,,,,,,,,,,,,,,,,,.....E..H..X--X.E.E.X---
-------X...X--X,,,,,X--X..........,,...............,,,,,,,,,,,,................,,,.........X--X.....X---
------X....X--X,,,,,X-X.H.......,,..H...E..E.E.E..H,,,,E,,E,,,,.H..E.E.E..E...H..,,.......H.X-X.....X---
------X....X--X,,,,,X-X........,....................,.........,...................,,........X-X.....X---
------X....X--X,,E,,X-X.H.....,...XXXXX,,,XXXXXXXXXXX,,,,,,,,,XXXXXXXXXXX,,,XXXXX..,,.....H.X-X.E.E.X---
------X....X--X,,,,,X-X.......,...X:..........:XXHX-X....E....XXHXX:..........:XX..,.,......X-X.....X---
------X.....X-X,,,,,X-X.H....,..E.X...A...A....XX.X-X.........XX.XX.....A...A..XX.E.,,.E..H.X-X.....X---
------X.....X-X,,,,,X-X...E..,....X............XX.X-X.E..K..E.XX.XX............XX...,.,.....X-X..E..X---
------X.....X-X,,,E,X-X.H...,.H...X............XX.X-X.........XX.XX............XX...H,,...H.X-X.....X---
-----X......X-X,,,,,X-X.....,.....X............XX.X-XH.A.WA..HXX.XX............XX....,,.....X-X.....X---
-----X......X-X,E,,,X-X.H...,.E...X............XX.X-XXXXXXXXXXXX.XX............XX...E,,...H.X-X.E.E.X---
-----X......X-X+++++X-X.....,.....X............XX.X-----XXX----X.XX............XX....,,.....X-X.....X---
-----X...E..X-X,,,,,X-X.H...,.E...X...E...E.E.EXX.X-:XXXX<XXXXXX.XX...E...E.E.EXX...E,,...H.X-X...A.X---
-----X......X-X,,,,,X-X.....,.....X............XX.X-X..<.<<..:XX.XX............XX....,,.....X-X.....X---
-----XE.E.E.EXX,,,E,X-X.H...,.E.E.X............XX.X-X.........XX.XX............XX.E.E,,...H,XXX...A.X---
----X........XX,,,,,X-X.....,.....X............,.,X-A.......A.XX.XX............XX....,,....,,+......X---
----X.E.E.E.EXX,,,,,X-X.H...,.E.E.X.E.E.E......XXXX-X.........XX,XX.E.E.E......XX.E.E,,...H,,+A.A.A.X---
----X........XX,,,,,X-X.....,.....X............X----X.........XX.XX............XX....,,....,,+......X---
----XXXXXXXXXXX,E,,,X-X.H...,.E...X............XXXXXX.........XX,XX............XX...E,,E..H,XXXXXXXXX---
--------------X,,,,,X-X...E.,.....X............XX.E......W......EXX............XX....,,.....X-----------
XXXXXXXXXXXXX-X,,,,,X-X.H...,.E...X.....E.E....X-X......,,,.....X-X.....E.E....XX...E,,...H.X-----------
X........,t.X-X,,,,,X-X.....,.....X............X-X......,E,.....X-X............XX....,,.....X-----------
X.E.E.E.E,t.X-X,,,E,X-X.H...,.....X............X--X.....,,,.....X-X............XX....,,...H.X-----------
X........,t.X-X,,,,,X-X.....,.....X............X--X.............X-X............XX....,,.....X-----------
X.E.E.E.E,t.X-X,,,,,X-X.H...,.H...X............X--X............X--X............XX...H,,...H.X-----------
X........,t.X-X,,,,,X-X.....,,....X............X---X.....E.....X--X............XX...,.,.....X-----------
X.E.E.E.E,t.X-X,E,,,X-X.H....,..E.X:..A..W..A.:X---X...........X--X...A..W..A..XX.E.,,....H.X-----------
X........,t.X-X,,,,,X-X......,,...XXXXXXXXXXXXXX----:.A.,,,.A:X---X:XXXXXXXXXX:XX..,.,......X-----------
X.E.E.E.E,t.X-X,,,,,X-X.H.....,,..XXXXXXXXXXXXXXXXX-XXXXX+XXXXX-+XXXXXXXXXXXXXXXX.,.,.E...H.X-----------
X........,t.X-X,,,,,X-X.....E..,,,................+-:XXH,,H..:X-+................,.,........X-----------
X.E.E.E.E,t.X-X,,,,,X-X.H.......,.,,H.E.E.E.E.E.H.X-X....H....X-+.H.E.E.E.E.E.H,,.,.......H.X-----------
X........,t.X-X,,,E,X-X..........,,.,,,,,,,,,,,,,,X-XH......H.X-X,,,,,,,,,,,,,,.,,..........X-----------
X.E.E.E.E,t.XXX,,,,,X--X..H........,,,,,,,,,,,,,,,XXX....:....XXX,,,,,,,,,,,,,,,........H..X------------
X........,t.,.,.....,X-X..........................,.,.........,.,..........................X------------
X.E.E.E.E,t.,.,.T.E,EX--X...H.................E...,.,...E.E...,.,...E.................H...X-------------
X........,t.,..,...,..X--X........................,.,....E....,.,........................X--------------
X.E.E.E.E,t.,..,..E.T.X--XX,..H.H.H.H.H.H.H.H.E.H.,.,.........,.,.H.E.H.H.H.H.H.H.H.H..,X---------------
X........,t.,..,..,....XX..,,,,...................,.,.........,.,...................,,,..X--------------
X.E.E.E.E,t.,..,.,E..XX,.H....,XXXXXXXXXXXXXXXXXXXXXX.........XXXXXXXXXXXXXXXXXXXXXX....H.XX------------
X........,t.,...,,XXXX.......XX---------------------:........:X---------------------XX......X-----------
X.E.E.E.E,t.,...XX-XX.E.E...+---XXXXXXXXXXXXXXXXXXX-XXX,,,,,XXX-XXXXXXXXXXXXXXXXXXX---XX..E..X----------
X........,t.,..X--XXL.....X+---X:..............HtTX---XA.A.AX---XTtH.............:.X----X.....XX--------
X.E.E.E.E,t.,..X-X..LL..XX----X...H.............ttX---X,,,,,X---Xtt.............H...X----XX.ELLXX-------
X........,t.,.X--X...XXX-----X..................H.X---X.....X---XH...................X-----XLLL..X------
X.E.E.E.E,t.,X--X..:.X------X...H.................X---X.E.E.X---X.................H...X-----X....X------
X........,t.,X--X....X-----X......................X---X.....X---X......................X----X.....X-----
XXXXXXXXXXXXX--X.....X----X...H...E...E...........X----X.E.X----X...........E...E...H...X----X..:..X----
---------------X....X----X........................X----X...X----X........................X---X.....X----
--------------X.....X---X...H...E...E...E.....E...X----X,,,X----X...E.....E...E...E...H...X---X.....X---
--------------X.....X--X..........................X----XLLLX----X..........................X--X.....X---
--------------X....X--X...H...................E...X----XLLLX----X...E...................H...X--X....X---
-------------X.....X-X............................X----X,,,X----X............................X-X.....X--
-------------X..E..X:...H.....................E...X---X.A.A.X---X...E.....................H..:XX....EX--
-------------X....X-X.............................X---X.....X---X.............................X-X....X--
------------X.E.E.X-X.H...........E.E.........E...X---X.:...X---X...E.........E.E...........H.X-X.E.EX--
------------X.....X-X.............................X---X.....X---X.............................X-X.....X-
------------X.E.E.X-X.E.......................E...X---X.E.E.X---X...E.......................E.X--XE.E.X-
-----------X.....X--X.............................X---X.....X---X.............................X--X....X-
-----------X.....X--X.E...........H.H.........E..:X---X.E.E.X---:...E.........H.H...........E.X--X....X-
-----------X.....X--X.............................X---X.....X---X.............................X--X....X-
-----------X.....X--X.E.........,,,,,,,.......E...X---X.E.E.X---X...E.......,,,,,,,.........E.X---X...X-
-----------X....X---X...........,,,,,,,...........X---X.....X---X...........,,,,,,,...........X---X....X
----------X...E.X---X.E.........:,,,,:,.......E...X---X.E.E.X---X...E.......:,,,,:,.........E.X---X.E..X
----------X.....X---X...W.......,,,,,,,...........X---X.....X---X...........,,,,,,,......W....X---X....X
----------X....X----X.E.........,,,,,,,.......E...X---X..A..X---X...E.......,,,,,,,.........E.X---X....X
----------X..A.X----X...........:,,,,:,...........X---X.....X---X...........:,,,,:,...........X---X..A.X
----------X....X----X.E.........,,,,,,,.......E...X---X.E.E.X---X...E.......,,,,,,,.........E.X---X....X
----------X.....X---X...........,,,,,,,...........X---X.....X---X...........,,,,,,,...........X---X....X
----------X.....X---X.E.........:,,,,:,.......E...X---X.E.E.X---X...E.......:,,,,:,.........E.X---X....X
-----------X....X---X...........,,,,,,,...........X---X.....X---X...........,,,,,,,...........X---X...X-
-----------X.....X--X.E.........,,,,,,,.......E...X--X.......X--X...E.......,,,,,,,.........E.X--X....X-
-----------X.....X--X...........:,,,,:,...........X--X...W...X--X...........:,,,,:,...........X--X....X-
-----------X.....X--X.E.........,,,,,,,.......E...X--X.......X--X...E.......,,,,,,,.........E.X--X....X-
-----------X......X-:...........,,,,,,,..........:X-X....H....X-X...........,,,,,,,..........:X-X.....X-
------------X.E...X-X...........:,,,,:,.......E...X-X....X....X-X...E.......:,,,,:,...........X-X...EX--
------------X.....X--XX.........,,,,,,,..........X--X....X....X-:...........,,,,,,,.........XX--X....X--
-------------X.....X---X........,,,,,,,........XX--XE.E..X..E.EXXX..E.......,,,,,,,........X---X.....X--
-------------X.....X----X.......:,,,,:,.......X----X....X-X....X--XX........:,,,,:,......XX----X....X---
--------------X.....X----XX.....,,,,,,,......X----X.....X-X.....X---XX......,,,,,,,.....X-----X.....X---
--------------X......X-----X....,,,,,,,....XX----X......X-X......X----XX....,,,,,,,...XX-----X......X---
---------------X..E...XX----X.A.:,,,,:,.A.X-----X...A..X---X..A...XX----XXA.:,,,,:,.AX------X...E..X----
---------------X........XX---XX.,,,,,,,..X----XX.......X---X........XX----XX,,,,,,,XX-----XX.......X----
----------------X.........XX---X,,,,,,,XX--XXX....A...X-----X...A.....XX----X,,,,,X----XXX........X-----
-----------------X..........XXX-:,,,,:X-XXX..........,.X-----X..........XXX-:,,,,:X-XXX..........X------
-----------------X......E......XX,H,,,XX........A...X.H.X-----XX..A........XX,.H.,XX......E.....X-------
------------------X...............,,,.............XX-X.X--------XX............,,,..............X--------
-------------------XX.........E.........E......XXX----X-----------XX......E...................X---------
---------------------XX............A........XXX---------------------XXX........A............XX----------
-----------------------XX................XXX---------------------------XXX........E......XXX------------
-------------------------XXXX.........XXX---------------------------------XX..........XXX---------------
-----------------------------XXXXXXXXX--------------------------------------XXXX...XXX------------------
--------------------------------------------------------------------------------XXX---------------------
