------XXXXXXXXX------------------------------
------X..<<.<.X------------------------------
------X.......X------------------------------
------X...H...X------------------------------
------X.......X------------------------------
------X...<...X------------------------------
------X.......X------------------------------
------XH..:...X------------------------------
----XXX,,,,,,,XXX----------------------------
---XX,,,,,,,,,,,XXXXXXXXX--------------------
---K,...........,.......EX-------------------
---XX,,,,,,,,,,,XXXXXXXXX-XX-----------------
----XXXXXXX+XXXXX--------XX,X----------------
---XXXXXXXX+X--------------X,X---------------
---X,,,,,,LWX---------------X,X--------------
---X,,,,,XXXX---------------X,X--------------
>XXX,,,,,XXXXXXXXX----------X,X--------------
XE,,..............X------XXXX,X--------------
XXXX,X,,,,,,,,,,,,.X-----XEXX,X--------------
---X.X,,,,,,,,,,,.,.X----X,X,,XXX------------
---X.,E..........,.,.X--X...,,..X------------
---X:,.........E..,,.X--X...,,...X-----------
---X.X............,,.X--X...,,...XXXXXXXXX---
---X.,......X,X...,,.X---X.......,.XXXXX,,X--
---XE,,,,..XX,XX..,,.X---X..,,...XX----X.,,X-
---X.X,T,..,,E,,..,,.XXXXX.......XXXXXXX..,X-
---X.X,,,..XX,XX..,,.XX.X,,.,,,,.X-XX:XX....X
---X.,......X,X..,,,.XXEX,,.,W,,.X-EX,XX,...X
---X.,E..........,,,.XXXXX.......XXXX,XX.,..X
---X.XXXXX.......,,,.X---X..,,...X-X..XX,XXX-
---X,XXXXX...E...,,,EXXXXH,......X--XXXX,X---
---X....,........,,,.XXt,K,.,,...X--XXX..X---
---XXXX,XX.......,,,.X-XXXXXX,XXX---XXXX,X---
------X.XX,,,,,,,,,,.X------X.X-----XXX.EX---
------XE,.,..,,,,XXXXX-----XX,X-----XXXX,X---
------X,XXXXX,,,,,X--------X..X-----XX-XtX---
------X,XXXX..,,..XXXXXX---XX,X-----XXXXTX---
------X.,.,,E...E.,,E,:X---XX,X-----XX-X+X---
------XXXXXX..E...XXXX,X---X..X-----XX-XWX---
-----------X,,,,,,X--X.X---XX,X-----XX-X.X---
-----------XXXXXXX---XEX---X..X-----XEXX.X---
-------------XXXXXXXXX,X---XX:X-----XX-X.X---
----------XXXX.,,.,,.,.X--XXX,XX----XXXX.X---
----------XE,+..E....X,XXXX....XXXXXXXXXXX---
----------X.XX.,,.,,.,.,,.,.XX.,,....XXX-----
----------X.,+.,E.,K.X.XX.X.XX.XXXXXXXXX-----
----------XXXX.......XXXXXX...EX---XXX,X-----
-------------XXXXXXXXX--X.,XX,XX---EXXXX-----
------------------------XW.XXTX----EX--------
------------------------XXXXX+X----XX--------
---------------------------XX.XXXXXXX--------
---------------------------X.H,E,...X--------
---------------------------XXXXXXXXXX--------
