----------------------------------------------XXXXXXXXX------------------------------------------------
----------------------------------------------XW..A..WX------------------------------------------------
----------------------------------------------X.......XXXXXXXXXXXX-------------------------------------
----------------------------------------------X.......,,.,,,,.,,.X-----------XXXXXXXXX-----------------
----------------------------------------------X...:...:,.,,A,.,,.X-----------XH.....AX-----------------
----------------------------------------------X.E...E.,,.,,,,.,,.X-----------X.......XXXXXXXXXXXXXX----
----------------------------------------------X.......XXXXXXXXXX.XXXXXXXXXXXXX....:..,.............X---
----------------------------------------------X.......X--------X.,.,,.,,.,,EE,....A..EE..........E.X---
----------------------------------------XXXXXXXXX,,,XXXXXXXXX--X.XXXXXXXXXXXXX.......,..............X--
----------------------------------------X...................X--X.X-----------X.......XXXXXXXXXXXX...X--
XXXXXXX<XXXXXXX-------------------------X,,,,,,,,,,,,,,,,,,,XXXX+X-----------X..E..E.X----------X...X--
XA<.:....<..<.X-------------------------X.,...,E.,...,..,...++E..X---XXXXXXXXXXX,,,XXXXXXXXXXX--X...X--
X.....,,,.....X-------------------------X,,,,,,,,,,,,,,,,,,,XXXX.X---X......................WX--X.:.X--
X...,,...,....X-------------------------X.,..............E..X--X.X---X....................,E.X--X...X--
X..,:.....,...X-------------------------X,,,,,,,,,,,,,,,,,,,XXXX.X---X..:.................,W.X--X...X--
X..,......,...X-------------------------X.E.,..,...E..,...,.XXE..XXX-X...,,,,,,,,,,,,,,,,,...X--X...X--
X.,........,..X-------------------------X,,,,,,,,,,,,,,,,,,,XXXX..EX-X...,.E.,...,...,..E,...X--X...X--
X.,....W...,..X-------------------------X.E...............,.X--X...X-X...,.,,,,,,,,,,,,,.,...X--X...X--
X.,....A.:.,..X-------------------------X,,,,,,,,,,,,,,,,,,,X--X..AX-X...,.,EE...,...,E,.,...X--X...X--
X..,......,...X-------------------------X...,..,...H..,...,EX--X.XXX-X...,,,,XXXX>XXXX,,,,...XXXX,,,XXX
X..,......,...X-------------------------X,,,,,,,,,,,,,,,,,,,X--X.X---X...,.,.X--X+X--X.,.,...XX..EE..HX
XE..,,...,..E.X-------------------------X.,..............E..X--X.XXX-X...,.,.X-XXEXXXX.,.,...XX.......X
X.....,,,.....X-------------------------X,,,,,,,,,,,,,,,,,,,X--X..EX-X...,.,.X-X.E..XX.,.,...,,E......X
XH.....E....H.X-------------------------X...,..,.E.,..,...,.X--X.XXX-X...,,,,XXX+++XXX,,,,.:.,,...W.:.X
XXXXXXX,XXXXXXX-XXX----------XXX--------X,,,,,,,,,,,,,,,,,,,X--X.X---X...,.,.,+.....HX.,.,...,,E......X
------X.X-------XEX----------XEX--------X.E...............,.X--X.X--XX...,.,.XX..W.AEX.,.,...XXE......X
------X.XXXXXXXXX.XXXXXXXXXXXX.XXXXXXXXXX,,,,,,,,,,,,,,,,,,,X--XEX--XX...,.,.EXA....HX.,.,...XX..EE..AX
------X....E........................E...,...,..,...,..,...,EXXXX.XXXXX...,,,,XXXXXXXXX,,,,...XXXX,,,XXX
------XXXXXXXXXXXXXXXXXX...XXXXXXXXX.XXXXXXXXXXXXXXXXXXXXXXXXXA...HXXX...,.E.,...,...,E,.,...X--X...X--
-----------------------XE.AX-------XEX-----------------------X.....XXX,,,,,,,,,,,,,,,,,E.,...X--X...X--
-----------------------XXXXX-------X+X------XXXXXXXXX--------X..E..+:,...,...,...,...,..E,...X--X...X--
-----------------------------------X.X------X......AX--------X...:.XXX,,,,,,,,,,,,,,,,,,,,...X--X...X--
-----------------------------------X.XXXXXXXX.......X--------XE...EXXX.......................X--X...X--
-----------------------------------X.,.,,,,.,.......X--------XXX+XXXXX.......................X--X...X--
-----------------------------------X.,.,,,,.,......WX----------X.X--XX.......................X--X...X--
-----------------------------------X.,.,:,,.,.......X----------X.X--XXXXXXXXXXXX,,,XXXXXXXXXXX--X...X--
-----------------------------------XXXXXXXXXX.......X----------X.X-----------X.EE..E.X----------X...X--
--------------------------------------------X......AX----------X.XXXXXXXXXXXXX.......XXXXXXXXXXXX...X--
--------------------------------------------XXXXXXXXX----------X.,.,,.,,.,,.,,.......,..............X--
---------------------------------------------------------------X.,.,,.,,.,,.,,E......E...........E..X--
---------------------------------------------------------------X.,.,,.,:.,,.,,E...W..E.............X---
---------------------------------------------------------------XXXXXXXXXXXXXXX.......XXXXXXXXXXXXXX----
-----------------------------------------------------------------------------XH.....AX-----------------
-----------------------------------------------------------------------------XXXXXXXXX-----------------
-------------------------------------------------------------------------------------------------------
