----------------------------------------------------XXX--------------------
----------------------------------------------------X.X--------------------
----------------------------------------------------XHX--------------------
----------------------------------------------------XHH--------------------
----------------------------------------XXXXXXXXX---XHX--------------------
-----------------------------------------X,,,,,X----XAX--------------------
-----------------------------------------X.....X----XHHX-------------------
-----------------------------------:X---X:,,,,,X:---XHH:-------------------
----------------------------------XXX-XXX.......XXX-XHX-----XXXXXHH--------
----------------------------------XTX-X:......E...X-XAX-----XE..+HH--------
----------------XBXXXXXXXX:-------X.X-X,,.........XXX,XX:---X...++X--------
----------------XB..EXX.E.X-------X.X-X.,...........,.,HX---X.A..EX--------
----------------X....XX...X-------X.XXXA,.......W...,.,.XXXXX.....X--------
----------------X..A.WX...X-------XW..,A,..........E,.,:,+........X--------
----------------X....:X...X-------:XXXX,,...........,,,,XXXX......X--------
----------------X.XXXXX..EX-----------X.............,,,.XXE,,...E.X--------
----------------X.XXXXX...X-----XXXXXXX...........XXXXXXXX..,,....X--------
----------------X..E......X-----X:...LL......A...:X------X.AEXX...X--------
----------------X.........XXXXXXX....LL...........XXX----XA..XX+++X--------
----------------X:....E..,...........LL...........,.X----XXXXXX,,,X--------
----------------XXXXXXXXX.A.,,,,,,,,,XXXXXX,,,,,XXX.X---------X+++X--------
------------------------X...B,..........X-X.....X-X.X---------X...X---X----
------------------------X.,,,,...........XXE.E.EX-X.X---------X.A.X:XX,X---
------------------------X.,,.............XXXXXXXX-X,X---------X......,,,X--
------------------------X.,,..............X----XXX.,X-----XXXXX......,.,,X-
------------------------X.,,..............X---X,.,E.X-----X....+......,.,,X
------------------------X.,,............,,BXXX,.,,,.X----X...E..+......,,,X
------------------------X.,,............,E.,.,.XXXXX-----B.......+.E..B,,,X
------------------------X.E,...........,A..,..X-XXXXXXXXX,,,,,,,XX,...B,,,X
-------------------------X.,,..........,.E.,..X-X.E.E.EXX:......XX+....,,,X
-------------------------X.,,...........,,XXX.X-X......XX,,,,,,,,.+....,,,X
-------------------------X.,,.............X-X.X-X.E.E.EXX,,,,,,,,.+....,,,X
------------------------X.,,..............X-XEX-X......,,......,,.+...,,,X-
------------------------X.,,............XX--X.X-X......,,......,,.+...,,,X-
-----------------------X.,,.............X---XEXXX.E.E.E,,..H...,,.+..,,,X--
-----------------------X.,,.............XXXXX.XX,......,,.H:H..,,.+..,,,X--
----------------------X..,,............,.E..X,XXX.E.E.E,,..H...,,.+..,,,X--
----------------------X.,,............,.....,.X-X......,,......,,.+..,,,X--
----------------------X.,,............,...E.XXX-X.E.E.E,,......,,.+..,,,X--
----------------------X.,,.............,E...X---X......XX,,,,,,,,.+..,,.,X-
----------------------XE,,..........XXXX...X----X.E.E.EXX,,,,,,,XX+...,,,X-
---------------------XX.,,..........X---XX:X----X......XX:......XX+...,,.,X
-------------------XX..,,,.........X------X-----XXXXX+XXXB,,,,,,,,,..E.,,,X
------------------X....,,,.........X------XX-------X,.X-X........+.....,,,X
------------------:.....XXX.........X---XX.,XX---XX.,.X--X...E..+.....B,,,X
-------------:XXXX...AXX---X.........XXX...,..XXX...,X---X.....+......B,,,X
-------------X...,....X-XXXX,,,,,,,,,,X...XX......XXX-----XXXXX.......,.,,X
-------------XHE.,....X-XAH,..........,XXX--XX..XX------------X......H,,,X-
-------------:...,....X-XXXX,,,,,,,,,,X-------XX--------------X......,.,X--
-------------XXXXX:....X--X............X----------------------X....:.,,,X--
------------------X.E...XX,,,,,,,,,,,,,,X---XXXXXXX-----------X,,,XXXX,X---
-------------------XX..,,,..............XXXX..+...X-----------X,,,X---X----
---------------------XX.,,.............,X,--XXX,,,X-----------X,,,X--------
----------------------X.,,.............,EXXXXX,...X-----XXXXX-X...X--------
----------------------X.,,............,..XXXE.,...XXXXXXX.A.XXX...X--------
----------------------X.,,............,H.XX...,...,...,.,...,.,...B--------
---------------------X.,,.............,.EXX...,:..,E.,.,.,.,..,...X--------
---------------------X.,,..............,.XX.E.,...,..,.,.,.,..,...X--------
--------------------X.,,...............,X-XXX.,..WXXX,A,XXXXXXX,,,X--------
--------------------X.,,...............,X----XX...X...........X...X--------
--------------------X.,,..............,EXXXXXXX,,,X...........X...XX-------
--------------------XE,,...............,,,...,E...X...........X.,,.X-------
--------------------X.,,................,XXXX.....X...........X,.A.X-------
--------------------X.,,.................X..X.E..EX...........X.,,.X-------
---------------------X.,,...............X....XX...X...........X...,X-------
---------------------X.,,.......E.....XX.......XXX............X.,,.X-------
----------------------X,XXXX.........X........................X,E..X-------
----------------------X.X---XX.....XX.........................X.,,.X-------
----------------------X.XX:---X,,,X...........................X...XX-------
----------------------X...X---X,,,X..........................X,,..X--------
----------------XXXXXXX,,,XXXXX,,,XXX.......................X,,,XXX--------
---------------X......,.E.,.........X......................XE.,XX----------
--------------X.......,...,.........X.....................X..,.X-----------
-------------X........,...,.........X....................X...,X------------
------------X.........,...,.........X...................X.E.XX-------------
------------X.........,...,.........X..................X.,.X---------------
-----------X..........,...,.........X.........XXXXXXXXX.,.X----------------
-----------X..........,...,.........X.........XE,....,.A.X-----------------
----XXXXXXX...........,...,.........X.X:XXX...X.,...,.K.X------------------
----X,...<,...........,...,.........X.X.A.:...X.,....+.,X------------------
XXXXX.A...,,,,,,,,,,,,,,,,,,,,,,,,,,XXX...XXXXXW,.....,.X------------------
X....,.,..,.........................,,,...++....,.......X------------------
X.....XXX<,.........................,,,E..++T..E,.......X------------------
X<....X-X.,....................E....,,,...++....,......X-------------------
X.....X-X<,,,,,,,,,,,,,,,,,,,,,,,,,,XXX...:XXXXXX,,,,,X--------------------
X.:...:-X:,...........,...,.........X-XE..X-----X.E...X--------------------
XXXXXXX-XXX...........,...,.........X-XX,XX-----XA..W.X--------------------
----------X...........,...,.........X--X,X------X.....X--------------------
-----------X..........,...,.........X-XXXXX-----XXXtXXX--------------------
-----------X..........,...,.........X-------------XEX----------------------
------------X.........,...,.........X-------------X.X----------------------
-------------X........,...,.........X-------------XHX----------------------
--------------X.......,.E.,.........X-------------XXX----------------------
---------------X......,...,.........X--------------------------------------
----------------XXXXXXX,,,XXXXXXXXXXX---XXXX:------------------------------
----------------------X+++X-----------XX..H.X------------------------------
----------------------X+++X---------X:.E....X------------------------------
----------------------X...X---------X.......X------------------------------
---------XXXXXXXXXXXXXX,,,XXXXXXXXX:X,,,,.E.X------------------------------
------XXX...........................,.E.,...X------------------------------
------X.............................,..E,..X-------------------------------
-----X...............................,..,..X-------------------------------
-----X..XXX...........................,:XXX--------------------------------
----X...X-X.............................X----------------------------------
----X...XXX.......................A.....X----------------------------------
----X...........E....:,,,,,:............X----------------------------------
----X................:,,,,,:............X----------------------------------
----X................:,,,,,:............X----------------------------------
----X.......XXXXXXXXXXX,,,XXXXXXX.......X----------------------------------
----X.......X---------X...X-----X.......X----------------------------------
----X.......X-XXXXXXXXX,,,XXXXX-X.......X----------------------------------
----X..A....X-X.E.W.E,,.......X-X.......X----------------------------------
----X.......X-X......,,.......X-X.E.....X----------------------------------
----X,,.....X-X.....E,,.......X-X......,X----------------------------------
----X..,....X-X...XXXXXXXXX...X-X....,,.X----------------------------------
----X...,...X-X...X-------X...X-X...,...X----------------------------------
----X..E.,,.X-X...XXXHXXXXX...X-X..,....X----------------------------------
----X......,X-X.E.,...:...,...X-X,,.....X----------------------------------
----X.......X-X...,E...A.E,...X-X......:X----------------------------------
----X.......X-X...,..A:...,...X-X.....XXX----------------------------------
-----X......X-X...XXXXXXXXX...X-X.....XXHHH--------------------------------
-----X..E...X-X...X-------X...X-X.....,..EX--------------------------------
------X.....X-X...X-XHXXH-X...X-X.....,.E.X--------------------------------
-----:X.....X-X.A.X-XHKHX-X...X-X..A..,EEEX--------------------------------
----XXXX....X-X...X-X.H.X-X...X-X.....,..EX--------------------------------
----XHXX....X-X...X-X+++X-X.E.X-X.....,.HHH--------------------------------
----XEXX....X-X...XXX,,,XXX...X-X.....XXXXX--------------------------------
----XEXX...EX-X..,............X-X.......X----------------------------------
----X.XX....X-X.,.............X-X.......X----------------------------------
----XEXX....X-X,..............X-X.......X----------------------------------
----XEXX....X-XXX,,,,,,,,,,,XXX-X.......X----------------------------------
----X,XX....X---X,,,,,,,,,,,X---X.......X----------------------------------
----X,XX....X-X:X,,,,,,,,,,,XXXXX.......X----------------------------------
----XA+.....X-X....E...E.E....E,,.......X----------------------------------
----X++.....X-X..E...E..E..E...,,...E...X----------------------------------
----X.......X-XE..H............,,.......X----------------------------------
----X.......X-X:......:XX,XXB.:XX.......X----------------------------------
----X.......X-XXXXXXXXX-X,XXXXX-X:......X----------------------------------
----X...E...XXXXXXXXXXXXX,XXXXXXX.......X----------------------------------
----X.......,...................,.......X----------------------------------
----X.......,.....E.............,.......X----------------------------------
----X.......,.........A.....E...,....E..X----------------------------------
----X.......,...................,.......X----------------------------------
----X.......,.................E.,.......X----------------------------------
-----X:.....,...E...............,......X-----------------------------------
-----XX.....,...................,.....XX-----------------------------------
-------XXXXXXXXXXXX,,,,,,,XXXXXXXXXXXX-------------------------------------
------------------X:..A..:X------------------------------------------------
------------------XXX,,,XXX------------------------------------------------
--------------------X,,,X--------------------------------------------------
--------------------X,,,X--------------------------------------------------
--------------------X,,,X--------------------------------------------------
----------XXXXXXX++XX+++XBBXXEXXXBB----------------------------------------
----------X......................BB----------------------------------------
---------X.........................X---------------------------------------
---------X.........................X---------------------------------------
---------X.........................X---------------------------------------
--------X...........................X--------------------------------------
--------X..........:,,,,,:..........X--------------------------------------
--------X...........,,,,,,..........X--------------------------------------
-------X:......E....,>,,,,....E.....:X-------------------------------------
-------X............,>,,,,...........X-------------------------------------
-------X............,,,,,,...........X-------------------------------------
------X.............,,,,,,............X------------------------------------
--XBXXX............:.....:............XXXXX--------------------------------
--X..E,...........,...................,E..X--------------------------------
--X....,.........,...................,,...X--------------------------------
--X....,........,....................,,...X--------------------------------
--X....,.......,.....................,....X--------------------------------
--X.E...,......,....................,,..E.X--------------------------------
--X.....,.....,.....................,E....X--------------------------------
--X....E.,...,.....................,,.....X--------------------------------
--X,,,,,XX..,......................XX,,,,,X--------------------------------
---X.E..XX.:.....................:.XX.....X--------------------------------
---X....X-XX........:...:.........X-X.E..X---------------------------------
----X...XXXXX,,,,,,,XXXXX,,,,,,,XX--X....X---------------------------------
-----X.......E.....EXXXXXE.....EXXXXX...X----------------------------------
-----X....E.....E.......,...E...,.E.....X----------------------------------
------XX...........XXXXXXXX.....,.....XX-----------------------------------
--------XXX.B..XXXX--------XXXX.B.XXXX-------------------------------------
-----------XXXX----------------XXX-----------------------------------------
