--------------------------------------------HXXAX-------------------------------------
--------------------------------------------X...X-------------------------------------
--------------------------------------------X.E.X-------------------------------------
--------------------------------------------X...X-------------------------------------
--------------------------------------------X,,,XXXXX------XXXXXXXXX------------------
-------------------------------------------X.........X----X.........X-----------------
------------------------------------------X......E...X---X..........X-----------------
-----------------------------------------X.........E..X-X............X----------------
----------------------------------------X..............X..............XXXXAX----------
----------------------------------------X..............+..............,,...X----------
----------------------------------------X..............+..............,,.E.X----------
----------------------------------------X..............+..............,,..HX----------
----------------------------------------X..............+..............XXXXXX----------
----------------------------------------X..............+..............X---------------
----------------------------------------X..............+..............X---------------
----------------------------------------X..............+............E.X---------------
----------------------------------------X.............XXX.............X---------------
-----------------------------------------XX..........,.XX,...........X-XXX------------
-------------------------------------------X........X.,,,,X,,,,,,,,,X-X--X------------
--------------------------------------------X+++++++XX,H,.XX+++++++X-X--->------------
-------------------------------------------X........XX,,,.X.........X+-XX>------------
------------------------------------------X..........,,..,..........,XX---------------
-----------------------------------------X............XXX.E.........,X----------------
----------------------------------------X..............X..............XXXXXX----------
----------------------------------------X..............,..............,,...X----------
----------------------------------------X..............,..............,,.E.X----------
---------------------XXXXXXXXXXXXXXXXXXXX..............,..............,,...X----------
-------------------XX.,.......E.E......AX..............,..............,,...X----------
-----------------XX....,........,...E...L..E...........,..........E...,,...X----------
---------------XX......,........,.......L..............,..............,,.E.X----------
---------------X,......,........,.......L..............,.......,,.....,,...X----------
--------------X..,,.....,.......,.......X..:...........X.....,,..,....XXXXXX----------
--------------XA...,....XXXXXXXXXXXXXXXXXXX...........X-XX.E.,,.,,...X----------------
-------------X......,.XX-------------------X.........X----X.,.,.,.,.X-----------------
-------------XA......X------------XXXXXX----XXXXXXXXX--XXXXXX.,.,.XX------------------
-------------X.......X------XXXXXX.....AX--------------X.t.XX.,.,.XXXXXX--------------
-------------X.......X--XXXX.........XXXX--------------XXX..,.,.,.,....X---XXX--------
------------XX.......XXX.............XXXXXXXXXXXXXXXXXXXXXXXX,,,,,XXX..X---XTX--------
----------XX.X,,,,,,,X.H.............XX.................,...,.,.,.,X-XtX---X.X--------
--------XX...........................XX.................,E...,,.,,.X-X.X---X.X--------
-------X......................E......,,.E..,,,......BBB.,....,,..,.X-XXX---XHX--------
------X..............................,,....,.,A.........,......,,..X-------X.X--------
------X..............................,,....,W,,,,,.,,,,,,.,,,......X-------XtX--------
-----X.............................,,XX....,.,...,.,..:,,.,.B..T.E.X-------X.X--------
----X..............,,,,............,,XX....,,,,,,,,,,,,,,,,.,......X-------XXX--------
---X............,,,....,,..........,,XX....,,B,.,.,A,B.,,,,.,....E.X------------------
---X............,.H,,,...,,........,,,,....,,.,,,.,,,,,,,,,,,......X------------------
--X............,.,,,,,,,...,.....E.,,,,......XX.....XX..,...X......X------------------
--X............H.,,.A..,,,.,,......,,,,......XX.....XX..,...X......X---XXXXXXXXXX-----
--X...........,.,,....K..,,.,,.....,,X+.................,..........X---XA......:.XXXX-
--X...........,.,........,,.,.,....,,X+.................,..........X---X.,,,,,,...,WX-
-X..E.........,.,..:...E..,,.,,....,,XX.................,,,,,,,,,,,X---X.,.....,..,.X-
-X............,.,H....,,..,,.,,......,,...B.............,....,,,...X-XX,.,......,..,X-
-X...........,..,,..,,,,,,.,..,,.....,,.E.,BB,BB........,....,.,...XXX.,.,.......,..X-
X............,..,,,,,....,,...,,.....,,...,BB,BB..,,,,,,,...,,,,,,.++,.,.,........,.:X
X....,,,,,.E.,................,,.....XX...,,,,,,..,,,,,,,...A,,H,,.XXX.,.,.........,.X
X....,,,,,...,,.W.......:.E..,,......XX...........,,...,,.......,,.X-X,,.,.........,.X
X.....A.:,....,....E.........,,......XX,XXXXXXXXXXXX,,,XXXXXXXXXXXXX--X,.,.........,.X
X........,....,,.........,,,,,.......XX.X----------XE.AX---------------X.,.........,.X
X....,,,,,.....,,,,,,,,,,.,,,,.......XX,XXXXX------X,,,X---------------X.,.........,.X
-X.................,,,,,,,...........,E.E...X------XLLLX---------------X.,,,,,,,,,,,.X
-X...........................E.......XXXX...X------X...X---------------X.............X
-X...................................XAXX:..X------X,,,XX--------------XXXXXXXXX.....X
-X..................................XXXXXXXXX----XX......XX--------------------X.....X
--X........E....................X,XX-----------XX..........XX------------------X.....X
---X...........................XX.X----------XX..H.,,,,,,H...X-----------------XE....X
---X..........................X-X.X----------X...,,,,..,,,,..X-----------------XXXXXXX
----X........................X-XX,XXXX------X..,,,........,,..X-----------------------
-----X......................X--X<...:X------X..,...........,..X-----------------------
------XX...................X---X.....X------XE.,..H.,+,.H..,,EX-----------------------
--------XXXX.............XX----X...,,XXXXX--X.,.....,,,.....,.X-----------------------
------------XXXXXXXXXX+XX------X<..,A,..:X-X..,..,,,........,..X----------------------
---------------------X,X----XXXXXXXX,,...X-X..,..,,,,,,,,,..,,.X----------------------
---------------------X,X----X<..X--X.....X-X..,..,.......,..,,:X----------------------
---------------------X,X----X...X--X.....XX..,...,...E..A,...,,.X---------------------
---------------------X,X----X..<X--X.....XX..,H..,.......,..H,,.X---------------------
---------------------X,X----X...X--X.....X-X..,..,,,,,,,,,..,,.X----------------------
---------------------X,X----XH,,X--X.....X-X..,.............,.EX----------------------
---------------------X,X----X,,,X--X.....X--XE.,.E........E,,.X-----------------------
---------------------X,X----X...X--X.....X--X...,.........,,..X-----------------------
---------------------X,X----XXXXX--XXX,XXX---X.A,.:.....:.,..X------------------------
---------------------X,X-------------X.X------X..XXX,,,,XX.AX-------------------------
---------------------X,X-------------X.X------X.X--X.W..XX+.X-------------------------
---------------------++X-------------X.X-------X---X+++XXW.X--------------------------
---------------------X..X--XXXXXXXXXXX.XXXXXXXXX---X+++XXXX---------------------------
--------------------+....XX,.,.,..............,X---X....X-----------------------------
--------------------+E.E.+.A.,.,.............,.X---X....X-----------------------------
--------------------+....XX,.,.,............,..X---:,,,:X-----------------------------
---------------------XXXX--XXXXXXXXX,,,,XXXX...X---X...X------------------------------
-----------------------------------X,,,,X--X...X---XE..X------------------------------
-----------------------------------X,..,X--X...X---X...X------------------------------
-----------------------------------X,..,X--X...X---X...X------------------------------
--------------------------------XX-X,,,,X--X...XXXXX...X------------------------------
------------------------------XX,.XXXX,XX--X..,.....,.EX------------------------------
----------------------------XX.,,,.X-XHX---X.E.......,.X------------------------------
----------------------------X,,.,.XXXX+X---X,.........,X------------------------------
----------------------------X,,:.,.+....XX-XXXXXXXXXXXXX------------------------------
----------------------------X,.,..,+......XXXXXXXXXXX---XXX---------------------------
-----------------------------X,.,.,.+.....+..,,,,,...XXX..,X--------------------------
-----------------------------X,.,..,.E...+.....:,.,,...,,,,X--------------------------
---------------------------XXA,,..,..+E..+....,.,...,,,...,.X-------------------------
-------------------------XX,,,.,.,....XX+.....,.,........A.,X-------------------------
-------------------------X,....,.,..,,X-X.....,.,..........,AX------------------------
-------------------------X,.E...,,..,X-X,.....,.,.......E..,.X------------------------
-------------------------X,.....,,.,.X-X.,,,,.,.,,,,,,,,..,.X-------------------------
-------------------------X,,,,,,..,.,,X-X,:..,..........,,,.X-------------------------
------------------------X.,:.......,,.,XX,,..............:,.X-------------------------
-----------------------X.,..,,.......,,XX,.,,,,.....,,,,,,,.X-------------------------
----------------------X.,.....,..,,...:XX,.:...,,,,,.....,.X--------------------------
---------------------X,,,,....,..,.,,,,XX,.......,,,,,,,,XX---------------------------
--------------------X..,..,,,,,,.,.....,XX,,,,,,,..,..XXX-----------------------------
--------------------X..,......,,,.....:,X-XXX,....,.XX--------------------------------
--------------------X.,..W......,,....,X----X,....,.XXXXX-----------------------------
---------------------X,...........,.,,X-----X.,....,.....XX---------------------------
---------------------X,............,,X------X.,.....,,,...X---------------------------
---------------------X.,....,......,..X-----X.,.....:.,....X--------------------------
----------------------X,..,,,.......,..X---X.,.A.......,E..X--------------------------
----------------------X.,,...,....A.,..X---X.,.........,...X--------------------------
-----------------------XXA.X.,.....,....X---X.,,......,....X--------------------------
-------------------------XXX..,,...,.E..X----X..,,...,..W..X--------------------------
----------------------------X...,,,.....X-----X...,,,......X--------------------------
-----------------------------XX........X-------XX.H..A....X---------------------------
-------------------------------X...A.H.X---------XX....XXX----------------------------
--------------------------------XX...XX------------XXXX-------------------------------
----------------------------------XXX-------------------------------------------------
