-----------------------------------------------------------------XXXXXXXXXXXXXXXXXXXXXXXXXXXXXXXXXXXXXXX-------------------------------------------------------
-----------------------------------------------------------------X,...................................,X-------------------------------------------------------
-----------------------------------------------------------------X,.E....,,,..........................,X-------------------------------------------------------
-----------------------------------------------------------------X,......,T,.......E.............E....,X-------------------------------------------------------
-----------------------------------------------------------------X,......,,,.A......,,,,.........H....tX-------------------------------------------------------
-----------------------------------------------------------------X,..............,,,,,,.,,,,,.......tt,X-------------------------------------------------------
-----------------------------------------------------------------X,...........,,,,,,...,,..+.,....tt..,X-------------------------------------------------------
-----------------------------------------------------------------X,........,,,.,,........,,..,..tt....,X-------------------------------------------------------
-----------------------------------------------------------------X,...E..,,.,,,............,,.,t......,X-------------------------------------------------------
-----------------------------------------------------------------X,......,,,.................,,.......,X-------------------------------------------------------
-----------------------------------------------------------------X,.....,.,...................,,..,,,.,X-------------------------------------------------------
-----------------------------------------------------------------X,.....,,.....................,..,T,.,X-------------------------------------------------------
XXXXXXXXXXXXXXXXXXXXXXXXXXXXXXXXXXXXXXXXXXXXXXXXXXXXXXXXXXXX-----X,.....,,.,,,,,,,,,,,,,,,.,,,.,,.,.,.,X-------------------------------------------------------
X,,,,,,,,,,,,,,,,,,,,,,,,,,,,,,,,,,,,,,,,,,,,,,,,,,,,,,,,,,X-----X,....,.,.,.,.,.,.,.,.,.,.,.,.,,.,,,.,X-------------------------------------------------------
X,.........A.E............................................,X-----X,....,,..,,,,,,,,,,,,,,,.,,,..,.....,X-------------------------------------------------------
X,..........................................E..E..........,X-----X,....,,..,.,..E......,.,.,.,..,,....,X-------------------------------------------------------
X,.....,,,,,,,,,,,,..................,,,,,,,,,,,,,,.......,X-----X,...,,...,,,.,,,,,,,.,,,.,,,...,....,X-------------------------------------------------------
X,.....,,,,,,,,,,,,..................,,,,,,,,,,,,,,....H..,X-----X,...,,...,.,.,E,.,K,E,.,.,.,...,,E..,X-------------------------------------------------------
X,.....,.E.E....E,,..................,,E.E.t,....,,.......,X-----X,...,,...,,,.,,,,,tt.,,,.,,,...,,...,X-------------------------------------------------------
X,.....,.....E...,,..................,,....t,....,,.......,X-----X,..,,....,.,.,.,T,.,.,.,.,.,....,,..,X-------------------------------------------------------
X,.....,...ttt...,,...........A......,,E.E.t,....,,.......,X-----Xtttt,....,,,.,,,tt,,.,,,.,,,....,ttttX-------------------------------------------------------
X,.....,.E.tHt..E,,..................,,..E.t,....,,.......,X-----X,..,,....,.,.,.,...A.,.,.,.,....,,..,X-------------------------------------------------------
X,.....,...ttt...,,..................,,E...t,.E..,,.......,X-----X,...,,...,,,E,,,,,,,,,,,.,,,...,,...,X-------------------------------------------------------
X,.....,.E.E.....,,..................,,..E.t,....,,.......,X-----X,...,,H..,.,.,.,.,.,.,.,.,.,...,,...,X-------------------------------------------------------
X,.....,......E..,,..................,,E.E.t,....,,.......,X-----X,...,,...,,,.,,,,,,,,,,,.,,,...,,.E.,X-------------------------------------------------------
X,.....,,,,,,,,,,,,..................,,E...t,....,,.......,X-----X,....,,..,.,H........E..A,.,..,,....,X-------------------------------------------------------
X,...................................,,,,,,,,,,,,,,.......,X-----X,....,,..,,,,,,,,,,,,,,,,,,,..,,....,X-------------------------------------------------------
X,...................................,,,,,,,,,,,,,,.......,X-----X,....,.,.,.,.,.,.,.,.,.,.,.,.,.,....,X-------------------------------------------------------
X,........................................................,X-----X,.....,,.,,,,,,,,,,,,,,,,,,,.,,.....,X-------------------------------------------------------
X,........................................................,X-----X,.....,,.....................,,.....,X-------------------------------------------------------
X,............................,,,.........................,X-----X,.....,.,...................,.,.....,X-------------------------------------------------------
X,........................,,,,.,.,,,......................,X-----X,......,,,.................,,,......,X-------------------------------------------------------
X,.....................,,,.....,....,,,...................,X-----X,......,,.,,............,,,.,t......,X-------------------------------------------------------
X,.................,,,,........,T......,,,................,X-----X,.E......,,.,,........,,.,,,.t......,X-------------------------------------------------------
X,...............,,..H........,,,.........,,..............,X-----X,.....A....,,,,,...,,,,,,.....t.....,X-------------------------------------------------------
X,...............,..........,,...,,........,..............,X-----X,.............,,,,,,,,........t.....,X-------------------------------------------------------
X,..............,........,,,.......,,....A..,.............,X-----X,....,,,........,t,......,,,...t....,X-------------------------------------------------------
X,..............,......,,............,,.....,.............,X-----X,....,T,........t........,T,...t....,X-------------------------------------------------------
X,....A.........,....,,................,..E.,.............,X-----X,....,,,..E.....t........,,,...t.E..,X-------------------------------------------------------
X,.............,.....,,..E....H.......,,.....,............,X-----X,..............t............E...t...,X-----------------XXXXXXXXXXXXXXXXXXXXXXXXXXXXXXXXXXX---
X,.............,.E..,..,......,,,....,..,....,............,X-----X,.............t.................t...,X----------------XX.......,,....,,.......+..........X---
X,............,.....,...,..,,,...,,.,...,.....,...........,X-----X,.............t..................t..,X----------------+,.++++..,,..E.,,,.....+...........X---
X,............,....,.....,,........,.....,....,...........,X-----Xtttt,,,,,,,,,t...E.....,,,,,,,,,,t..,X----------------+X.+..+..,,....,,,.....+........E..X---
X,............,....,.....,.........,.....,....,...........,X-----X,..,,,,,,,,,,,.........,,,,,,,,,,,..,X-----------------X.+H.+..,,....,,,.....+...........X---
X,...........,....,.....,.....H..E..,.....,....,..........,X-----X,..,..T.....,,,,,,,,,,,,....T...:,..,X-XXXXXXXXXXX-----X.++++E.,,H.E.,,.,...+............X---
X,...........,....,..H..,...........,...A.,..H.,..........,X-----X,..,........,,,,,,,,,,,,........,,..,X-X:,....,.:XXXXXXX,......XXXXXXXXXX,,,XXXXXXXXXX,,,X---
X,...........,...,.....,.............,.....,...,..........,X-----X,..,.E.,,,E.,+.E..t.,.,+...,,,,,,,..,X-X....H.,..XX...,,.,,,...X--------X,,,X--------X...X---
X,..........,....,.....,.....:....:..,.....,....,.........,X-----X,..,...,:,..,+...t.E.,,+...,A..,,,..,X-X......,..XX.E.,,....,,.X--------X...X--------X.E.X---
X,..........,...,ttt..,........ttt....,.....,...,....ttt..,X-----X,..,...,,,..,+...t...,,+...,.E.,,+..,X-X......,..XX...,,......,XXXXXXXXXX,,,XX-------X...X---
X,.........,....,t.t..,........t.t....,.....,....,...t.t..,X-----X,..,.E......,,..t..H..,,...,H..,,,..,X-X......,..XX..E,,.......,,.,..........X-------X...X---
X,.........,,,,,.ttt.,...T.....ttt.....,.....,,,,,...ttt..,X-----X,..,......A.,,,,,,,,,,,,...,,,,,,,..,X-X,,,,,XX..XX...,,.......,,.,..........X-------X,,,X---
X,.........,...,.....,..............A..,.....,...,........,X-----X,..,....E...,,...,,,,..,.E......,,..,X-X.....XX..XX...,,...E...,,.,..........X-------X,,,X---
X,..........,...,.....,........ttt....,.....,...,.........,X-----X,..,,,,+++,,,,...,.T,..,........:,..,X-X.....XX..XXH..,,......,XXXX..........XXXXXXXXX,,,XXXX
X,..........,...,.....,........t.t....,..H..,...,.........,X-----X,....t,,,,,,.....,,,,..,........,,.t,X-X.....XX..XX..E,,..,,,,.X--X..........XX...+.........X
X,..........,....,.....,.......ttt...,.....,.A..,.........,X-----X,....,t...,,E..........,,,,,,,,,,,t.,X-X.....XX..XXXXXXXXXXXXXXX--X.....E....XX...+..H......X
X,...........,...,.....,..........:..,.....,A..,..........,X-----X,....,.t..,,.,,,+++,,,.....,,,,,,t..,X-X.....XX,,XXXXXXXXXXXXXXXX-X..........XX...+......E..X
X,...........,....,....,.....:.......,....,....,..........,X-----X,,,,.,..t.,,.,,,,,,,.,.....,.E.,,,..,X-X.E...X,,,,,,,,,,,,,,,,,,X-X..........XX...+.........X
X,...........,....,..E..,...........,..E..,....,..........,X-----X,,T,.,.E.t,,.+,,...,.,,ttt.,.,,.,,..,X-X.....X,......,.,.,.,,E..X-X...E....E.XX...XXXXXX,,,,X
X,............,...,.....,.......E...,.....,...,...........,X-----X,,.,.,....t,.,,,.H.,.,,,..tt,ttt,,..,X-X.....X,..A...,.,.,.,,...X-X..........XX...X----X,,,,X
X,............,....,.....,.H.......,.....,.E..,...........,X-----X,,,,.,..T.,,.,.,...,.E,,...,.tTt,,..,X-X.....X,,,,,,,,,,,,,,,,,,X-X,,,,,,,,,,XX...X----X,,,,X
X,............,.H..,.....,,........,.....,....,...........,X-----X,....,....,,.,.,,,,,.,,,...,.ttt,,..,X-XX,,,>XXXXXXXXXXXXXXX,...X-X,,,,,,,,,,XX,,,X----X,,,,X
X,.............,....,...,..,,,...,,.,...,....,............,X-----X,....,....,,.,.,...,.,,,E..,,,..,,..,X-->...>--------------X,,,,X-XE..E.E..H.XX...X----X....X
X,.............,....,..,......,,,....,..,....,............,X-----X,....,...E,,.,.,,,,,.,,,...,E.,,,,..,X-->:.:>--------------X,...X-XXXXXXXXXXXXX,,,X----X....X
X,.............,.....,,..E............,,.....,............,X-----X,..E.,,,,,,,.,.,...,.,,,...,,,,,,,..,X-->.:.>--------------X,,,,X-------------X...X----X....X
X,..............,....,,......T....H....,....,.............,X-----X,....t,,,,,,.,.,,,,,.H,,............,X-->>>>>--------------X,...X-------------X.E.X----X,,,,X
X,..............,......,,............,,.....,.............,X-----X,...t........,.,.E.,,,,,.A..........,X--XXXXXXXXXXXXXXXXXXXX,,,,XXXXXXXXXXXX--X,,,X----X....X
X,..............,........,,,.......,,.......,.............,X-----X,.Ht.........,.,,,,,.,,,.....,,,.E..,X--X,,,,,,,,,,,,,,,,,,,,,,,,,,,,,,,,,,X--X...X++XXX....X
X,...............,..........,,...,,........,..............,X-----X,..t,,,,,,,,,,.,...,E,,,.....,T,....,X--X..............H,..,,...,..,,......X--X...XX..XX,,,,X
X,...............,,.....E.....,,,......H..,,..............,X-----X,.tE,,...,,T,,.,,,,,.,,,.....,,,....,X--X...,,,,,,,,,...,,,,,,,,,,,,,.E...HX--X,,,XXH.XX....X
X,.................,,,,........,.......,,,................,X-----X,t..,,...,,,,,.,.E.,.,,,............,X--X...,.H.....W...,,,,,,:,,,,,,......X--X...XX..XX....X
X,.....................,,,.....,....,,,...................,X-----X,,,,,,,,,,,,,,,,,,,,,,,,,,,,,,,,,,,,,X--X.E.,<.,.,,,,...,..........,,..,,,.X--X,,,XX..XX,,,,X
X,........................,,,,.,.,,,......................,X-----XXXXXXX,,,XXXXXXX,,,XXXXXXXXXXXXXXXXXXX--X...,..,.,<,,...,..E.....E.,,..,++.X--X...XXE.XX....X
X,............................,,,.........................,X-----------X,,,X-----X,,,X--------------------X...,A.,.,,,,...,.....T....,,......X--X...XX..XX....X
X,........................................................,X-----------X...X-----X...X--------------------X...,......H,...,..........,,......X--X,,,XX..XX,,,,X
X,...................................,,,,,,,,,,,,,,,,,,,,,,X-----------X,,,X-----X,,,X--------------------X...,,,,H,,,,...,,,,,,,,,,,,,....:.X--X...XX..XX....X
X,...................................,.,,,,,,,,,,,,,,,,,,,,X-----------X...X-----X...X--------------------X..<...............................X--X...XX..XX....X
X,...................................,.,..................,X-----------X,,,X-----X,A,X--------------------X.......:....<.....................X--X,,,XX..XX....X
X,...................................,.,..................,X-----------X...XXXXX-X...X--------------------X,,,,..............................X--X...XX..XX,,,,X
X,..................................,,,,...............H..,X-------XXXXX+++XA.HX-X,,,X--------------------X,,,,,,,,,,,,,..E......,,,,,,,,,,,,XXXX,,,XX..XX....X
X,..............................,,,,.,.,..................,X-------X.EXX...XX..X-XE..X--------------------X..E,,,,,,,,,,.........,,,,,,,,,,,,,..,...XX..XX....X
X,..........................,,,,....,,.,..................,X-------X..,,...,,E.X-X,,,XXXXXXXXXXXXXXXXXXXXXX...,.:.E...E,.........,,,H.,.,....,..,...XX..XX,,,,X
X,......................,,,,....,,,,.,.,..................,X-------X.E,,...,,..X-X...X:.H.:XXE.....E,..E.+,...,,,,,,,++,,,.......,,:,.,.,....,..,,.,,,..XX....X
X,.,,,,,,,,,,,,,.....,,,.....,,,....,,.,..................,X-------X..,,,A,,,E.X-X,,,X.E..EX+.......,....+,.E.,.....,,,,,,.......,..,E,.,....,..,,.,XX..XX....X
X,.,.....,.,.,.,.....,...,,,,....,,,.,.,..................,X-------XXXXX,,,XXXXX-XE..X,,,,,XX....E..,.E..+,...,.H.E.,E..E,.......,,,,,,,,,,,,XXXX,,,XXE.XX....X
X,.,.....,.,.,.,.....,.,,.....,,,....,.,..................,X-------XXXXX,,,XXXXX-X,,,X.E....X,,,XXXXXXXXXXX...,,,,,,,++,,,..............,.,,.X--X,.,XXXXXX....X
X,.,.....,.,.,.,.....,.,...,,,.....,,,.,..................,X-------:,.........:X-X...X...EE.X,,,X---------X.E.,,,,,,,,,,................,.,,.X-XX,,,XXXXXX,,,,X
X,E,,....,.,.,.,.....,.,.,,......,,..,.,..................,X-------X...........X-XX,XXX,,,,,X+++XXXXXX++XXX...,..E...E.,................,.,,EX-X..............X
X,.,.,...,.,.,.,.....,.,.,......,....,.,..W...,,,,,,,,,,,,,XXXXXXXXX...........X-X...,...............,..:XX...,,,,,,,,,,.............E..,.,,.X-X..............X
X,.,.H.E.,.,.,.,.....,.,.,......,....,.,......,.,A,.,A,.,AA,,A,A,,,,.....H.....X-X...,...............,H..XX,,,,.........................,.E,.X-X.E............X
X,E,.,...,.,.,.A.....,.,.,......,....,.,......,,,,,,,,,,,,,XXXXXXXXX...........+-XEH.,...............+++HXX.....................E.......,.,,.X-X..............X
X,.,,....,.,.,.,.....,.,.,,......,,..,.,..................,X-------X...........X-X...,....,,,,,,,,.A.,.H.XX.............................,.,,.X-X..............X
X,.,.....,.,.,.,.....,.,...,,,.....,,,.,..................,X-------X...........X-X.H.,....,,,,:,,,...,...XX............................H,.,,.X-X..,,,,,,,,,...X
X,.,.....,.,.,.,.....,.,,.....,,,....,.,..................,X-------X...........X-X...,..A.,,....,,...,..EXX..E....,,,,,,,,,,,,,..,,,,,,,,.,,HX-X..,,,,,,,,,...X
X,A,.....,.,.,.,.....,...,,,,....,,,.,.,..................,X-------X,.........,X-XH..,....,,...H,,...,.H.XX.......,,,,,,,,,,,,,..,...,,,,,,,.X-X..,,.....,,...X
X,.,,,,,,,,,,,,,.....,,A.....,,,....,,.,..................,X-------:XXXX,,,XXX:X-X...,....,,....,,...,..EXX.......,T.,,.,...E,,..,,,,,....,,.X-X..,,.....,,...X
X,......................,,,,....,,,,.,.,.........T........,X-----------X...X-----X.H.,....,,.E.E,,...,.H:XX.......,..L,.,,,,,,,..,L.L,.E..,,.X-X..,,..K..,,...X
X,..........................,,,,....,,.,..................,X-----------X,,,X-----X:..,....,,....,,...,...XX.......,.EL,.,,,,,,,..,L.L,....,,.X-X..,,.ttt.,,...X
X,..............................,,,,.,.,..................,X-----------X...X-----XEH.,....,,,,,,,,A..,.H.XX.T.....,..L,:,,,,,,,..,L.L,....,,.X-X..,,.t.t.,,...X
X,..................................,,,,....A.............,X-----------XE,,X-----X...,....,,,,,,,,...,...XX.......,..,,...,,K,,..,,,,,..,,,,.X-X..,,.ttt.,,...X
X,...................................,.,..................,X-----------X...X-----XH..,...............,H.EXX.......,,,,,,,.,,T,,..,...,..,:,,.X-X..,,.....,,...X
X,...................................,.,..................,X-----------X,,,X-----X...,.........H.....,...XX.......,..,,:,.,,,E,..,,,,,,,,,,,.X-X..,,...E.,,...X
X,...................................,.,,,,,,,,,,,,,,,,,,,,X-----------X...X-----XEH.,.....A.........,.H.XX...E...,..,,,,,,,,,,..............X-X..,,,,,,,,,...X
X,...................................,,,,,,,,,,,,,,,,,,,,,,X-----------X,,,X-----X...,,,,,,,,,,,,,,,,,,,,XX.......,LL,,,,,,,,,,..............X-X..,,,,,,,,,...X
X,........................................................,X-----------X,,,X-----X,,,,,,,,,,,,,,,,,,,,...XX.......,,,,,......................X-X..............X
X,............,,,.........................................,X-----XXXXXXX,,,XXXXX-X..H..H.H..H..H.E.H.,.H.XX.H.....,..,,E.....................X-X..............X
X,............,.,......................................E..,X-----X...B.....E..BX-X:...E.....E.:...H..,..:XX.......,,E,,......................X-X..............X
X,............,,,.........................................,X-----X,,,,,,,,,,,,,X-XXXXXXXXXXXXXXXXXXXXXXXXXX,,,,,,,,,,,,,,,,,,,,,,,,,,,,,,,,,,X-X,,,,,,,,,,,,,,X
X,............,.,.........................................,X-----X.,....,,,..,.X------------XXXXXXXXXXXXXXXXXXXXXXX,,,XXXXXXXXXXXXXXXXXXXXXXXX-X,,,,,,,,,,,,,,X
X,...........,,,,,........................................,X-----XE,....,,,..,.X------------XH,..,.,.,.,.,+....:X-X,A,X------------------------X.E......E...E.X
X,...........,...,........................................,X-----X.,....,,,..,.X------------X.X,XXE,,,,,,XX...E.+-X..,X------------------------X.....H........X
X,.....,,,,,,,,,,,,,,,,,,,................................,X-----X,,.........,EX---XXXXXXXXXX.XEXX,,,,,,HXX,H..,X-X,,,X------------------------XXXXXXXXXXXXXXXX
X,.....,,,,,,,+++,,,,,++,,................................,X----XX,,.........,.X---:,..H..:XX.X.XX,,,,,,,X:XXXX:X-X..,X----------------------------------------
X,.....,..H.........,,EE,,.........................,,,,,,.,X----X,,,.........,,XXXXX.....E.XX,XXXX.E.....XXXXXXXXXX..,X----------------------------------------
X,.....,H,,.........,,..,,.......................,,......,,X---X.,,,...........+.++,E..E...XX.E.L,....E..,.A.,.,..,..,X----------------------------------------
X,.....,.,..........,,E.E,......................,..,,,,,,.,X---X.,,,.........,,XXXXX.....E.,,...L,.,,,...,...,,,..,..,XXXXXXXXX--------------------------------
X,.....,H,..........,,,,,,....................,,.,,......,,X----X,,,.........,,X---XE..E...XX..EL,.,E,E..X++XXXXXXXX,XX.,....EX--------------------------------
X,.....,H,..........,,,,,,...................,...,........,X-----X,,.........,BX---XXXXXXXXXXXXXXX.,,,...X---------X+XX.,E.E..X--------------------------------
X,.....,,,..............,,..................,...,.........,X-----X.,.........,.X-----------------X.......X---------XEXX.,.....X--------------------------------
X,.....,.E.............E,,...A..............,..,..........,X-----XB,.........,.X-----------------:,..A..:X---XXXXXXX.XX.,...E.X--------------------------------
X,.....,................,,.................,..,...........,X-----X.,.........,EX-----------------XXX,,,XXX---XE,.,.,HXX.,.E...X--------------------------------
X,.....,,,,,,,,,,,,,,,,,,,................,...,...........,X-----XE,,,,,,,,,,,,X-------------------XE.EX-----X,XXXXX.XXXXXXXXXX--------------------------------
X,.....,.,...,..,,,..,,,,,................,..,.....H......,X-----X.B..,,,,,,..HX-------------------X...X-----X.X---X.X-----------------------------------------
X,.....,,,,,,,,,,,,,,,,,,,...............,..,.............,X-----XXXXXXX,,,XXXXX-------------------XE.EXXXXXXX,X---X.X-----------------------------------------
X,.....,.....,,,.......H,,...............,.,..............,X-----------XX.X------------------------X...,.,A,.,.X---XEX-----------------------------------------
X,.....,,,,,,...,,..E...,,...............,.,..............,X-------------X-------------------------XE.EXXXXXXXXX---X+X-----------------------------------------
X,.....,....,.....,,..E.,,...............,,...E...........,X---------------------------------------X,..X-------------------------------------------------------
X,.....,,,,,........,,..,,..............,.,...............,XXXXXXXXXXXXXXXXXXXXX-------------------:XXXX-------------------------------------------------------
X,.....,...,..........,,,,..............,,................,,,,,,,,,,,,,,,,,,,,,X-------------------------------------------------------------------------------
X,.....,,,,,........E...,,..............,,....................................,X-------------------------------------------------------------------------------
X,.....,...............E,,.............,.,..................................H.,X-------------------------------------------------------------------------------
X,.....,..............,,,,.............,.,.....,,,,,,,,,,,.......,,,,,,,,,,,..,X-------------------------------------------------------------------------------
X,.....,.........,,,,,.,,,............,..,.....,,A,,,,H,,,.......,,,A,,,H,,,..,X-------------------------------------------------------------------------------
X,.....,.....,,,,:,....:,,............,..,.....,,.......,,,,,,,,,,,.......,,..,X-------------------------------------------------------------------------------
X,.....,,,,,,,,,,,,,,,,,,,............,..,.....,H.......A,,,,,,,,,H.E...E.A,..,X-------------------------------------------------------------------------------
X,.....,,++,,,,,,,+,,,,,,,............,..,.....,,.....E.,,...,H..,,.......,,..,X-------------------------------------------------------------------------------
X,.....,....,,.,.,+...,.,,............,..,.....,,.......,,...,...,,.......,,..,X-------------------------------------------------------------------------------
X,.....,.,,,...,.,+,,,,.,,............,..,.....,,..E....,,,E,.,E,,,.......,,..,X-------------------------------------------------------------------------------
X,.....,,.....E,.,+.....,,............,.,......,,.......,,,,,,,,,,A....T..,,..,X-------------------------------------------------------------------------------
X,.....,...H...,.,+.....,,............,.,......,A.......H,,,,,,,,,,.......H,..,X-------------------------------------------------------------------------------
X,.....,,......,.,+.E..E,,............,,,......,,H,,,,,,,,.......,,,,,,,A,,,..,X-------------------------------------------------------------------------------
X,.....,.,,,.E.,,,+.....,,............,.,......,,,,,+,A,,,.......,,H,,+,,,,,..,X-------------------------------------------------------------------------------
X,.....,....,,.,,,+.....,,............,.,........,,.,,,,...........,,.,,,,....,X-------------------------------------------------------------------------------
X,.....,,,,,,,,,,,,,:,,:,,............,.,........,,...,,...........,,,..,,....,X-------------------------------------------------------------------------------
X,.....,..,+,......,,..,,,............,.,........,,...,,...........,,..E,,....,X-------------------------------------------------------------------------------
X,.....,,,,,,,,,,AA,AAAA,A............,,,........,,E..,,.,,,.ttt...,,,,.,,.E..,X-------------------------------------------------------------------------------
X,.....,:.....,,HHHH.HHH..............,.,........,,.,,,,.,T,Ht.,...,,..,,,....,X-------------------------------------------------------------------------------
X,.....,H.....,,,,,,,,,,HHH,,,,,,,,,..,.,........,,,..,,.,,,.ttt...,,..,,,.ttt,X-------------------------------------------------------------------------------
X,..E..,H..E..,,:,,HH,H,H,H,,,,A,,:,..,.,....E...,,.,,,,...........,,,,.,,.tTt,X-------------------------------------------------------------------------------
X,.....,H.....,,,...,,,H,H,,..,.A,,,..,.,........,,...,,...........,,..E,,.ttt,X-------------------------------------------------------------------------------
X,.....,H.....,,....,.......E.,...A,...,.,.......,,E..,,...........,,.H.,,....,X-------------------------------------------------------------------------------
X,.....,H.....,,....,..E......,.E.A,...,.,.......,,...,,.....E.....,,,..,,....,X-------------------------------------------------------------------------------
X,.....,H.....,,....,..,,,,,,H,...,,...,.,.......,,.,H,,...........,,.,,,,....,X-------------------------------------------------------------------------------
X,.....,:HHHH:,,:.H.,..HHHHHH,,W.,:,...,.,.....,,,,,++,,,,.......,,,,,++,,,,..,X-------------------------------------------------------------------------------
X,.....,,,,,,,,,,,,,,,,,,,,,,,,,,,,,...,.,.....,,A,,,,A,,,.......,,H,,,,H,,,..,X-------------------------------------------------------------------------------
X,.....................................,.,.....,,.......,,,,,,,,,,,.......,,..,X-------------------------------------------------------------------------------
X,.....................................,.,.....,H.E.....H,,,,,,,,,A....E..H,..,X-------------------------------------------------------------------------------
X,.....................................,.,.....,,..ttt..,,,.,.,.,,,.......,,..,X-------------------------------------------------------------------------------
X,.....................................,.,.....,,..t.t..,+,E,.,E,+,..E....,,..,X-------------------------------------------------------------------------------
X,..........E..........................,.,.....,,..ttt..,,...,.H.,,.......,,..,X-------------------------------------------------------------------------------
X,.....................................,.,.....,A.E.....,,,,,,,,,,,.......A,..,X-------------------------------------------------------------------------------
X,.....................................,.,.....,,.......A,,,,,,,,,A.......,,..,X-------------------------------------------------------------------------------
X,..H..................................,.,.....,,A,,,,H,,,.......,,A,,,,H,,,..,X-------------------------------------------------------------------------------
X,.....................................,.,.....,,,,,,,,,,,.......,,,,,,,,,,,..,X-------------------------------------------------------------------------------
X,.....................................,.,....................................,X-------------------------------------------------------------------------------
X,......................................,,...................H................,X-------------------------------------------------------------------------------
X,......................................,.,...........................E.......,X-------------------------------------------------------------------------------
X,......................................,.,...................................,X-------------------------------------------------------------------------------
X,,,,,,,,,,,,,,,,,,,,,,,,,,,,,,,,,,,,,,,,,,,,,,,,,,,,,,,,,,,,,,,,,,,,,,,,,,,,,,X-------------------------------------------------------------------------------
XXXXXXXXXXXXXXXXXXXXXXXXXXXXXXXXXXXXXXXXXXXXXXXXXXXXXXXXXXXXXXXXXXXXXXXXXXXXXXXX-------------------------------------------------------------------------------
