--------------------------------------------------------XXXXXXXXXXXXXXXXXXXXXXXXXXXXXXXXXXXXX----
-------------------------------------------------------X,,A,,,,,,,,,,,,,,,,,,,,,,,,,,,,,,,,,X----
-------------------------------------------------------X,.......,EE.EE..E..E..E.E.AH..E.E.T.X----
------------------------------------------------------X,........,...........................X----
------------------------------------------------------X,...,,,,,,,,,,,,,,,,,,,,,,,,,,,,,,,,,X----
------------------------------------------------------X,,,,,XXXXXXXXX,ttXXXXX,ttXXXXXtttXXXXX----
------------------------------------------------------X,,,,,X---XXXXX,,,XXXXX,,,XXXXX,,,XXXXX----
------------------------------------------------------X,E.,.X---XH....H....................HX----
------------------------XXX-----XXX-----XXX-----XXX---X,.E,.X---X.................<.........X----
------------------------X:X-----X:X-----X:X-----X:X---X,..,.X---X......................T....X----
XXXXXXXXXXXXXXXXXXXXXXXXX,XXXXXXX,XXXXXXX,XXXXXXX,XXX-X,E.,.X---X<............H...........:.X----
X.E..,,.....E...,.......,..,HH.,...,.HE,,..,HH.,.A.HX-X,..,.X---X...........................X----
XH,E.,,.........,.:,,,,:,..,...,E..,...,,..,...,....X-X,..,.X---X.....,H,,XXX,H,XXX,H,XXX,H,X----
X.E..,,..:......,.,.....,...,.,.....,.,.,...,.,.....X-X,.E,.X---X.....,..HXXX...XXX...XXX...X----
XX>>>XX.........,.,...,.,....,.......,..,....,......X-X,..,.X---X.....XX....................X----
------X.........,.,..,..,...............,......E....X-X,..,.X---X.....XX....................X----
------XXXXXXX...,.,.,,,A,...............,...........X-X,.E,.X---X.....XX....................X----
------X......,..,.,.,H,.,...............,...........X-X,..,.X---X.....H...........E..E....E.X----
------X......,,.,.,.,,,.,...............,...........X-X,..,.X---X.....,.................H...X----
------X.......,,,.,..,,.,...............,...........X-X,.E,.X---X.....,....,,,,,,,,,,,,,,,,,X----
------X...E....,,.,...,.,...............,...........X-X,E.,.X---X.....H...H,,,,,,,,,,,,,,,,,X----
------X........,,.:....:,...............,...........X-X,..,.X---X.....,....,,...H.H.H.......X----
------X........,,.,,,,,,,...............,.:,,,,:,...X-XXX+XXX---X.....XX...,,H,,,,,,,,,,,,,,XXX--
------X........,,.......,...............,.,.....,...X---X.X-----X.....XX...,,.,...E.E.E.E.E.t.X--
------X,,,,....,,.......,...............,.,...,.,...X---X,X-----X.....XX...,,.,.,,,,,,,,,,,,XXX--
------X..E,,...,,.......,...............,.,..,..,...X---X.X-----X.....,....,,.,.,........A.TX----
--XXXXX....,,..,,.......,...............,.,.,,,A,...XXXXXEX-----X.....H..<.,,E,A,.,,,,,,,,,,XXX--
--X...,EH..,,K.,,..E....,.......A.....E.,.,.,H,.,...,E..,.X-----X.....,....,,.,.,E,.E..EE..Et.X--
--XEXXX....,,..,,.......,...............,.,.,,,.,...XXXXXXX-----X.....XX...,,.,.,.,.,,,,,,,,XXX--
--X.X-X,,,,,...,,.......,...............,.,..,,.,...X-----------X.....XX...,,.,.,E,E,.E.H..TX----
--X,X-X,,,,....,,.......,...............,.,...,.,...X-----------X.....XX...,,E,.,.,.,.,,,,,,XXX--
--X.X-X........,,.......,...............,.:....:,...X-----------X..:..,....,,.,H,E,.,E,H.EE.t.X--
--X,X-X........,,.:,,,,:,...............,.,,,,,,,...X-----------X.....H....,,.,.,.,A,E,.,,,,XXX--
--XEX-X...E....,,.,.....,...............,...........X-----------X.....,....,,E,A,.,H,.,.,A.TX----
--X,X-X........,,.,...,.,...............,...........X---------XXX.....XX...,,.,.,E,T,E,.,.,,XXXXX
--XEX-X.......,,,.,..,..,...............,...........X---------W++.....XX.T.,,.,T,.,.,.,T,E,TAHt.X
--X,X-X......,,.,.,.,,,.,...............,...........X---------XXXH....XX...,,tXXXtXXXtXXXtXXXXXXX
--X.X-XXXXXXX,..,.,.,H,A,...............,......E....X-----------X.....H...H,,.X-X.X-X.X-X.X------
--X,X-XXXXXXX...,.,.,,,.,...............,...........X-----------XXX<XXXXXXXXXXX-XXX-XXX-XXX------
--XEX-X.........,.,..,,.,...............,...........X-------------X.X----------------------------
--X,XXX.........,.,...,.,....,.......,..,....,......X-------------XXX----------------------------
--X..+,..:......,.:....:,...,.,.....,.,.,...,.,.....X--------------------------------------------
--XE.+,.........,.,,,,,,,...HH,..A..HH,.,...HH,....,X--------------------------------------------
--X..+,.........,.......,..,...,...,...,,..,...,...HX--------------------------------------------
--XXXXXXXXXXXXXXXXXXXXXXX,XXXXXXX,XXXXXXX,XXXXXXX,XXX--------------------------------------------
------------------------X:X-----X:X-----X:X-----X:X----------------------------------------------
------------------------XXX-----XXX-----XXX-----XXX----------------------------------------------
