--------------------------------XXX>XX---------------------------------
--------------------------------X....X---------------------------------
--------------------------------X....X---------------------------------
--------------------------------X....X---------------------------------
--------------------------------X....X---------------------------------
--------------------------------X....X---------------------------------
--------------------------------X....X---------------------------------
--------------------------------X....X---------------------------------
--------------------------------XLLLLX---------------------------------
--------------------------------XLLLLX---------------------------------
--------------------------------XLLLLX---------------------------------
--------------------------------XLLLLX---------------------------------
---------------------------XXXXXXLLLLXXXXXXX---------------------------
---------------------------:..............:X---------------------------
---------------------------X......:........X---------------------------
---------------------------X...............X---------------------------
---------------------------X......W........X---------------------------
---------------------------X...............X---------------------------
---------------------------X...............X---------------------------
---------------------------X...............X---------------------------
---------------------------X.......E.......X---------------------------
---------------------------X...............X---------------------------
---------------------------X...............X---------------------------
---------------------------X...............X---------------------------
---------------------------X...............X---------------------------
---------------------------X...............X---------------------------
---------------------------X...............X---------------------------
---------------------------X...............X---------------------------
---------------------------:XXXXXXX,XXXXXX:X---------------------------
XXXXXXXXXXXXXXXXX------------XXXXXX.X-----------------XXXXXXXXXXXXXXXXX
:.......A.A....:X------------XH..XX.XXX---------------:.......:......:X
X...............X------------X...++...X---------------X...............X
X...............X------------X...XX,XXX---------------X.......W.......X
X...............X------------X...XX.X-----------------X...............X
X...............X-------XX---X...XX.X-------XX-----XXXX...............X
X...............X-------XX---X:.WXX.X-------XX-----X.XX...............X
X...............XXXXXXXXXXXXXXXXXXX,XXXXXXXXXXXXXXXX.XX...............X
XK.....H........,A......,,....,..<.<<.<.,...,,......A.,...............X
X...............XX.XXXXXXXXXXXXXXXX,XXXXXXXXXXXXXXXXXXX.......H......KX
X...............XX.X----XX--------X.X-------XX--------X...............X
X...............XXXX----XX--------X.X-------XX--------X...............X
X...............X-----------------X.X-----------------X...............X
X......W........X-----------------X,X-----------------X...............X
X...............X---------------XXX.X-----------------X...............X
X......:........X---------------X...X-----------------X......A.A......X
:XXXXXXXXXXXXXX:X---------------XXX.X-----------------:XXXXXXXXXXXXXX:X
---------------------------XXXXXXXX,XXXXXXXX---------------------------
---------------------------:..............:X---------------------------
---------------------------X...............X---------------------------
---------------------------X...............X---------------------------
---------------------------X...............X---------------------------
---------------------------X...............X---------------------------
---------------------------X...............X---------------------------
---------------------------X...............X---------------------------
---------------------------X:.W....H......AX---------------------------
---------------------------X..............AX---------------------------
---------------------------X...............X---------------------------
---------------------------X...............X---------------------------
---------------------------X...............X---------------------------
---------------------------X...............X---------------------------
---------------------------X...............X---------------------------
---------------------------X.......K.......X---------------------------
---------------------------:XXXXXXXXXXXXXX:X---------------------------
-----------------------------------------------------------------------
