---------------------------------------------XXXXXXXXXXXXXXXXXXXXXXXXXXXXX------------------------------------------
-------------------------------------------XX.,E.,.,.,.,,,E,,,,,.,,,,,,,.,X-----------------------------------------
------------------------------------------X,,,.,,.,,..,,,,.,,,,,.,,,,,,,.,,X----------------------------------------
XXXXXX-XXXXXXXXXXXXXXXXXXXXXXXXX--------XX..,,,.XXXXXXXXXXXXXXXXXXXXXXXX,,..X---------------------------------------
X....X-X.....................,,X--------X,,,..XX------------------------X,.,X---------------------------------------
X.H..X-X...A.................T,X--------X.,,,X------XXXXXXXXX-----------X,,.X---------------------------------------
X....X-X,XXXXXXXXXXXXX.XXHXXX,,X-------X,...X-------X........XXXXXXX----X....X--------------------------------------
X.E..X-XEX-----------X.X----X..X-------X.,,.X------X<..:.....A......X---X,,,,X--------------------------------------
X....X-X.X-----------XEX----X..X------X,,A.X-------X...............WX---X....X--------------------------------------
X....X-X.X-----------X.X----X.AX------X..,X--------X<...............XXXX,K.EX---------------------------------------
X.E..X-X.X-----------X.X----X..X-----X,,,,X--------X...............XX....,,.X---------------------------------------
X....X-X.X-----------X.X----X..X-----X....X--------X<............XXX.......X----------------------------------------
X....X-XEX-----------X.X----X.AX-----X,,,,X------XX+<.........:.X-X........:X---------------------------------------
X..E.X-X.X-----------XAX----X..X-----X,,,,X-----X,.+......:....X-X...........X--------------------------------------
X....XXX.X-----------XAXX---X..X-----X....X----X..,+H..........XX.............X-------------------------------------
X......+EX-----------X...XXX...X-----X,,,,X---X.,.XX..........+.,..............X------------------------------------
XE....E+.X-----------X....E.A..X-----X,,,,X---X..X-X..........+,...............X------------------------------------
X....E.+.X------------XX...XXXX------X....X--X,,.X-X........:X.,E.....E.......H.X-----------------------------------
X.....E+.X--------------XXX----------X,,,,X--X..,X--XA.......XX.................X-----------------------------------
X....E.+.X---------------------------X,,A,X--X...X--X.......X-X................X------------------------------------
X.....E+.X---------------------------X....X--X.,X---X.......XX..............:.X-----------------XXX-----------------
XE....E+EX---------------------------X,,,,X--X,.X----X.....X-X...............X--X------------XXX...X----------------
X......+.X---------------------------X..,,X--X...X-XXX.....XX.........:...,+X-XXX----------XX....:..XX--------------
XA...EE+.X---------------------------X,,.,X--X..,XX..XX.A.X-X.........XXX+++XX.EX---------X...........X-------------
X......+EX----------------------------X,,.X--X,,...E.XXXXX-X.........X--X++.....X--------X............X-------------
X.E.EXXX.X----------------------------X.,,X---X.......X----X.........X--X.E.....X------XX..............X------------
X....X-X.X----------------------------X,..,X--X........X--X..........X-XH.......X-----X................X------------
X....X-X.X-----------------------------X,,.X---X.W.....X--X..........X-X........X----X..................X-----------
X.E..X-X.E------XXXXXXXXX--------------X,,,X----X..A....X-X.....:....X--XH......X----X..................X-----------
X....X-X.X--XXXX.........XXXX----------X,,,X----X.....:X--X...........X-XH.......X--X.......XX.......K...X----------
X....X-X.X-X.................XX--------X...X-----X....X---X.E.........X-X........X--X:....XX--X::........X----------
XE...X-X.X-X......XXXXX.E...E..X------XXX,,XXX----X..X----X..........AX-X.H..:...X--X.....X----X..........X---------
X....X-X.XX...XXXX-----XXXX....X------XB....BX----XHX-----X..E.......X---XH......X--X....X------A.........X---------
X....X-XEX....X------------XX..X------B.....BX-----X------XX.....XXXX---XX.......X---X...X------X..........X--------
X....X-X.....X--------------X..X------B..,....X-------------XXXXX---XXXX.........X---X.,,.XXXX---X.....E...X--------
X..E.X-X.....X--------------X...X-----B.,.,.B.X-----------------XXXX.............X----X..,.,,X---X.........X--------
X....X-X.E..X---------------X...X-----X.,.,.B.XXX------------XXX.................X-----X.,.,E.X---X.........X-------
X....X-X.X...X--------------X.H.X-----B,,.,,B....X---------XX.,..................X------XXXX.,,X--X........HX-------
XE...X-X.XX..X-------------X....X-----B.,.,.B.....X-----XXX...,....E.............X----------XE.X--X.........X-------
X....X-X.XX...XX-----------X.E.X------B.,.,.B.....X---XX......A..................X------XX---X,,X-XH........X-------
X.E..X-XEX-X....XX-----XXXX....X------B.,.,.B..E..X--X........,......XXXXXX:.....X-----X.,XX-XE,X--X........X-------
X....X-X.X-X......XXXXX.....E.X-------B.,.,.B.....X--X........,.....X------XX....X----X,,,.,X,,.X--X........X-------
X.E..X-X.X--XX......A..E...A.+X-------B.,.,......X--X.....A...XXX..X---------X...X----X.XXXXXE,X---X.........X------
X....X-X.X----XXXX.........+++X-------B.,.,.B..XX---X.........X-X..X----------X...X--X,,X----XX----X.........X------
XH...X-X.X--------XXXXXXXXX++..X------B.,,,.BXX-----X........X--XHX-----------X...XXXX,,XXXXXXXX---X.........X------
X....X-X.X----------------X.AA.X------B....BBX------X........X-X..X-----------X...X:......:XAAAX----X........X------
X.E..X-X+X----------------X.....X-----B...B.BX-----X...E....X--X..X-----------X.E.X.......XX..AX----X........X------
X....X-XEX----------------X:..A.AX----B.B...BX-----X........X--XH.X-----------X...X.......XX...XX---X.........X-----
X....X-X.X----------------XH...H.X----B..B.BBX-----X.......X---X.X----------XXX...X.......XX.H.,,XX-X........:X-----
X.E..X-X.X----------------X.....AX----B.B...BX-----X.......X--XH.X-------XXX..,...X.......XX...XX,XXX:........X-----
X....X-X.X----------------X.A.H..X----B...,.BXXXX--X....W.X---X..X------X....,....X..,,,..XXA.WXX,,,X.........X-----
X....X-X.X-----------------X....X-----B..,.,B....X-X.....X----XHX------XA.E..,....+..,T,..XX...X-XX,,.........X-----
XE...X-X.X------------------X...X-----X.,..,B.....X-XX..X-----X.X------X....,.....+..,,,..XXAAAX---XX,,,,K,,,,XXXXX-
X....X-X.XXXXXXXXXXXXXXXXXXXX+++X-----B,,,.,B..E..X---XX-----X..X-----X.....,.....+.......X-----XXXX.H............X-
X....X-XE.......................X-----B..,.,B.....X----------XH.X-----X.....,.....X.......XXXXXX..................X-
X....X-X...............E..E.E...X-----B..,.,......X-XXXXXX--X..X-----X.....,......X.......XX......................X-
X....X-X.XXXXXXXXXXXXX..XXXXXXE.X-----X..,.,B....X-X......XX.H.X-----X.....,......X.......XX..................E...X-
X.E..X-XEX-----------X..X----X..X-----B..,.,B....X-X...........X----X..E..,.......X.......++......................X-
X....X-X.X-----------X..X----X..X-----B..,.,BXXXX-X...........X-----X.....,.......X.......++......................X-
X....X-X.X-----------X.EX----X.EX-----B..,.,.X----X..E........X----X......,.......X......E++......................X-
XA...X-X.X-----------X..X----X..X-----B..,,,BX----X.........A.X----X.....,........X.......XX......................X-
X....X-X.X----------XX..X----X..X-----B....BBX----X...........X---X......,........X:......:-X.....................X-
X....X-XEX--------XX..E.X----X.EX-----X...B.BX-----X.........X----X......,........XXX+++XXX--XX...................X-
XE...X-X.X------XX......X----X..X-----B.B...B.X----X...H.....X---X......,.........X-X...XXX----X..................X-
X....X-X.X---XXX.....XX.XX---XE.X-----B.B..B.BX-----XX.......X---X..E...,.........X-X.E...X-----X.................X-
X....X-X.X-XX.A....XX-X.E.XXX...X-----X.B...BBX-------XXX...X---X......,..........X-X.....X------X................X-
X....X-X.XX.....XXX---XX.E...E.X------B..,..BBX----------XXX----X.H....,..........X-X.....X-------X...............X-
X..E.X-X.....XXX--------XXX...X-------B.,.,.B.BX----------------X......,.....:....X-X.....X-------X................X
X....X-X.E.XX--------------XXX--------B.,.,.B..BXXX-------XXX----X....,...........X-X.:...X--------X...............X
X.E..X-X.XX---------------------------B,,.,,B..BB.,XXX--XX...XX--XX...,E..........X-X.....X--------X...............X
X....X-X.X----------------------------B.,.,.B...,.,W,X--X..H...X---XX,............X-X.....XXXX------X..............X
X....X-XEX----------------------------B.,.,.B...,.,.,X-X.A.....X-----XX...........X-X.....+...XX-----X.............X
X....X-X.X----------------------------B.,.,.B...,.,,,X-X........X------XX........X--X.....+.H...X----X.............X
X..E.XXX.X----------------------------X.,.,.B...,....X-X........X--------XX......X--X.....+......X----X............X
X.....E+.E----------------------------B.,.,.B...,....X-X....E....X---------X.....X--X....:XX......X---X......E.....X
X...E..+.X----------------------------B.,.,.B...,.E..X-X..........X---------X....X--X.....X-XX.H..X----X...........X
X.....E+.X----------------------------B.,,,.B...,....X-X..........X---------X..E.X--X.....X---XX...X---X...........X
XH..E.E+.X----------------------------B.....B...,...X--X...........X---------X...X--X.....X-----XE..X--X...........X
X......+EX----------------------------B.....B...,...X-X............X---------H...X--X.....X------X..X--X...........X
X.E...E+.XXXXXXXXXXXXXXXXXXXXXXXX-----B.....B...,...X-X............X--------XH...X--X.....X------X..X---X..........X
X...E.E+.............E....E..E.HX-----B.....B...,.A.X-X.............X-------X....X--X.....X-------XH.X--X..........X
X......+................E..E....X-----B.........,...X-X.............XX-----X.....X--X....:X-------X..X--XLLLXXXXXXXX
X...E.E+.XXXXXXXXXXXX.XXXXXXXXXXX-----B.....B...,...XX......:.......H.XX--XXH....X--X.....XXXXXXX-X..X-XX+++XX------
X.....E+.X--------XX.E.XX-------------BA.AAAB...,...XX.........E......H.XX.,...E.X--X.....,....AX-X..X-X.....X------
XE...XXX.X-------X--X.E..XX-----------XXX,,,XXXXXXXXXX..................HE.,.....X--X.....,.....X-X.HX-X.....X------
X....X-XEX-----XX--X-XX.A..X---------XXXX+++XXX------X.....................,.....X--X.....,.E...X-X..X-X....EX------
X..A.X-X.X---XX..XX----XX..EXX-------X...:....XXXXXXX..................E..E.,....X--X.....,.....X-X..X-Xttt..X------
X....X-X.X--X...X--------XX.E.XX-----X.....E..X..:.XX.:.....................,...:X--X.....,....AX-X..X-Xt.t..X------
X....X-X.XXX...X-----------X...EX----X........X....XXXXXX+++XXXXXXXXXXXXXXXXXXXXXX--X.....XXXXXXX-X..X-Xttt..X------
X.E..X-XEX....X-------------XX..X----X........,....XXXXXX+++X-----------------------X.....X-------X.EX-XXXXXXX------
X....X-X....XX----------------XXX----X.E.E....,....XXA..,...XXXXXXXXX---------------X.....X-------X..X--------------
X.H..X-X...X--------------------X----X.......W,....XX...,......,+..AX---------------X....HX--------X..X-------------
X....X-XE.X--------------------------X..E.....X...X-X...,......,+...X-XXXXXXXXXXXXXXX+++++XXXXX----XH.X-------------
X.E..X-X..X--------------------------X........X...X-X...,......,+.E.X-X.............,.....,...X----X..X-------------
X....X-X..X--------------------------X....E...X...X-X.E.,...:..,+...X-X.E............,,,,,,...X-----X..X------------
XXXXXX-X..X--------------------------XA.......X...X-X...,......,+...X-X..............,....,...X-----X.HX------------
-------X..X--------------------------X........X+++X-X...,......,+...X-X............E..,,,,,...X-----X...X-----------
-------X..X--------------------------XXXXXXXXXX...X-X...,...:..,+...X-X...............,...,...X------X..X-----------
-------X..X--------------------------X........X...X-X...,......,+...X-X...............,..,,.E.X------X..X-----------
-------X...X-------------------------XH.......X...X-XH..,......,+..HX-X...............,,,.,...X-------E.X-----------
-------X...X-------------------------X.....E..X...X-X...,......,+...X-X...............,...,,..X-------X.X-----------
-------X...X-------------------------X.H......+...X-X...,...:..,+...X--X...............,,,.,..X-------XEX-----------
-------X...X-------------------------X...E...E+.H.X-X...,......,+...X--X......ttt......,...,..X-------X.X-----------
-------X...X-------------------------X........+...X-X.E.,......,+...X--X......t.t......,,,,,..X-------X.X-----------
------->>>>X-------------------------X.:..E...X...X-X...,......,+...X--X......ttt......,...,..XXXXXXXXX,X-----------
-------------------------------------X........X...X-X...,...:..,+.E.X--X...............,...,..,.........X-----------
-------------------------------------X........X+++X-X...,......,+...X--X...............,,,,,..,.E..E.E.HX-----------
-------------------------------------X....E...XE.EX-XA..,......,+..AX--X...............,.,,...,.........X-----------
-------------------------------------XH.......X...X-XXXXXX.....XXXXXX--X...............,,.,...XXXXXXXXXXX-----------
-------------------------------------X........X...X------X:++++:XXXXXXXXE..............,,,,...X---------------------
-------------------------------------XXXXX++++X...XXXXXXXX.....XH......,.,,,,,,......,,,,,,...X---------------------
-----------------------------------------X....X....++..........L+..E...,.,,.,,.,,,.,,:....,...X---------------------
-----------------------------------------XH.:.X....++..:...H:..L+.....,..,,.,,.,,.,,.,..E.,...X---------------------
-----------------------------------------XXXXXX....++..........L+.....,.,.,,.,,.,.,,.,.A..,...X---------------------
-----------------------------------------------X..XXXXXXXXXXXXXXHXXXXXX,,,,,,,,,,.,,,.....,...X---------------------
-----------------------------------------------X..X-------------------X.........,,,,,..E..,...X---------------------
-----------------------------------------------X..X-------------------X............,,,,,,,:...X---------------------
-----------------------------------------------XE.X-------------------X........E........,.....X---------------------
-----------------------------------------------E.EX-------------------X.....ttt.........,,..E.X---------------------
-----------------------------------------------X:.X-------------------X.....t.t.........,,,...X---------------------
-----------------------------------------------XXXX-------------------X.....ttt...........,,,.X---------------------
----------------------------------------------------------------------X....................,.,K---------------------
----------------------------------------------------------------------XXXXXXXXXXX,,,XXXXXXXXXXX---------------------
--------------------------------------------------------------------------------X...X-------------------------------
--------------------------------------------------------------------------------X...X-------------------------------
--------------------------------------------------------------------------------X.E.X-------------------------------
--------------------------------------------------------------------------------X...X-------------------------------
--------------------------------------------------------------------------------X...X-------------------------------
--------------------------------------------------------------------------------X.E.X-------------------------------
--------------------------------------------------------------------------------X...X-------------------------------
--------------------------------------------------------------------------------X...X-------------------------------
--------------------------------------------------------------------------------X..EX-------------------------------
--------------------------------------------------------------------------------XXXXX-------------------------------
