-----------XEXXX----------------------------------------------------------------------------------------------------------------------------------
-----------X..EX----------------------------------------------------------------------------------------------------------------------------------
-----------XE..X----------------------------------------------------------------------------------------------------------------------------------
-----------XtttX----------------------------------------------------------------------------------------------------------------------------------
-----------X...X----------------------------------------------------------------------------------------------------------------------------------
-----------XXXXX----------------------------------------------------------------------------------------------------------------------------------
-----------X,,,X----------------------------------------------------------------------------------------------------------------------------------
-------XXXXX,,,XXXXX------------------------------------------------------------------------------------------------------------------------------
-----XX:..........:.X-----------------------------------------------------------------------------------------------------------------------------
----X................X----------------------------------------------------------------------------------------------------------------------------
---X........:.........X---------------------------------------------------------------------------------------------------------------------------
--X............E....H..X--------------------------------------------------------------------------------------------------------------------------
--X:......E...........:X--------------------------------------------------------------------------------------------------------------------------
--X....................X--------------------------------------------------------------------------------------------------------------------------
--X.........XX.........X--------------------------------------------------------------------------------------------------------------------------
--X.......X,XX,XX......X--------------------------------------------------------------------------------------------------------------------------
--X......,X....XX.E....X--------------------------------------------------------------------------------------------------------------------------
--X....E.XX.W...X......X--------------------------------------------------------------------------------------------------------------------------
--X......XX.....X......X--------------------------------------------------------------------------------------------------------------------------
--X......,...A..,......X----------------------------------------------------------------------------XXX-------XXX-------XXX-------XXX-------------
--X......XX..E..X....H.X----------------------------------------------------------------------------X:X-------X:X-------X:X-------X:X-------------
--X:,,,XXX:XXXX:XXXXXX:X------------------------------------------------------------------------XXXXX,XXXXXXXXX,XXXXXXXXX,XXXXXXXXX,XXXXX---------
---X+++X--------XXX----------------------------------------------------------------------------X.................................,.......XX-------
XXXX,,,XXXXXXXXXX,XXXX------------------------------------------------------------------------X.E........,,,,,,,,...........E.,,,,........X-------
X:.......,,.XX...<..<X-XXXXXXXXX------------------------------------------------------XXXXXXXXX,,,,,:,,,,.,.:.,..,,,:,,,,,,...,:.,..B.....X-------
X........,,..,.,,.,,.XXX.....E.:------------------------------------------------------X,,,....,...,...,...,...,...,...,...,...,..,........XXXXXX--
X........,,..,.,,.,,.,,,.......X------------------------------------------------------X,:,..A.,...,...,...,...,...,...,...,.E.,,,,,,,,,..E,,:..X--
X..E.....,,..,...<..<,,,......EX------------------------------------------------------X,,,....,...,...,...,...,...,...,...,......,,,,,,...,,...XXX
X........,,..,.,,.,,.,,,.......X------------------------------------------------------X.......,...,.T.,...,...,...,...,...,.W..E.A,,E,,..E,,...>.X
X........,,..,.,,.,,.XXX.....E.X-----------------------XXXXXXXXXXXXXXXXXX----------XXXX....,,,,...,...,...,...,...,...,...,......,,,,,,...,,...XXX
X:,......,,.XX.......X-XXXX+XXX:-----------------------X..E.............X----------X:XX,,,.,A,,...,...,...,...,...,...,...,.E....,,,,,,..E,,:.:X--
X,,......,,,XXX,,,,,XX--XXX,XXXXXXX--------------------X.,,,,......,,,,HXXXXXXXXX-XX,XX,,,.,,,,...,...,...,...,...,...,...,...,,,,........XXXXXX--
XA,.......,..XX.....XX--XT.E.....EX--------------------XA,.,,......,.,,E,+,.....X-X.....,,XXXXX,,.,.:.,...,...,...,.:.,..,,...,:.,..B.....X-------
X,,.......,TW,.......X--X.........X----XXXXXXXX--------X.,,,,....E.,,,,.,+,.....X-X.....XX----X..,,,,,,,,,,,:,,,,,,,,,,,,...E.,..,........X-------
X:,.......,,,,,,,,,,,X-XXX,XX,XXX.X----X...,.,.XX------X.,,,,...E..,,,,W,+,..A..X-X..H..XXX----XE.............................,,,,........X-------
X,............,,,,,,,X-X.......XX.X----XE...E,.,.X-----XE....,,,,...A...,+,.....X-X.....,:X----XXXXXX,XXXXXXXXX,XXXXXXXXX,XXXXXXXXX,XXXXXX--------
X....................XXX.......,.HX----X,,XXXXX.,X-----X..E.H,.,,E......,+,.....X-X.A...XXX---------X:X-------X:X-------X:X-------X:X-------------
X..E.................,XX.......XX.XXXXXX,,XXXXXX.X-----X.....,,,,......HXXX,,,,,X-X,,,,,X-----------XXX-------XXX-------X,X-------XXX-------------
X....................XXX.......XX.XX.....E...:XX,.X----X.....,,,,.......X-X.....X-X.....X-------------------------------X.X-----------------------
X........A...........X-X,,.....,.EXX.,,,,,,,,.XX.:XXXXXX:........,,,,,,:X-X,,,,,XXX,,,,,X------------------------XXXXXXXX,XXXXXX------------------
X....................XXX,,,....XX.XX.,..,.,.,.XX..,,,,,,........,.......X-X.....,.,.....X------------------------X.............X------------------
X:...................,.,.,,....XX:XX.,,,,,,,,.,,.A,,,,,,..::....,:..:.:.X-X.....,.,.....X------------------------XtttttttttttttX------------------
XXXX,XX..............,.,EH,....,.W,,.,,H,W,H,W,,EA,,,,,,........,.......X-X..A..,.,..H..X------------------------X.............X------------------
---XXX-X..:..........,.,.,,....XX.XX.,,,,,,,,.,,..,,,,,,........,...:...X-X.....,.,.....X------------------------X....E....E...X------------------
-------X.............XXX,,,....XX.XX.,..,.,.,.XX.A,,,,,,..:.H...,.:...:.X-X.....,.,.....X------------------------X.............X------------------
-------XX............X-X,,.....,.EXX.,..,,,.,.XX..XXXXXX...,,,,.,.......X-XXXXXXXXXXXXXXX------------------------XXXXXXXXXXXXXXX------------------
-------X,.........E..XXX.......XX.XX..,,,,,,,.XX.:X----X:..,.,,E,:..:.:.X-------------------------------------------------------------------------
--------X............,XX.......XX.XX.....E...:XX,XX----X.E.,,,,.,.......X-------------------------------------------------------------------------
--------X...E..E.....XXX.......,.HX-XXXX,,XXXXXX,X-----X.E.,,,,.,.:.:.:.X-------------------------------------------------------------------------
--------X.:..........:-XXXX,,XXXXX:----X....E,,..X-----X.....E..:XXXXXXXX-------------------------------------------------------------------------
--------XXXXXXXXXXXXXX----X,,XX--------XE..,.,.,X-------XXXXXXXXX---------------------------------------------------------------------------------
--------------------------X...X--------XXXXXXXXX--------------------------------------------------------------------------------------------------
--------------------------X,,,X-------------------------------------------------------------------------------------------------------------------
--------------------------:,K:XXXX----------------------------------------------------------------------------------------------------------------
--------------------------X,,.X.AX-XXX------------------------------------------------------------------------------------------------------------
------------XXXXX---------X++XX.EXXtttX-----------------------------------------------------------------------------------------------------------
-------XXXX:X....XXXXX----X......,,t.tX-----------------------------------------------------------------------------------------------------------
-----XXX:E..,....,...X----X.E.E.EXXtttX-----------------------------------------------------------------------------------------------------------
-----X.t..A.,....,...X----XXXX,XXXX...X-----------------------------------------------------------------------------------------------------------
-----X.tEHA.,.K..,.ATX-------XtX---XXX------------------------------------------------------------------------------------------------------------
-----X.t..A.,....,...X-------XTX------------------------------------------------------------------------------------------------------------------
-----XXX:E..,.W..,...X-------XXX------------------------------------------------------------------------------------------------------------------
-------X...:,....,...X----------------------------------------------------------------------------------------------------------------------------
--------XXXXXXXXXXXXXX----------------------------------------------------------------------------------------------------------------------------
--------------------------------------------------------------------------------------------------------------------------------------------------
