----------------------------------------------------------------XXXXXXXXXXXXXXXXX----------------------
----------------------------------------------------------------X...............X----------------------
-----------------------------XXXXXXXXEXXXX:X--------------------X.E..E..E....E..X----------------------
-----------------------------H..H...........X-------------------X...............X----------------------
-----------------------------X...............XX-----------------X...............X----------------------
-----------------------------X.................X----------------X+++++++++++++++X----------------------
-----------------------------X,,,XXXX........:..X-------------XXX+++++++++++++++XXX--------------------
-----------------------------XLLLX--X...........EX------XXXXXXX...................X--------------------
-------------------------XXXXX,,,XXXX,............XX----X....++...................X--------------------
-----------------------XXB.B.,...,.B.,,,......W.....X---X.E..++..,,,,,,,,,,,,,,...X--------------------
---------------------XX..B...,...,E..B.,,...........:X--X....++..,,,,,,,,,,,,,,...X--------------------
-------------------XX........,...,B......,...........X--X....++..,A...........,...X--------------------
------------------X.....H,,..,,,,,........,..........X--XXXXXXX..,,.......E...,...X--------------------
-----------------X......,.,..,...,.........,.......E.X--------X,,,,...........,...X--------------------
-----------------X.E..,,,:,..,,,,,....,,,..,,........XXXXXXXXXX,,,,...........,...X--------------------
----------------X.....,...,..,...,.A..,H,.A.,,.......LL...,...,...............,...X--------------------
---------------X......,,,,,E.,,,,,..H.,,,....,,......LL..E,...,.......++++++..,...X--------------------
--------------X..............,...,:...........,,.....LL...,...,.......++++++..,...X--------------------
--------------X.........,,,,,,,,,,,,,,,.......,,.....XXXXXXXXXX,,,,...++++++.,,,,,XXX----XAXXHX--------
--------------X........,.............B.,.......,.....X--------X..,,..H+++.,+.,,...,.>----X....X--------
--------------X.......,........K.......B,......,,.A..X--------X..,,...++++,+.,,,,,XX>----X....X--------
--------------X..E....,.................,......,,....X--------X,,,,...++++++..,...X------X....X--------
-------------X........,.....,,,,,,,.....,.......,..E.X--XXXXXXX,,,,...........,...XXXXXX-X....XXX------
-------------X........,..E..,..W..,.....,.....B.,B...X--XH....,...............,...++...X-X....t.X------
-------------XB.......,.....,.....,.....,...B..B.,.B.X--X.....,...............,...++...X-X....XXX------
----:XXXXXXXXX,H,......,...H,.....,....,.........X...X--X.....,.............E.,...++...X-X...AX--------
----X........,..,....B..,,,,,,,,,,,,,,,.......B..XH..X--X...XXX,,,,...A..A....,...++.E.X-X,XXXX--------
----X........,..,.......B......E.................XXXXX--X...X-X..,,H..........,...++...XXX.X-----------
----XE.......,W.,.............................E..X------X.E.X-X..,,,,,,,,,,,,,,...++...+,..X-----------
----X........,..,.......B.......................X-------X...X-X...................++...XXXXX-----------
----X........,..,.................,,,,,.........X-------X...X-X...................XXXXXX---------------
----XH..XXXXXX,,,.................,.,H,.........X-------X...X-X.................E.X--------------------
----X...X----X..,H..,,,..........B,B,,,.........X-------X,,,X-XXXXXXXXXXXXXXXXXXXXX--------------------
----X...X----X..,...,.,............B,.,........X--------XLLLX------------------------------------------
----X,,,X-----X,,...,,,.......E.....,,,........X:XXXXXXXX,,,XXXXXXXXXXXXXXXXXXX------------------------
----X...X-----X..,............................X-X........E.H,.................X------------------------
----X,,,X-----X.,,..A.........................X-X...........,.................X------------------------
----XE..X------X..,........................B.X--X...,,,,,,,,,.............E...X------------------------
----X,,,X------X.,.,..................,,,,,..X--X...,.........................XXXXXXXX-----------------
----X...X-------X.,.,.................,.,.,.X---X...,,,,,,,,,,,,,,,,,,,,,,,,,,,,,,,,,.X----------------
----X,,,X--------XX,,,,...............,.,.,X----X...,,,,,,,,,,,,,,,,,,,,,,,,,,,,,,,,,,X----------------
----X...X---------X...,..B............,,,.,X----X...,,,,,...............E...........H,.X---------------
----X,,,X---------X.W.,B..............,...X-----X...,,,,,......E............E.........,.X--------------
----X..HX---------X...,...B.B.....A...,H..X-----X...,,,,,H..........A.A.AA............,,.X-------------
----X...X---------X,,,XXX.....,,,....XX,,,X-----X...,,,,,,,,,,,,,,,,,,,,,,,,,,,,,,,....,,X-------------
----X.E.X---------H...X--XXXX.,.,.XXX-X...X-----X...,..............................,.E..,.X------------
----X...X---------X.E.X------XX,XX----X...X-----X...,.B.B.....................XXXXX.,....,.X-----------
----X...X---------X...X-------X.X-----X...X-----X...,.B.......................X----X,,..A.,.X----------
--XXX,,,XXXXXXXX:-X...X-------X,X-----X...X-----X...,.........................X-----X,,...,,X----------
--X............HX-X...X-------X.X-----X...X-----X...,.........................X-----X.,,...,.X---------
--X:............X-X,,,X-------X,X-----X...X-----A...,..E...................B..X-XXXXX,,,,,,,,,XXXXXXXXX
--X......XXX,,,X:-X+++X-------X.X-----X...X-----X...,.......................B.X-X......,,...,.........X
--XA....,.XX,,,XXXX,,,XXXXXXXXX,BXX---X..AX-----X,,,X.....................B...X-X......,,...,.........X
--X...XX.,......E...........B.,.,..X--X..AX-----XLLLXXXX,,,,XXXXXXXXXX,,,,,,XXX-X...,,,,,...,,,,,,,...X
--XA..X-X.B.,,,...............,,,...X-X...XXXXXXX,,,XXXX,,,,XXXXXXXXXX,,,,,,XXXXX...,:,,,...,,,,,:,...X
--X...X-X...,H,...............,.,....XX..AXX...,,E..,...........................X...,,...........H,...X
--XA..X-X...,,,.......,,,.....,,,....HX..AXX...,,...,...........................X...,,.,,,,,,,,,,.,...X
--X.E.X-X.............,.,.....,.,.....X..AXX...,,..E,...........................X...,,.,.......E,.,...X
--X...XXX,,...........,,,.....,,,.....X...XX...,,...,...........................X...,,.,........,.,...X
--X...,+,.,...........................,..AXX...,,...,,,,,,,,,,,,,,,,,,,,,,,,,...X...,,.,........,.,...X
--X...,+,.,.........................E.,.EAXX...,,...,,,,,,,,,,,,,,,,,,,,H,,:,...X...,,.,........,.,...X
--X...,+,.,...........................,...XX...,,...H......E.......,,,,,..H.,...X...,,A,........,.,...X
--X...XXX,,,,...,,,...,,,,,,,...B.,,,.,..AXX...,,..................,,,,,..H.,...X...,,.,...E....,.,...X
--X...X-X.,.,...,.,...,..E..,.....,.,.,..AXX...,:..................,,,,,....,...,...,,.,........,.,...X
--X.E.X-X,,,,...,E,...,,,,,,,...,,,E,.,...XX...,,,,,,,,,,,,,,,,,,,,,,,,,,..H,...,...,,.,........,.,...X
--X,T,X-X.,.,...,.,.....A.....A.,...,.,..AXX...........................,,..H,...,...,,.,........,.,...X
--X,.,X-X,,,,...,.,.......,,,...,,,E,.X..AXXXXX,,,,,XXXX,,,,,,,,,XXX...,,...,...,...,,.,......W.,.,...X
--:,,,:-X.,.,...,.,.......,.,.........X...XXXXX,,,,,XXXX,,,,,,,,,XXX...,,..H,...,...,,.,........,.,...X
--XXXXX-X,,,,...,,,.......,,,.......A.X....X....................B..X...,,...,...X...,,.,...K....:.,...X
--------X.,.,...................E.A..XX....,....................B.BX...,,...,...X...,,.,........,.,...X
XXXXXXXXX,,,,.B....................XX-X....,.......................,...,,...,...X...,,.,...A....,.,...X
X.....EXX...,...B.,,,...........A.X---X.E..,.......................,...,,...,.E.X...,,.,........,.,...X
XB..tttXX...,B...............A.A.X----X....,.......................,...,,...,...X...,,.,........,.,...X
X.B.t.tXX..H,..................XX-----X....,...........,,,,,,......,...,,...,...X...,,.,........,.,...X
XB..tttXX+++XXXXXXXXXXX...XXXXX-------X...HX...........,,...,......,...,,.H.,...X...,,.,........,.,...X
X.....:XX+++X---------X...X-----------X..HXX..........,,..E..,....H,...,,...,...X...,,.,........,.,...X
X......XX...X---------X,,,X-----------X,,,XX..........,,....H,....H,...,,...,...X...,,A,........,.,...X
X.....:XXE..X---------X+++X-----------X+++XX..........,,..W..,.....,...,,...,...,...,,.A.......B,.,...X
X...:..XX..AX-XEXXXXXXX,,,XXXXX-------X,,,XX..........,,.....,.....,...,,.A.,...,...,,A,A.......,.,...X
X....:.,,...X-X................X------XE...X,.........,,.....,.....,...,,...,...,...,,.,.......B,B,...X
X...:..,,...X-X...,,,.......,,A.X-----X.....,,.........,,A..,......,B.B,,...,...,...,,.,........,.,...X
X.:....,,...X-X...,.,.......,.,..X----X......,,........,,...,....A.XXX.,,...,...,...,,.,........,.,...X
X.....:,,W..X-X.B.,,,.......,E,...X---X.......,XXX....H,,...,......X-X,,,.E.,...X...,,.,,,,,,,,,,.,...X
X...:..,,...X-X.............,.,....X--X........X-X.....,,...,,,,,,,XXX,,,...,...X...,:...........:,...X
X......,,...X-XB.B..........,,,.....X-X..XXXXX..XXH..H.,,...,.,,,,.LL,.....:,...X...,,,,,,,...,,,,,...X
X.....A,,...X-X.H.B................B.XX..XXEXX..XXXXXXXXX,,,XXXXXXXXXXXXXXXXXXXXX........,,...,.......X
X......,,...XXX,,,,,,...........,,,...X..XX.....X-------X,,,X-------------------XXXXXXXXXXXLLLXXXXXXXXX
X......,,...,+,.,,,,,,..........,.,...X..XX.....X-------X,,.X-----------------------------XLLLX--------
X.....:XX.E.,+,.,,,,,,..........,,,...,..XA.....X------X,..,X-----------------------------XE,,X--------
X:.....XH...,+,.,,,,.,..........B.B...,..XX.....X-----XX.,,.X-----------------------------X...X--------
X.....:XXXXXXXX,,,,,,,.........E......,..XA.W...XXXXXX,.,..,X-------XXXXXXXXXXXXXXXXX-----X...X--------
X......X------X.......................,..XX.....LL.,,,E,.,HX--------X...............X-----X...X--------
X......:X-----X.............,,,.......,..XXH....LL.,,,.,..X---XXXXXXX,,,,A,,A,A,,,,,XXX---X...X--------
X........X----X.............,.,.......,..XX.....LL.,,.,.,X----X:H..................E.:X---X...X--------
X......B.BX---X.............,,,,,A.W..,..XXE....XXXXXXXXX-----XH......................X---X...X--------
X.........X---X..........E..,.,.,.....,..XXXXX..X-------------X.......................X--X.,,,.X-------
X.......B.X---X<............,,,,,.....X..XXXXX..X-------XXXXXXX.......:.........:.....XXX.,...,HX------
X.........X---X......................HX.........X-------X,,.,.,.......................,+,.,...,.X------
X....E..H.XXXXX<......................X.........X-------X,XXXXX.....................E.,+,.,W..,.X------
X.........,.<.,......................XXXXXX+++XXX-------X.X---X.......................,+,.,...,.X------
X.E......H,:..,.......,,,,,.........XXXXXXX+++XXX-------X,X---X.......:.........:.....XXX.,...,.X------
X.........X.<.,.......,...,........,..B.......E.X-------X.X---X.......................X--X.,,,.X-------
X.........XXXXX.......,,,,,.......,.............XXX-----X,X---X:A.......A...E......H.:X---X+++X--------
X...E....:X---XA.................,.....XX.......,.X-----X.X---XXXXXXX,,,,,XXXXX,,,,,XXX---X+++X--------
X......:..X---X.........B.......,......XX...,,,.,.X-----X,X---XXXXXXX,,,,,XXXXX,,,,,XXXXBXX,,,XXXXXBX--
X.........X---XA...............,............,.,.,.X-----X.X---X...,.A.A...............B....E......B.X--
X...:.....X---X...............,............B,,,.,.X-----X,X---X...,.................................X--
X..:......X---XA.......B..B..,..................,.X-----X.X---X...,.................................X--
X.........X---X......E......X.........W..BXX....,.X-----X.X---X,,,,...............................E.X--
X.........X---XA...........XX.....XX......XX....,.X-----X.X---H...,....B............................X--
X.........X---X+++XXXXXXXXX-X...H.XX............,.X-----XEXX--X...,......B......................,,,,X--
X.........X---X+++X---------X...................,.X---XX....X-X...,.......XXX....E......XX......,...X--
X.........X---X...X---------XH................E.,.X---X.....X-X...,.....XX---X........XX--XX....,,,,X--
X.........X---X...X---------X...........A..E....,.X---X.....X-X...,.....X----X........X----X....,...X--
X.........X---X..,XXXXXXXXXXX..........AXX......XXX---XX....X-X...,....X------X....E.X------X...,,,,X--
X.........X---X,,,,,,,,,,,.++...........AX......X-------X.XX--X...,....X------X..K...X------X...,...X--
X.E.......X---X,,,,,,,,,,E.++....XX.............XXXXXXXXX,XXXXX...,....X------X......X------X...,,,,X--
X.........X---X.,,,,,,,,,,.++..BBXX..........XX.LL..,.,.,.,,,+,...,....X------X......X------X...,...X--
X.........X---XXXXXXXXXXXXXXX................XX.XXXXXXXXXXXXXXX...,.....XX---X........XX--XX....,,,,X--
X........:X-----------------X.B.............E...X-------------X...,.......XXX...........XX......,...X--
X.........X-----------------XXX,,,,,,,,,XXX+XXXXX-------------X...,.............................,,,,X--
X.........X-------------------X.........X-X+X-----------------X...,................W............,...X--
X.........XXXXXXXXXXXXHXXXX:X-XXXXXXXXXXX-X.X-----------------X...,...........................B.,,,,X--
X..:....................:...X-------------X.X-----------------X...B..B...........:..........B...,...X--
X...................B.......X-------------X.X-----------------X...,B.........A............E...B.,...X--
XA..........................X-------------X.X-----------------X...,H............................,E..X--
X..:....B.......E..E..B.....XXXXXXXXXXXXXXXEX-----------------XA..,,,,,,,,,,,,,,,,,,,,,,,,,,,,,,,...X--
X:....:.....B...............,,,,,,,,,,,,,,,,X-----------------X...................W................BX--
X.......B......A.A.A.AA.B...XXXXX,,,,,,,XXXXX-----------------XE.................................B..X--
X...:......................:X---X.A.....X---------------------X.....................................X--
XXXXXXXXXXXXXXXXXXXXXXXXXXXXX---X..WK..+XXXXXXXXXXXXXXXXXHXXH-XXXXX,,,,,,,,,,,,,,,,,:,,,,,,,,,,,,,XXX--
--------------------------------X......+,...A,.,.,E.A..A.....XXXXXX................E.......E......X----
--------------------------------X......+,....,.,.,...............,+...E...:.....:....H.::.....:..:X----
--------------------------------XE.XXXH.XXXXXXXXXXXXXXXXXXXXXXXXXXX..........A...:...........H....X----
--------------------------------XXX--XXXX-------------------------XXXXXXXXXXXXXXXXXXXXXXXXXXXXXXXXX----
