-------------------------------------------------------XXXXXXXXX--------------------------------------------------------------
-------------------------------------------------------XE.E.E.EX--------------------------------------------------------------
-------------------------------------------------------X+++++++X------------X-------------------------------------------------
-XXXXXXXXXXXXXXXXXXX--------XXXXXXXXXXXXXXXXXXXXXXXXXXXX,,,,,,,XXXXXXXXXXX-E.X------------------------------------------------
-X.,.,.,...........+--------X.,.EE,.<.<,XXA........+++++++++++++++++......X.E.X-----------------------------------------------
-X,,,,,,...........AXXXXXXXXX..,,,.<..:XXX.........+...............+.......,.X------------------------------------------------
-X.,A...B.....E...........A,,........W.X-XA........+++++++++++++++++........X-------------------------------------------------
-X,,...EBB.................,,........<.X-X.....XXXXXXXXXXXXXXXXXXXXXXX.......XX-X---------------------------------------------
-X.,................B.....A,,A...,,...,X-XA....X-----XXXXXXXXXXXXXXXX-X........X.X--------------------------------------------
-X,,................BB.BB..XXXXX,..,.,EX-X.....XXX---X.....,,,,,.....X-X........,.XX------------------------------------------
-X.,....................E.AX---X...,.,EX-XA....,.X---X....HH...,......X-X........,E.X-----------------------------------------
-X,,.......B...............X---X,..,.,.X-X.....,EX---X,,,XXX...XXXXX...X-X.......,...X----------------------------------------
-X.,H.....EEB.............AX--X..,,..,,X-XA....,.X---X.,.X-X...X---XA...X-X.......,.E.X---------------------------------------
-X,,HXXXXXXXXXXX,,,,,,,XXXXX-XH....,,..X-X.....,.X---X.,.X-X,,,X-X-XA....:-X.......,.X----------------------------------------
-XE,.X---------X.......X-----X.....,...X-XA....,,XXXXX,,,XXX,,,XXX-X.....X-X........X-XXX-------------------------------------
-X.,HXXX---XXXXX,,,,,,,XXXXX-XH....,,..X-X.......................X-XA.E..X-X.........XX..X------------------------------------
-X.,HHHX---X...............X-X.......,,X-X.......................X-X....HX-X..........,EXX------------------------------------
-X.,,,HX---X...,,,,,,,,,...X-X.......,.X-X...XXXXXXXXXA,,,.......X-XA,,,,X:X...........X,EX-----------------------------------
-X...,HX---X..,.........,..X--X..,,..,EX-X...X-------X...,.......X-X:,.....,.............X------------------------------------
-X...,.XXXXX.,.........E.,.XXX-X,..,.,.X-X...X-XXXXX-XAE.,.......X-X.,.....,....E........X------------------------------------
-X...,H.E,.,.,.E...E.E...,.,.X-X.E.,..,X-X..HX-X.tTX-XA..,.......X--X,.....,.............X------------------------------------
-X...,...,.,.,...,,,,,...,.,.X-XXX,,,XXX-X...X-XWXXX-X,XXX.......XXX-X:....,.............X------------------------------------
-X...,...,.,.,...,.,.,...,.,.X---X+++X---X...X-X+X---X.X-X..........XX,,,,,,.............X------------------------------------
-X.,,,...,.,.,...,,K,,...,.,.XXXXX,,,XX:-X...X-X+XXXXX.X-X...............................X------------------------------------
-X.,.....,.,.,...,.,.,E..,.,.,.........X-X...X-X.,.....X-X...............................X------------------------------------
-XA,.E...,.,.,...,,,,,...,.,.,.........X-X...XXX.XXXXXXX-X...........,,,,,,,,,,,,,,,,,...X------------------------------------
-X.,....E,.,.,.E.........,.,.,.........X-X...,EX.X-------X....E......,......E........,...X------------------------------------
-X.,,,...XXX.,...........,.XXXA........X-X...,.X,X-XXXXXXX...........,.XXXXXXXXXXXXX.,...X------------------------------------
-X...,...X-X..,.........,..X-X.........X-X...,.X.X-X.................,AX-----------X.,...,X-----------------------------------
-X...,...X-X...,,,,,,,,,...X-X..E..,,,,X-X...,EX,X-X...........E.....,.X-XXXXXXXXX-XE,...,.X----------------------------------
-X..W,...X-X...............X-X.....,...H-X...,.X.X-X.................XXX-XH,H,H,HX-X.,...,.,X---------------------------------
-XE..,...X-XXXXX,,,,,,,XXXXX-X.....,,,,X-X...,EX,XXX,,...............XXXXX,XXXXX,X-X.,...,.,.X--------------------------------
-X...,...X-----X.......X-----X.....,...H-X...,.X.,..:,...............,.,H,HX---XHX-X.,...,.,.,X-------------------------------
-X...,...XXXXXXX,,,,,,,XXXXXXX.....,,,,X-X...XXX,,,,.,..,,,,,,.......XXXXXXX---X,XXX.,...,.,.,.X------------------------------
-X...,.....,+,.,,......EEXX........,...H-X...X-X.,.,.,..,.:.:,.......X--------X,.,.,.,...,.,.,.,X-----------------------------
-X.,,,.....,+,..,........XX,,H.E...,,,,X-X...X-X,,,,.,..,..W.,.......X-------X.,.,.,.,...,.,.,.,.X----------------------------
-X.,.E.....,+,...,.......XX..,.....,...H-X...X-X.,...,..,....,.......X------X..,.,.,H,...,.,.,.,.,X---------------------------
-X.,.......XXX...,.E.....XX.E,.....,,,,X-X...X-X,XXX,,..,....,.......X-X:XXX...XXXXXXX...,.,.,.,.,.X-----------XXXX:X---------
-X.,.......X-A...,...,...,+..,.....,...H-X..HX-X.X-X....,...H,.......X-X...,..X------X...,.,.,.,.,.,X--------XX......XX-------
-X.,.......X-X+XXX.,,.,,.,+..,,,,,,,,,,H-X...X-X,X-X....,...:,...XXXXX-X...,.X-------X...,.,.,.,.,.,HX------X:....,,..X-------
-X.,AAA.AA.X-X:X-X,.....,,W...E........X-X...X-X.X-X....,....,...X-----X...,X--------X...,.,.,.,.,.,.,X-----X....,>>>..X------
-X.,,,,,,,.X----XX......,XX....E.....E.H-X...XXX,XXX....,..,,,...XXX---X...X-------XXX...,.,.,.,.,.,.,.XXXXX...,>....>.XX-----
-XE.....E,AX----:+H.....HXX:...........:-X..............,..,.....,.X---X...X-------X.,...,.,.,.,.,.,.,.,.,+,...,>....>.,X-----
-XXXXXXXXXXX----XXXXLLLXXXXXXXXXXXXXXXXX-X..............,..,.....,.X:XXX...X-------XE,...,.,.,.,.,.,.,.,.,+,...,>....>,:X-----
-------------------X,,,X-----------------X.............H,..,.....,EX......AX-------X.,...,.,.,.,.,.,.,.,.,+,...,>....>,,X-----
----XXX-----XXX----X,,,XXXXXXXXXXXXXXXXX-X.........,,,,,,..,.....,.X.......X-------X.,...,.,.,.,.,.,.,.XXXXX...,,>..>,.XX-----
----XHX-----XHX----X...,...,.........EAX-X.........,:......,.....,.X......AX-------X.,...,.,.,.,.,.,.,X-----X:...,,,,..X------
-X:XX,XXXXXXX,XXXXXX,,,,...,,,,,,,,,...X-X.........,.......,.....,.X.......X-XXXXX-XXX...,.,.,.,.,.,.X-------X........X-------
-X..............:+++........,.....,,...X-XA........,:......,.....XXX.......X-X...X---X...,.,.,.,.,.,X---------X....:XX--------
-X.,,,,,,,,,,,,,.XXX,,.......,,,,,.,...XXX,,,,.....,.......,.....X-X:.....AX-X.E.X---X...,.,.,.,.,.X-----------XXXXX----------
-X.,.A.AA....E.,.X-X..,............,...,+,,,,,.....,.......,.....XXX,,,,,,,XXX,,,XXXXX...,.,.,.,.,X---------------------------
-X.,.,,,,,,,,,,,.X-X...,...........,..E,+,,,,,.....,...K...,......H......................,.,.,.,.X-----------XXXXX------------
XX.,.,...........:-X...,...........,...,+,,,,,.....,.......,.............................,.,.,.,,X-----------X,,,X------------
H,.,.,...XXXXXXXXX-X,,,,...........,...XXX,,,,.....,.......,........XX,,,,,XXX...........,.,.,.X.X---XBBBXXXXX,,,XXBBBBBXXX---
XX.,.,...X---------X...,............,..X-X.........,.......,........XX.,...X-X...........,.,.,XX.X---XB......,...,.....BT,.XX-
-X.,.,...+-XXXXXXX-X...,.............,.X-X.........,......:,........XX.,...X-X...........,.,.X-X+X---X.....,,,,,,,,,...Btt.,.:
-X.,.,...+-XH...:X-X....,.............,X-X.........,..E...:,........XX.,...X-X...........,.,X--X,X---X.....,......E,...B:,,..X
-X.,.,...XXX.....X-X.E...,,,,,,,,,,,,,,X-X.........,.......,....E...XX.,,,,XXX...E.......,.X---X,XXXXX.....,.E.E...,...B.,,..X
-X.,.,...+KX.....X-X..........H.H,.....X-X.........,......,.........XX.,E..XX,...........,X----X........,,,,.......,...,.,,.EX
-X.,E,...XXX.:...X-XXX,,,XXXXXXXXXXX+++X-X...E.....,......,.........XX.,..EXXE...........X----XX,,,,,,,,,,,,,,,,,,,,...,.,,..:
XX.,.,...+-X.....XXXXX,,,XX--------X,,,X-X.........,,,,,,,..........XX.,...XX,...........X----XX,,,,,,,,,,....,,.......,.,E,XX
H,.,.,...+-X...E.........:XXXXXXXXXX...X-X..........................XX.,,,,XXX...........XXX---X,,A...........,,.......,W,XX--
XX.,.,...+-X..............XXA.A.AA.A...X-X..........................XX.,...X-X...........,EX---X,,,,,,,,,,,,,,,,,,,,,,,,,X----
-X.,.,...+XX.,,,,,,,,,tt..XX..........XX-X.........XXX,,,,,,XXXXXX..XX.,...X-XH..........,EX---X.,.,.,.,.,.,.,,,.,.,.,.,.X----
-X.,.,...,.,.,.,.,.,.t.t..,,..........X--X.........X-X......X----X..XX.,...X-X,,,,.......,.X---X:,H,H,H,H,H,H,,,,,.,.,.,.:----
-X.,.,...,.,.,.,.,.,.tTt..,,..........XX-X.........X-X..E.E.X--XXX..XX.,B..X-X..E,.......XXX---XXXXXXXXXXXXXXXXXXXXXXXXXXX----
-X.,.,...,.,.,.,.,.,.t.t..,,.....E.....X-X.........XXX......X--X.,..XX.,B..X-XXXXX.......X----------------------XX------------
-X.,.,...,.,.,,,,,,,,,tt..,,..........XX-X.........,EX,,:,,,:--XE,..XX.,B..XXXXB-X.......XXX--------------------XX------------
XX.,.,...,.,.....E.......:,,..........X--X......H..,.X.,.:.:X--X.,..XX.,B..E...B-X......X-------------------------------------
H,.,E,...,.,..............XX..........XX-X.....XXX,,.X,,....X--XXX..XX.,B...E..B-X.....,.X------------------------------------
XX.,.,...,.,...XXXXX,,,,,XXX...........X-X.....X-XXXXX.,....X----X..XX.,,,.....B-X....X.E.X-----------------------------------
-X.,.,...,.,..:X-XXX,,,,,XXX...,,,,,,,,X-X.....X-XXXXX,,....XXXXXX..XX...,.E...X-X...XXX.X------------------------------------
-X.,.,...,W,...X-XW............,.......X-X.....X-X.,.,.,....,.,..,..,....,....X-X...XXX-X-------------------------------------
-X.,.,...XXXXXXX-X.............,.,,,,,.X-X.....X-X,,,,,,....,.,..,..XXXXXX...X-X...X-XX---------------------------------------
-X.,.,...X-------XW............,.,,T,,.X-X.....X-X,,........,.,A.A..X----X..X-X...,EX-----------------------------------------
-X.,.,...XXXXXX:-X.............,.,,,,,.XXX.....X-X,,......E.XXXXXX..XXXX-X,X-X..XX...X----------------------------------------
XX.,E,.........X-X.....E.......,.......,+,.....X-X.,........X----X..,..X-X+XX...XXX.X-----------------------------------------
K,.,.,.........X-X.............,....E..,+,.....X-X,XXXXXXXXXXXXX-X..,,,XXX,X....EX-X------------------------------------------
XX.,.,.........X-X.............,.......,+,.....X-X+X-XEX-XEX-XEX-XH...........,.,X--------------------------------------------
-X.,.,,,,,,,,,.XXX.............,.t,,,,.XXX.....XXX,XXX,XXX,XXX,XXX...........,XXXX--------------------------------------------
-X.,....E....,..,+.............,.t,,,,.X-X..................................,.X-----------------------------------------------
-X.,,,,,,,,,,,..,+.............,.ttttt.X-X.................................,EX------------------------------------------------
-X:.............,+.XXX.XXX.XXX.,......HX-X.A.A.A.A.A......................,.X-------------------------------------------------
-XXXXXXXXXXXXXXXXXXX-XXX-XXX-XXXXXXXXXXX-XXXXXXXXXXXXXXXXXXXXXXXXXXXXXXXXX,.X-------------------------------------------------
-------------------------------------------------------------------------X,X--------------------------------------------------
-------------------------------------------------------------------------XX---------------------------------------------------
