---------------------------------------------------------------------------------------XXXXXXXXXXXXXXXXX-------------------------------------
---------------------------------------------------------------------------------------E.......H......EX-------------------------------------
---------------------------------------------------------------------------------------X....:,tt,:.....X-------------------------------------
---------------------------------------------------------------------------------------X.....,tT,......X-------------------------------------
---------------------------------------------------------------------------------------X,,,,,,..,.,,,,,X-------------------------------------
---------------------------------------------------------------------------------------X,...,,,,,.,...,X-------------------------------------
---------------------------------------------------------------------------------------X,.:.,,,,,.,.:.,X-------------------------------------
---------------------------------------------------------------------------------------X,...,,,,,.,...,X-------------------------------------
----------------------------------------------XX---------------------------------------X,.E.,,,,,.,.E.,X-------------------------------------
--------------------------------------------XXKX---------------------------------------X,...,,,,,.,...,X-------------------------------------
------------------------------------------XX...X---------------------------------------X,...,,,,,.,...,X-------------------------------------
----------------------------------------XX..E.EX---------------------------------------X,,,,,.,,,.,,,,,X-------------------------------------
--------------------------------------XX..:....X-------XXXXXXXXXXXXXX------------------X......,,.......X-------------------------------------
------------------------------XXXXXXXX.........XXXXXXXXXE...B.B.B...X------------------E.......:......EX-------------------------------------
----------------X-------------:....++.E..:......,,,,,,,............EX------------------XXXXXXX...XXXXXXX-------------------------------------
----------------XXX-----------XXXXXXXXXXXXXXXXXXXXXXXXXXE...........X------------------------X...X-------------------------------------------
----------------X..X-----------------------------------XXXXXX,,XXXXXX------------------------X...X-------------------------------------------
----------------XE..XX-------------------------------------X+++X-----------------------XX----X...XXXXXXXXXX----------------------------------
----------------X.....X-------------------XXXXXXXXX--------X,,,+-----------------------X.XX--X,,,XXT.....:X----------------------------------
----------------X......X------------------X.A.W.A.X--------XX,,XX----------------------X...XXXLLLXXXXXXXX.X----------------------XXXXXXXXXXX-
----------------X.......XX----------------X,,,,,,,XX------X......X----+XXX:XXXXXXXXXXXXX.....X,.:X------X.X----------------------:.........X-
----------------:.........X---------------:........X-----X..E.....X---+H.E.E.E..E.E:.++,...E...,,X------X.X----------------------X.E.....E.X-
XXXXXXXXXXXXXXXXX..,,,,,,,:XX-------------X...E..:.X----X......E...X--X.:...........AXXX.........XX-----XEX----------------------X.....H...X-
X..<...............,.....,...XXXXXXXXXXXXXX........XXXXX............XXX,,,,,,,,,,,,,,XXX......E....XX---X.XXXXXXXXXXXXXXXXXXXXXXXX,,,......X>
X.,,,..............,.,,,.,...++.,.,,.,,.,............++,..X+X.......LL,.A..........A.,+,.............XX-X:.E.LL.A,H,A,H,A,H,,E++,,,,,.AH.E.,>
X<,<,:.............,.,:,.,...++.,.,,.,,.,:..E.W..E...++,..X-X:..E...LL,..............,+,..E.:....E..:..XX.XXXXXXXXXXXXXXXXXXXXXXXX,,,......XX
X.,,,..............,.,,,.,...++.,.,,.,,.,............++,..X++.......LL,.A..........A.,+,.............XX-XEX----------------------X.....H.E.X-
X..<...............,.....,:..XXXXXXXXXXXXXX........XXXXX.......E....XXX,,,,,,,,,,,,,AXXX......E....XX---X.X----------------------:.E.......X-
XXXXXXXXXXXXXXXX:..,,,,,,,.XX-------------X...E..:.X----X..........X--XK.E.E:E..E:E..XXX.........XX-----X.X----------------------XXXXXXXXXXX-
----------------X.........X---------------:........X-----X..E.....X---X..............+,,...E...,,XXXXXXXXEX----------------------------------
----------------X.......XX----------------X,H,H,H,XX------X.X,,X.X----XXXXXXXXXXXXXXXXXX.....X+++XXKE.....X----------------------------------
----------------X......X------------------XXXXXXXXX--------X,,,XX----------------------X...XXX+++XXXXXXXXXX----------------------------------
----------------X.....X------------------------------------X+++X-----------------------X.XX--X...XXXXX---------------------------------------
----------------XE..XX--------------------------------------X,,X-----------------XXXXXXXX----X......WX---------------------------------------
----------------X..X-----------------------------------XXXXXX..XXXXXX------------X...:X------X..,,...X---------------------------------------
----------------XXX------------------------------------X,.,..:...,,HX------------X....X------X..,,..EX---------------------------------------
----------------X--------------------------------------X,,,.E.E..,,.X------------X,,,.XXXXXXXX.......X---------------------------------------
-------------------------------------------------------XW..........AX------------X,H,..++H..........AX---------------------------------------
-------------------------------------------------------XXXXXXXXXXXXXX------------X,,,.XXXXXXXXXXXXXXXX---------------------------------------
---------------------------------------------------------------------------------X....X------------------------------------------------------
---------------------------------------------------------------------------------X...:X------------------------------------------------------
---------------------------------------------------------------------------------XXXXXX------------------------------------------------------
