------------------XXXXXXXAXXXXXXX--------------------------------------------------------------------------------------------
----------------XX.,..,E...E,,.,.XX------------------------------------------------------------------------------------------
--------------XX,.E,..,.....,,.,,.,X-----------------------------------------------------------------------------------------
-------------X...,..,.,.....,,,.,,..X----------------------------------------------------------------------------------------
------------X.,E.,..,,,,,,,,,,,,.,...XAAXXXX---------------------------------------------------------------------------------
------------XE.,..,,............,.....,.:XHX---------------------------------------------------------------------------------
-----------X,...,,...............,,...E.HX-----------------------------------------------------------------------------------
-----------X.,,.,..E........XXX....,.XAA,X-----------------------------------------------------------------------------------
----------X....,....,,,.....X-X.....X-XXXX-------------------XXX-------------------------------------------------------------
----------X,,..,....,H,.....XXX.....X------------------------X.X-------------------------------------------------------------
----------X..,,.....,,,.............XXX----------------------X.X-------------------------------------------------------------
----------X...,.....................t.X----------------------X.X--------X----------------------------------------------------
------XHEXXE,,,.....................XXX-XEXXXXXXXXXXX---XXXXXX,XXXXXX-XX.X---------------------------------------------------
------X..XX....,....................X---X..,..,,...EX--X.E...........X,.E.X--------------------------------------------------
------X,,XX....,......,,,,,,,,,,,,,,X---XE.,..,,....X-X...............,,...X-------------------------------------------------
----XXX.E.,.....,.....,..,,,,,,,,...XXXXX...,.,..E...X.................,,.E,X-----------X------------------------------------
----K.+..:,...W.,.....,..,,,,,,,,...,.......XXX.....,....,,,,,,,,,,,....,,..,X--------XXTXX----------------------------------
----XXX.E.,.....,.....,..,,,,,,,,...,.......X-AE...,....,...,...,...,....,,..,X-------X...X----------------------------------
------X,,,XXH.AA,.....,............AXXXXX...X-XXX.,....,..,,,,,,,,,..,....,,E.,X-----X,...,X---------------------------------
------X,,,X-XXXXXXXXXXXXXXXXXXXXXXXXX---X,,,X----X....,..,.........,..,....,,XX-------X.H.X----------------------------------
------X,,,X-----------------------------X,,,X---X....,..,...........,..,....X,--------XX,XX----------------------------------
------X,,,X----XX---------XEEXAEX-------X,,,X--X....,..,.,...........,..,....X---------X.X-----------------------------------
------X,,,XXXXXXXXXXX-----X,,,,.X-------X,,,X-X....,..,...,...........,..,....X-X------X,XXEXXEXXXXXXXXXXXXXXX---------------
----XXX...,.,...+E,EX-----XEE.EEX-------XEEEX-X...,..,.,...,...........,..,...X-X------X.XX....,.H.........A..XX-------------
----XH,...,.,...+.,,X-----XHE,EHX-------X,H,X-+...,.,...,...,...........,.,...X-X------X,XX.A.,.................X----XXXXXXXX
----XXX...,.,...+...X-----X,,,,,X-------X+++X-+...,.,....,...,,,........,.,...X--------X.XX..,...................X---X,,,,,,X
------X,,,,.XXXXX...XXXXXXX,,,,,XXXXXXXXX,,,XXX...,,,.....,.,.E.,,,,,,,,,,,...XXXXXXXHXX,XXE,............E......H.X--X.....,X
------X,,,,,X---X...+A.E,............,,,,.,,,.,...,.,......,,...,.......,.,...,,,,....XX.XX,...................E..X--X.....,X
------X,,,,,X---X,,.XXXXX.:.......E..,,,,.,T,.,E..,.,......,,HT.A.......,.,...,,,,A...XX,XX.........H.,,,,,,,......X-X.....,X
------X,,,,,X---XE,EX---X....W..A..A.,,E,.,,,.,...,.,......,,...,,,,,,,,,.,...,,,,....XX.XXA.........,,E,,E,,,.....X-X.....,X
------X,,,,,X---XXXXX---X.....XXXXXXXXXXXXXXXXX...,,,.....,.,.H,........,,,...XXXXX...XX,XX.........,,XXX,XX.,,.....XX.....,X
XXX---X,,,,,X-----------X,,,,,X---------X:XXWXX...,.,....,...,,.........,.,...X---X...XX.XX.........,,XE...E.,,....AXX.....,X
XAXXXXX,,,,,XXXX--------X,.W.,X---------XAEA.E,...,.,...,...,...........,.,...X---X...XX,XX.........,,XXXXEXE,,.....XX.....,X
X+X.............X-------X,...,X---------XE,EXXX...,..,.,...,...........,..,...X---XE,,XX.XX.........,,XXXWXX.,,.E...XX.....,X
X+XH,,,.....,,,AX------XX,,,,,XX--------X...X-X....,..,...,...........,..,....X---X,..XX,XX.........,,XE-EEXE,,.....,,.....,X
XE,.,.,.....,.,.X----XX.........XX------X,,,X--X....,..,.,...........,..,....,.X--X,,,XX.XX.........,,XXXXXX.,,.....,,.....,X
A.,.,,,.....,,,.X----X,.........,X------X.E.X-X-X....,..,...........,..,....X.E.X-X...XX,XX.........,,.......,,.....,,.....,X
XE,.,,,,,,,,,,,.X---X..,,,,,,,,,..X-----X...X----X....,..,.........,..,....X-X.,X-X...XX.XX..........,,,,,,,,,......,,.....,X
XXX,,.........,,XXXXX..,,:,,,,,,..XXXXXXX...XAXXX.,....,..,,,,,,,,,..,....X---X.X-X.E.XX+XX.........H.,,,,,,,.H.....,,.....,X
--X.............,,.,,..,,.....,,.,,,,,.......EXX...,....,...,...,...,....,.X--X,X-X...XX,XX.........................XX.....,X
--X.....,,,.....,,E,,..,,.<.<.,,.,,..,..,,,,,,XX,...,....,,,,,,,,,,,....X.E.X-X,X-X.......,.........................XX.....,X
--X.....,W,.....,,E,,..,,..W..,,.,,.A,..,......,.,,..X.................X-X.,.XX,X-X......E,........................AXX.....,X
--X.....,,,.....,,E,,..,,.<.<.,,.,,..,..,......,...,X-X...............X---X...X,X-XH......,.........................XX.....,X
--X,............XXXXX..,,....H,,.,,,,,..,......,..,,X--X.E...........,.X---X.,..X-XXXXXXXXX........................,XX.....,X
XXXA,.........,,X---X..,,,,,,,,,..XXXXXXX......,,,.,,HX-XXXXX,XXXXXXX.E.XXXXX.ttX---------XX,.....................,.XX.....,X
XE,.,,,,,,,,,,,.X---X.,,,,,,,,,,,.X-+HXXX......,..,,,,X-----X.X------X.,.,,,,.t.X---------X,.,...................,.EXX.....,X
A.,.,,,.....,,,.X----X,.........XX--+.E.X......,..,.,X------XtX-------XXXXXXXXXXX-------XX.,XX..................,.A.XX.....,X
XE,.,.,.....,.,.X-----XX.......X----+..,.,.....,....X-------X.X--------------------------X..X-XXX,,,,,,........,.E.EXX,,,,,,X
XXX.,,,.....,,,.X-------X,,,,,X-----XXX...,....,,,,,X-------XXX-----------EXXXXXXXXXXXX---XX-XXXX.....,.....,.XXXXXXXXXXXXXXX
--XX.,,,,,,,,,.XX-------X,.A.,X------X.,.E.,........X-------------------XXX......:.XH,X------X.E,.E.A.,....,,,X--------------
----XX+++++++XX-------XXX,...,XEXXXXX...,...,.....,,X------------XX--XXXXXX........,,,XAXXXAXX..,,,,,,,....,,AX--------------
----XX,,,,,,,X--------XE.,,,,,.,,,,H,....,.E.,.X,,..XXXXXXXXXXX------X..............,X-X,,,.XX..HHHHHXXE.E..,HX--------------
-----X,EEHEE,X--------X......,,..,,,,.....,...XXX..E,.+.,...,,XXXXXXXX........W.......XX,,,.XX,,,,,,,XXXXXXXXXX--------------
-----A,A,A,AAX--------X....,,....,,E,......,.,......,.+:,...,,....,,X.+...............,,,T,.,........XXXXXXXXXXXX------------
-----XXX,,XXXX--------X..,,......,,A,...W...XXE....E,.+.,.,,,,....,,,,+.........++....,,,,,E,...................X------------
--------X,X-----------X,,........,,E,.......X-XXX,,,,.+.,.,A,,....,.,,,XXXX.....+-+...,,....,...................X------------
--------X,X-----XXXXXEX.......W..,,H,.......XAX-X.....+.,.,,,,....,,,.,X--X......X....XX..E,......,,,,,,,.......XXXXX--------
--------XHX-----X...,............,,E,.......,.X-X++++++.,..,,,....,.,,.,X--X........:X-X,,,.......,,,,,,,.......,...,X-------
--------XXX-----X.E.,E...........,,,,...:...,.X-X.......,..,.......,,,,,X---X......,:X-X..........,,,,:,,......,....,HX------
----------------H...,............,,H,.......,EX-X......,...,............X----X.....XXX-X..........,.,.,.,......,..E.,.X------
----------------XXXXX.....:.....XXXXXXXXXXXXXXX-X,,,,,,.W..,..........E.X-XHX-X+++X----X..........,,,,,,,......,....,.HX-----
---------------------X.........,.XXAX-----------X..........,,,..........X-X.X-X...X----X..........,.,.,.,......,..E.,..XX----
---------------------X.........,....XHXXXXXXXXXXX.,,,.....,,,,...:....E.X-X.XXX,,,XXX--XXXX,,.....,,,,,,,......,....,..,X----
----------------------X.......X..E..XX.........,,:,A,,,,,,,A,,..........X-X.........X-----XA,......,,,,,.......,..E.,..XX----
-----------------------XXLLLXXX.....XX,,,XXXXXXXX.,,,,...,,,,,...W....E.X-X.........X-----XE,......,ttt,.......,....,.AX-----
------------------------X...X-XXXXXXXX,H,X------X....,...,,,,,.:........X-X.......,,X-----XH,......,t.t,.......,..E.,A.X-----
------------------------X.A.X--------X,E,X------XXXXX.............:...E.X-XXX,,,,,,.X-----X.,......,ttt,.......,....,.X------
------------------------X,,,X--------X,,,XXXX-------X,..................X---X,...,,,X-----XH,......,,,,,.......,....,X-------
--------------HHHHHEX---X,,,X---AEEXXX,,,XX,XEX-----XH,................,X---X,...,.,X-----XXX........E..........XXXXX--------
--------------H.,,,HX---X,,,X---X.............X-----X..,.............,,EX--X:,...,,.X-------X..,,,.........,,,..X------------
--------------HEXXX.XXXXX,,,XXXXX.............X-----X.E.,...E.E.E.E..,..XHXX.,...,..X-------X..,A,.........,A,..X------------
--------------H.X-X.,.,,,.E.,,,...............X-----+,..H,..........,E.H,.XX,,...,,.X-------X..,,,.........,,,..X------------
------------XXH.XXX.,.,,,,,,,,,...W.....:.....XX-----XXXXXXXXXXXXXXXXXX,,.XX,,...,.,X-XXXXXXX...................XXXHX--------
------------XHHH...,,.,,,,,,,,,...............XX----------------------XH.:XX.,...,,,X-HE,.,....................,...EX--------
------------XXXXX,,...,,,,,,,,,.......,,,,,...XX----------------------XXXXXA,,...,..X-H.,.,...................,....AX--------
----------------X.....................,...,,.,,.AX--------------------A.,.,.,,...,..X-HE,.,...................,....EX--------
----------------X,,,,,,,,,,,,,,,,,,,,,,,,,,.,,,E.HX-------------------X.,,,,.,,,,XAAX-H.,.,...................,.....X--------
----------------X,,,,.....................,,,.,...X-------------------X.,E.....,.X----HE,.,...................,.....X--------
----------------X,,,,..E...E...E..........,.,,,..EX-------------------X.,......,.X----H.,.,...................,.....X--------
----------------X,,,,.....................,,,,,...X-------------------X.,E...,,XAX----AEA.,...................,.....X--------
---------------XX,,,,.....................,.,,,E..H-------------------X,,,,,,,.X------XXXXXXX...,,,,,,,,..XXXXX,,,,,X--------
-------------XX,,.,.,.....................,...,..EX-------------------X........X------------X.,,........,,X---X.,,,.X--------
-------XXXXEX,,,,,,.,....,,,,,,,,,........,...XXXAX-------------------X........X------------X,............X---XA,H,AX--------
-------X.,L.,,,,,.,,.....,,,,,,,,,........,...XX----------------------A....H..AX------------X.............X---XE,E,EX--------
-------X.,L.,,,,,,.......,,.....,,........,...XX----------------------XXXXXXXXXX------HXAAX-XH...........HX---XXXXXXX--------
-------XXXX.,,,..........,,.,,,,,,........,...X---------------------------------------X.E.X-X.............X------------------
----------XXX............,,.,:,,,,........,...X---------------------------------------X...XXX,,,,,,,,,,,,,XXXXXXXHX----------
------------X............,,.....,,........,...X---------------------------------------XE.E...................E.E.HX----------
--------XEXXX............,,.....,,........,...X---------------------------------------X.......E..E..E...E.......XXX----------
--------X.,..............,,,,,,,,,........,....XX-------------------------------------X.......,,,,,,,,,,,.....A.X------------
------X-X.,..............,,,,,,,,,........,.....XX-------------------------------------X......,,E,,E,,E,,......X-------------
-----+,X..,..............................,.,.....,X------------------------------------X......,.........,......X-------------
----XX,.E.,.............................,...,....E,X------------------------------------XX....,,,,,,,,,,,.....X--------------
-----X....,............................,...,.,.....X--------------------------------------XX.HHHH.....HHHH..XX---------------
----XE..E.,...........................,...,...,.....X---------------------------------------X,,,XX+++X,,,XXX-----------------
----X.....,..........................,...,.....,.....X--------------------------------------XE.EXX...XE.EX-------------------
----XE.E..,...........,,,,,,,,,,,,,,,...,.......,....EX-------------------------------------X...XXXKXX...X-------------------
----X.....,..........,..,.,.,.,.,.,..,.,.........,....X-------------------------------------XE.EX-XEXXE.EX-------------------
----XE.E..,.........,...XXXXXXXXXXX...,...........,..AX-------------------------------------X,XXX-XXXXXX,X-------------------
----X.....,.........,..,XXX,XEX,XXX,..,..........,...EX-------------------------------------X+X--------XXX-------------------
----XE.E..,.........,,XXA,,,,,,...AXX.,..........,....X----------------------------------------------------------------------
----X.....,.........,.XXE,,,,,,..E.XX.,.........,....X-----------------------------------------------------------------------
----X.....,,,,,,,,,,,.XH,,,,,,,HXX.XX.,........,....,X-----------------------------------------------------------------------
----X.....,,.......,,.XH,,,,,,,HXXXXX.,.......,.....X------------------------------------------------------------------------
----X.....,,.......,,.XA,,,,,,,HXXXXX.,.......,....X-------------------------------------------------------------------------
----XE....,,.......,,HXA,,,,,,,HX-HE,.,......,....,X-------------------------------------------------------------------------
----X,,,,XXXX,,,,,XXXXXA,,,E,,,HX-XXXXXX..XXXX...XX--------------------------------------------------------------------------
----XE..EX--X,,,,,X----A,,,,,,,HX-------X,X---X,.X---------------------------------------------------------------------------
----X....X--X,,,,,XHXXXX,,,,,,,,X-------X,X---X.X----------------------------------------------------------------------------
----X..:.X--X,,,,,,..E.........EX-------XXX---XXX----------------------------------------------------------------------------
----XE..EX--X,,,,,,,....,,..,,..X--------------------------------------------------------------------------------------------
----XHXXXH--X.,,..,,....,,..,,..X--------------------------------------------------------------------------------------------
-----------XX.,,..,,....,,..,,..X--------------------------------------------------------------------------------------------
-----------X,E,,..,,....,,..,,.EX--------------------------------------------------------------------------------------------
-----------X,.,,..,,....,,..,,..X--------------------------------------------------------------------------------------------
-----------X,E,,..,,....,,..,,..X--------------------------------------------------------------------------------------------
-----------XX.,,..,,....,,..,,.EX--------------------------------------------------------------------------------------------
------------A...................X--------------------------------------------------------------------------------------------
------------XXX+++++++++++++++XXX--------------------------------------------------------------------------------------------
--------------X...............X----------------------------------------------------------------------------------------------
--------------X.E.AE..E..EA.E.X----------------------------------------------------------------------------------------------
--------------X...............X----------------------------------------------------------------------------------------------
--------------A++++++++++++++HX----------------------------------------------------------------------------------------------
------------XXX...............XX---------------------------------------------------------------------------------------------
-----------X:.X...............X:X--------------------------------------------------------------------------------------------
-----------X.,.................,.X-------------------------------------------------------------------------------------------
----------X:,...................,:X------------------------------------------------------------------------------------------
----------X.,......E...E..,.....,.X------------------------------------------------------------------------------------------
---------X.,.............,H,.....,.X-----------------------------------------------------------------------------------------
---------X:,.....E.,.E.,,H,..E...,:X-----------------------------------------------------------------------------------------
--------X.,...E...,H,.,.H,.......,.X-----------------------------------------------------------------------------------------
--------X.,........,H,.H.......E.,.X-----------------------------------------------------------------------------------------
--------X.:.....E.E.,H,..E..E....,:X-----------------------------------------------------------------------------------------
--------X.,........,.,.,.........,.X-----------------------------------------------------------------------------------------
--------X.:...E....,H.,H,.....E..,:X-----------------------------------------------------------------------------------------
--------X.,.......,H,..,H,.......,.X-----------------------------------------------------------------------------------------
---------X.,,,,.E.,,,...,,,.E.,,,,.X-----------------------------------------------------------------------------------------
---------X.:,T,...,T,...,T,...,T,:.X-----------------------------------------------------------------------------------------
----------X.,,,...,,,.E.,,,...,,,.X------------------------------------------------------------------------------------------
-----------X:,.................:.X-------------------------------------------------------------------------------------------
------------X.,,....X++XX,....,.X--------------------------------------------------------------------------------------------
-------------X:.XXX,+...+XXXX:.X---------------------------------------------------------------------------------------------
--------------XXX--X,,,,,X--XXX----------------------------------------------------------------------------------------------
-------------------X,...,X---------------------------------------------------------------------------------------------------
-------------------X,,E,,X---------------------------------------------------------------------------------------------------
--------------------XX,XX----------------------------------------------------------------------------------------------------
---------------------X>X-----------------------------------------------------------------------------------------------------
---------------------X.X-----------------------------------------------------------------------------------------------------
---------------------XXX-----------------------------------------------------------------------------------------------------
-----------------------------------------------------------------------------------------------------------------------------
-----------------------------------------------------------------------------------------------------------------------------
-----------------------------------------------------------------------------------------------------------------------------
----------------------XXXXXXXXX----------------------------------------------------------------------------------------------
----------------------X.......X----------------------------------------------------------------------------------------------
----------------------Xt,tttttX----------------------------------------------------------------------------------------------
----------------------XE,E,E,EX----------------------------------------------------------------------------------------------
----------------------XXXXXXXXX----------------------------------------------------------------------------------------------
