---------------------------------------------------XXXXXX-XXX------------------------------------------------------------------------------
--------------------------------XXXXX-------XXXXXXX.....,X-X-XXXXXX------------------------------------------------------------------------
-------------------------------XXAW.AXX---XX...........:,HX-X..E.,,XXXXX-------------------------------------------------------------------
-------------------------------X,....,.XXX...:..........,.AX-XX......,,,XXXXX--------------------------------------------------------------
------------------------------X.,....,..,...............,A.X---X.........,,,,XXXXXX--------------------------------------------------------
------------------------------X.,.....,,.,..............,,..X---X.....:........,,,,XXXXX---------------------------------------------------
------------------------------X.,.XXXXXX.,..............,,.EX----E,,,,,,,,,...:.......E,XXX------------------------------------------------
-----------------------------X.,.XXXXXXX..,.............,,..X---X...:......,,,,,........XX----XX--X:X-X:X-X:X------------------------------
-----------------------------X.,.X.,A.E,,E,.............,,...X--X...............,,.....X----XX,,XXX,XXX,XXX,XXXXXXXX-----------------------
-----------------------------X,,XX,.,...,..,............,,...XXX..................,,.XX---XX,,.......E........,,,,E.XXX--------------------
-----------------XXXXXXX-----X.XX,.E.,..,,.,............,,..,.,,,...................X----X...E................,,,,,....XX------------------
----------------X.,..E.,XX--X..XX.,...,..,..,...........,,...XXX...................E.X---X.......E............,,,,,......XX----------------
---------------X..,....,..XXX..X...,...,E,,.,...........,,..X--E.....................:-:X.E.......,,,,,,,,,,,,,,,,,,......X----------------
--------------X....,...,.Et.A..,T...,.E.,.,..,..........,.,.XXXX......................XXX.....,,,,,E................,,.....X---XHHHHHHX----
-------------X..E...,..XXXXXX..X...,...,..,,E,,,,,,,:,,,,.,XXA,,..................E..,XXX.....,,,T..,,,,,,,,,,T,,,,...,....XXXX.......HHX--
------------X.......,.X-----X..X..,...,...E,.A...T.......E,X..A,E......E...........,,.L..,....,.,,..,.............,...,....,.,.......:..HHX
-----------X.,,......X-------X.X.,.E.,.....XXXXXX,,,,,XXXXXX...,,.....XXX.........,.E.LE..,..E,.,H..,.............,...,....,.,............X
-----------X...,,...X--------X.,..,.,......X---XE..E...E,,,,...,,....,X-X,.......E.,,.L..,....,.,T..,.............,...,...:,.,...........HX
----------X......,,.X--------X..,..,.......X-XX..,,,X,,,XXX,....,,..,.XEX.,..........,XXX.....,,.,..,.............,...,....,.,.:..........X
----------X........X----------X.,..........AX...,.XXX,AEXX-X....XX.,,,...,,........E.:X:X.E.....,,,E,.............,..,,....,.,...........HX
---------X,,.......X----------X..,.........XX,E.XXX.......XXX...X-X,......,,.....E...X-XX......E..,,,,,,,,,,,,T,,,,,,......XXX.........HHX-
---------XE.,.....X----------XX.A,.E.......XX,.,+...........X..X--X........,,..E...XX---X...........,,,,,,,,,,,,,,.........X-XX.HHHHHHHX---
--------X.,,X,,,,,X------XXXX.:E.H,,...E...XX.,,+...........,..X--X.........,XXXXXX------X..E............,,,,,,,,..........X---XXXXXXX-----
--------X...X.....X---XXX....,,,,...,,,....,+E.,+...........XXX---X.........,XX--XXXX----X...........E......,,,,,..........X---------------
-------X....XX...,X--X.E.,,,,.........,,,,.EX.XX+...........XXXX--X......,,,:,:XX.:..XX---XX.....E..........,,,,,..........X---------------
-------X....XX.,,.X--X.,,...............,,,XX.X,+.............+.XXX......,...,.:..,..,X-----XX,.............,,,,E.........X----------------
-------X...,HX,....XA..,..................,XX.XHE.....W.....TE+.,T,......,::.,:.XXXXX.EX------XXXXX:XXX:XXX:XXXXXX........X----------------
-------X...,,......,,.,.................:..XX,XX+.............+.XXX......,,,:,XX----X,,X----------XXX-XXX-XXX-----XX......X----------------
------X...,H,......,,.,....................XXE,,+...........XXXX--X......,,,,X----XX.:.,XXXXXXX---------------------X..T..X----------------
------XT..,.,.......,.,....................X,.,,+...........XXXXX-X.........,X--XX,:,,,,.....,X---------------------X....X-----------------
------X..,.H,.......,E,,..................XX,..,+...........,....XX..........X-:,.:,E:XX.....,X----------------------X...X-----------------
-----X.,.,..XX......X...,,,...............XH,..,XX..........XXX..XX..........XXE.XXXX---XXXXX.X-----------------------X,X------------------
-----X,,,.XX--XX,,,,XX,:...,,,,,,,,,,,,,,,XX,.E,,.XX..AE..XX-XX..X...........XX.X-----------X.X-----XXXX------XXX:XX--XTX------------------
----X.,.XX-----X,,,,XX,,,,,.A..E..:..,,,,.XX,,...,,.X,,,XXXXX,,.XX...........X..X-----------X..X----X---XXXXXX......X-X.X------------------
----X..X-----XX........,,,,,XXXXXXX,,....,X-XX,,..E,,,,,,E,,,,,XX...........XX,,X-----------X..X---X.XXX...,......:.X-X.X------------------
----X..X---XX.:............,XXX---X..,,,,..X--XX,,....E...,,,,X-X...........XX..XX-----------X.X---X.X--XXX.:........XX.X------------------
----X..X---X,,................AXX--X,......X----XXXX,,,,,,,XXX-X............XX,,E.X-----XXX--X.XXXX..X-----X.........X-XX------------------
----X..X--X.,.,,...............HX--X.......HX-------XX,,,XX---X.............XXX.,,X-----XTX--X,....,X------X.........:XX.X-----------------
----X..X--X.,...,............:.AX--H.........X------XX,,,XEXXX.,.......,,,,,X--X...X----XtX--X,,,,,,X-------X.........XX.X-----------------
----X.X--X.E.,...,,..XXX,,,,XXXXX-X..........B----XX..........,,.T...,,,,,,,X---X.,.X---X.X-X..E.,,,X-------X.........,+.X-----------------
----X.X--X...,.....XXXX.E,..A.BXXXX...........XXXX,E...........,,...,,,.,....X---X...X-X...XE....E.EX--------:....:...,,AX-----------------
----X.X-X..:.,.....XA,..,........,,...........,,,,.,...........,.,..,,..,.....X--X.,,:-X.E.XH.A..A..X--------X........,,+X-----------------
----X.X-X.....,....,,..,,,,......,,..........XXXXX.,............,,.,,.,..,....X--X,...XH....XHE.E.E.X--------X........XX.X-----------------
----X.XX.E...B,....,.E,,.H,....E.,,..........X---X.,.....E.....E.XXX..,..,.....X-X....,......XHHHHXX---------X........XX.X-----------------
----X,XX.......,..E,,..,,,,......,,..........X---X.,............XXXX...,..,.....XX,,..,E......X-XX------------X......X-X.X-----------------
---X,E,,.......,...XA,..,........,,...........XXX,.,..........XXX,,X...,..,.....,,E,..,........X--------------X.,..:X-X..X-----------------
---X,E,,.......,...X-BX.E,.....XXXX...........,,,,,..........X-X..WX....,..,....,,.,..,:..E.....X-------------X,.,..X-X.X------------------
--A.,.,,...E....,...X--X,,,AXXX----X..........XXXXXXE,,,,,,EXXX....X....,..,....,,.,..XXX........X------------X.H,.XXX.,X------------------
--X.,E,,........,....XBX,,,XX------XH.......H.X----XX,,,,,,,X......X.....,..,..,,E.,..X--XX..E....X------------XXXXX....X------------------
--X.,,,,.........,...,.......XX-----XB.......X------XEAEHEAEX......X.....,..,..,,.,..XXXXXXX.......X-------------XX....TX------------------
--X...XX.........,...,.........XX---X........X------XE,E,E,EX...ttXX......,..,.XX.,..X,.W.,XXX......XXXXXXXXXXXXX.......X------------------
--X...XX...B.....,..,..........EX----X,,,,,,X-------X,,,,,,,XXX.tTXA,,....,..,.XXE,.XXA...AX--X........................X-------------------
--X...XX.........,..,.....E.....X----X,,,,,,X----XXXX,,,,,,,XXXXXXX.,,,....,.,XX,,,.XX,...,X---X.......................X------------------X
--X..XX.E.......,...,...........X----X......X---:...............XX:,E,,,,..X,,,....X-X.,,,.X----XX....................X------------------XX
--X..XX.........,...,...........X----X......X--X,..................XX.E,XXXX..,...XX-X.....X------X.................XX------------------X.X
--X,,X..........,..,.:..........X---X.......X-XH.,......:...........XX,..XX,...XXX---X.....X-------X,,,,,XXXXX,,,,,X-------------------X..X
--X,EX..........,..,............X---XB.....X-X,..,....,,,,,,,,,,,....XX,E,..,..X-XXXXX.....X------XX,,,,,XXXXX,,,,,XX-----------------X...X
--X,,,.........,...,............X---X......X-X,...,...,.........,.....XXX...X.:XX,.EXX.....X----XX.,...A...A...A.....XX--------------X....X
--X,E,...:.....,...,........E...X---X......XX.,...,...,.........,......X-X..X:.:,,..XX.....X--XX...,...................XX-----------X.....X
--A,E,.........,..,.............X--X.......,,.,....,..,.........,.:.....X-X.XX,XX,........X-XX.....,.....................XX--------X......X
--X,,,........B,..,....B........X--X.......,K.,....,..,...:.....,......,X-X.XX.X-X,,XXXXXXXX,......,.......................XX-----X.......X
--X,,,.........,..,.............X--X.......,,.,.....,.,.........,.....,..XX,XX..XX,,X---XX..,......,.........................XX--X........X
--XtXX........,...,.............X--X.......XX.,....,..,.........,.....,..XX.XX..XX,,X-:X....,......,...........................:X.........X
--X.XX........,..,.............EX-X........XA.,...,...,.........,....,..:XX,XX..XX,,X-X.....,......,.............................,........X
--XXX-X.......,..,........E.....X-X.......X-X.,..,....,.........,...,....XX:XX..XX,,XX......,......,.............................,........X
------X.......,..,.............X--X.......X--X,.,.....,.........,..,.....:X..X..XX,,XX......,......,..............................,.......X
-------X.....,...,......:....XX---X......X---X:,......,,,,,,,,,,,..,......X:.X.X-X,X-X......,......,..............................,.......X
-------X.B...,..,..........XX----X.......X----X.....:.............,......,XX,X,XX,,X-X......,......,...............................,......X
--------X....,..,.....XXXXX------X......B------XXX...............,.....,,.XX:XHXX,,XX.......,......,................................,....,X
--------X....,..,...XXXAX---XXXXB.......X---------XX,,,,,,......,.....,.:XX-XXXXX,,XX.......,......,................................,....,X
---------X..,...B.XXHAH.,XXX.,..,........X--------X.....E.,,....,....,...XX-X--X,,X-X.......,...T,,,....................,T,..........,...,X
---------X..E.E,.XXA..,,,.....,.,.........XX----XX..........,,.,A.:,,:.:.X.E-:XX,,XX........,...,,.,.....................,,...........,..,X
----------XXX,,XX-X.,,,.......,..,..........XX-X..E...........XXXXXX:.:..X,X-EX,,,XX........,...,..,......................,...........,..,X
-----------XX,,X--X,...........,.,............X...HXXH,XXH...EX---X.::E:XX:X-X....XX........,......,...................................,.,X
---------XX.,.,.XX.+...........,.,................XX....XXX...X--X.:.:.XX-X:-X...AX:........,......,...................................,.,X
-------XX.B.T,T..,.+...........,.,...............X........X...X-X,...XX---X,XX....,.........,......,...................................:,,X
-----XX.....,....,..+...........,.,..............,........,H...X-X,XX----X:.XX...H,.........,......,.........,..........................,,X
----X.............,.+...........,.,.............,H.........,...X-X.E----X.:X-XE...,A........,......,.........,.........................A,,X
---X...............,.+...........,XXXXXXB.......X.....:....XX,,XX-X:XX:E.:.X-X....XX..A.....,......,........,,..........................,,X
--X.<......E........,.+.........+XXXXXXXXXXXXX..X..........X...,.XX.,:.:,.X-XX,,..X-XX......,......,.......,,,,.........................,,X
XX..................,.+......+++,,.A...:.X---X.HXX........X,.E,.E.XXXXXXXXXX....,XX---XX....,......,......H,,,,,H.......................,,X
X,<.:.<..............,.XXXXX+..,..,......X---X..XX........XX..,....XXXXXXXX.E....LLXXXX-X...,......,.....,,....,,......................A,,X
XX...................BX-----X.,.,,,.,,,,,.X--X..X.H.....,,X...,....,......,......LL,,,,XX...,......,....,,,.>>,,,,,.....................,,X
--X.<.................X------X,.,..,,...,..X-X.....XXXXXH..,,,...XX.......,......LL,,,,,,...,......,..,,,,,.>E,,,,,,,..................:,,X
--X...................X------X.,,.K,,.E.,..X--X....XXHXX.....XXXX--XX.....,.E....LL,XXXXX...,......,.....,,.,,,,,.......................,,X
---X...........E......X------XA..,,.,...,...X--XX..........XX--------X,,,XXX......XX----X...,......,......,,,,,,.......................A,,X
----X..................XX----X..,,,,,...,....X---XE.....EXX--------XX..HAX--XX,,,X----XX....,......,......H,,,,.H.......................,,X
----X....................X----X.,.......,....X----X,,,,,X---------X......X---X...X--XXA.....,......,........,,..........................,,X
-----XX...................X---X.,.E.....,.....:XXXX,,,,,:--------X:.,,,,,X---X....XX........,......,........,,..........................,,X
-------XXXXX...............XX-:.,.......,.....,..........X-----XX...,...,X---XE...,A........,......,.........,.........................A,,X
------------XXXXX............XXX,,,,,,,,,....,............XXXXX.....,.E.,X--XX...H,.........,......,.........,.........................:,,X
-----------------XX...........XXXX...........,............,..E......,...,X--X,...A,:........,......,....................................,,X
-------------------X............XXXX.......,,.............,.........,,,,,X-X,.,...X.........,......,...................................,.,X
--------------------X.............X-XX...,,...............,..............X-X.,,...X.........,......,...................................,.,X
---------------------XX..........B.X--XX:.................,..............XA.E,,...XX........,......,..................................,..,X
-----------------------B............X---X.................,..............XX..,.,..XX........,...T..,.....................T............,..,X
------------------------X...........X----X................,..............XX.E.,,...XX.......,......,.................................,...,X
-------------------------XX..........X----X.............,,...............XA...,,...XX.......,......,................................,....,X
---------------------------X..........X----X...........,.................XXE..,,...XX.......,......,................................,....,X
----------------------------X.........X-----X.........,..................XX..E.,,..XX.......,......,...............................,......X
-----------------------------XX.......X---XX-X......,,....XX,H,X,........XA....,,...XX......,......,..............................,.......X
-------------------------------XXB...,.XXE.EX-X....,...T,,...T...XX......XXE..E,,...XX......,......,..............................,.......X
---------------------------------XX.,.,..:..EX-X:,,....XX........X,......XX.....,,..XX......,......,.............................,........X
-----------------------------------X.,.....:.EX-X......X.........,.,.....X-XE.E.,,..,X:.....,......,...........................:.,........X
----------------------------------XXX.:.::.::..XX......,...XX,XX.E,,......X-X,.E,,.,.XXX....,......,...........................XX.........X
----------------------------------XE,::.A,,A.:.,,......,E..XX,X:..,.,.....XX,.,,.,,,..X-XX..,......,.........................XX--X........X
---------------------------------X,,X..:.,W,:.A,,.....,...X-X,XXX..XX.....HXX,..,XX...,X--XX,......,.......................XXXXXX-X.......X
---------------------------------X,,XE:..,,.:.:,,.....,...X-X,X.,.E,,......,,.,,.XB.,,:X--K.XX.....,.....................XX-XE,EX--X......X
--------------------------XXX----X,,X....A:....XX.....X..X--X,X.X..,,......K,...,XX,...X-X....XX...,...................XX---XXXXX---X.....X
--------------------------X,X----X.,XXX:....:.X-X.....,E.X-X.,.XX..,:......,,.:.,,,....X-X...E:.XX.,...A...A...A.....XX-----X--------X....X
--------------------------XXX----X,,.X-X.:...X--X.....,..XX.....X..A,......,,..,.,,....XX:ttt.....XX,,,,,XXXXX,,,,,XX-------X---------X...X
----------------------------------X.,XX-X.AAX--X......A..XXE...EX..,,......,,..,.,,....,,.tTt...E.+,................XX------X----------X..X
-----------------------------------X,.,XX,,:X--X......,..XA....AX..,,......,,.,..,,...A,H.ttt....+.,.................AX-----XXXX--------X.X
-----------------------------------XX,.,E...X-X.......,E.XX..:..X.E,,......,,,...,,....,,E..:E...+.,..................X-----X,tX---------XX
-------------------------------------XXX,,,X-X........X..XX.ttt.XX,XX......XX....XX....XX,A,,,XXXX..,.................X-----XEEX---------XX
-------------------------------------:XX,,.X-X.......EX..X-XtTtXX..XX......:,....XX...EXX,,,,,XX--XX,.................X-----XEEX---------XX
-------------------------------------X....,XX.........XX,XXXX,XX...XX......,,....,,....,:..A.T..XXXXXXXXXXXXXXXXX...,,.XX---X.,X------XXXXX
-------------------------------------X....,...........XX..A..H.....X.......,,....,,....,,,,,,,,,,,,,,,,,,,,,,,,,XXXX.....X--XEEX------X.,.X
------------------------------------X.....,...........XX.........E.,.......,,....,,....,,.....................,..,XX......XXXEEX------X,t,X
------------------------------------X....,...........:XXE.........,........,,....,,...,,,.....................,...TXXE......X.,X------X...X
-----------------------------------X,...,.............,,..........,........,,...:,,...,.,.....................,.....X,,,,,,,XEEX------X.E.X
----------------------------------X..,.,...............,,.......EH,........,,....XE...X.,......................,...:X......:XEEX------X...X
----------------------------------X..,.,...............H,........,.........XX....,,...,.,...........,,,,,......,,,,.X:...,,,X.,X------X,,,X
---------------------------------X....X.................,E...T.E,,..........X....,,...,.,...........,...,......,,E,.,,...,E,XEEX------X,t,X
--------------------------------H.....X.................XXHHHHXXX...........,....,,...,.,...........,.E.,......,,.,.,,...,.,X,,X------X...X
--------------------------------X....EX.................X-HHHHX-X............,...,,...,.,...........,...,......,,E,A,H,..,E,XXXX------X.E.X
--------------------------------X.....X..................XX,,,XXX............,...,,...,.,...........,,,,,......,,.,.,..,.,.,X---------X...X
--------------------------------X.....,.........................E............,...XB...,.,......................,,E,.,..,.,E,X---------X,,,X
--------------------------------X.....,.......................................,..XX..:X:,.......................,,,.X...,,,,X---------X,,.X
--------------------------------A.....,.......................................,..X....X,,,,,,,,.................,..:XE...,..XXXXXX----Xtt,X
--------------------------------X.....XA........,,,,,.........................:.H,,...X.,......,,,,,,,,,,,,.....,...XX...,..X,tt,X----X.E.X
--------------------------------X.....X,........,...,..........................,,..,..X..,,........,,,,,,,,,,,,,T.,,......,.XE..EX----X...X
--------------------------------X.....X,,,:.....,.E.,.................,,,,,..A.XX..,.XXtt..,.....,,,..,.,.,.,,..,H.........,XXXXXXXXXXXXXXX
--------------------------------X.......,,,,....,...,.................,...,:.,,X.,..,XXTt..H,:.,,...,.,.,.,...X,...........:X------------XX
--------------------------------:.E.........,XX,,,,,,.................,.E.,.,,,..,...XXXXXXXXXX,.T..XXA,,,,,XXA.............X------------XX
--------------------------------XX............X,,,....................,...,,,.....,.,..XX----X.A,,.X-X......X-X...........XXX------------XX
----------------------------------XX............,,,,..H..,,XX,,,,,X,,,,,,X,,.....E.X...:.XXXX,,,,,XXX......X--X.........XX--X---XXXXXXXXXXX
------------------------------------XXX.............,XX,,,,BX,,A,,X,,,,,XX.......XX-XX.,,E..E.E..E.......,X---X.......XX----X---XtttttttttX
---------------------------------------XXX.E.........EX,,.............,,,E......X----XX,,,,,,,,,,,...,,,,:X----X....XX--XXXXX---XtEE.EE.EtX
------------------------------------------XX...................................X---XX,,......,,,,,,,,..,A,X----X,,XX----XE,EX---XtEE.EE.EtX
--------------------------------------------XXX...............E..............XX-XXX..,.,,,,............,E,AX---X,.X-----XXXXX---Xt.......tX
-----------------------------------------------XX.B.........,XX,,,XX,,...B.HX-XX....,..,...,,,,,,,,....,.,.XXXX..,X---------X---XtEE.EE.EtX
-------------------------------------------------XX:,,,,,X,,,XX,,EXX,,,XX,,,XX......,.,.:..........,,,,,E,.,..,,,.X---------X---XtEE.EE.EtX
----------------------------------------------------X....,..E,.E..,..E.,...E,,.....,..,.,...........:.,,.,,,..,..X----------X---XtttttttttX
-----------------------------------------------------XX..,....,...,....,E...,.,....,.,..,.............,,.,,.,..,.X--XXXXXXXXE---XXXXXXXXXXX
-------------------------------------------------------X,...XXXXXXXX...,....,..,..,..,..,..............,E,,.,..,X---X,,tt,,tX------------XX
--------------------------------------------------------XXXX--------XX..,..,....:.,..,...,.............,.,,.,...X---XE.EE,,tE------------XX
----------------------------------------------------------------------XX,A.,.....,..,....,.............,E,..,..XX---XE.EE,,,X------------XX
------------------------------------------------------------------------XXXX........,....,.............,,,...,X.E---X....,.,X-----XXXXXXXXX
----------------------------------------------------------------------------XX.....,......,............,.,...XX.X---XE.EE,.,E-----X.,,,,..X
------------------------------------------------------------------------------XX...,.....,,,,,..........,,HXXXE.E---XE.EE,.,X-----Xt,t,t,,X
--------------------------------------------------------------------------------X:,.,,,,,,:,,,,,,,,,,,:.,XX-XEE.E---X....,..X-----XE,E,E,EX
----------------------------------------------------------------------------------X,E...E.E..E.E..E.E,,,X--Xt...X---XE.EE,tEX-----X,,,,,,,X
---------------------------------------------------------------------------------X..,,,,,,,,,,,,,,,,,,...X-X,EE.EXXXX,,,,,,,X-----XE,E,E,EX
--------------------------------------------------------------------------------XXXXXXXXXXXXXXXXXXXXXXXXXXXXXXXXXXXXXXXXXXXXX-----XXXXXXXXX
