---XXXXXXXXXXXXXXXXXXXXXXXXXXXXXXXXXXXXXXXXXXXXX------------------------------------------
---X,,,,,,,,,,,,,,,,,,,,,,:,,,,,,,,,,,,,,,......X-----------------------------------------
---X,..,A,,,..,,,HA,...E.E::.,:,.E.,.E.:,,.......X----------------------------------------
---XE..,.,,T.<.,,..,......:H,:..,.,:....,,........X---------------------------------------
---X,..,<,,,..,,H..,,,,,,,,,,,,,,,,,,,,,,,........,X--------------------------------------
---X,,,,,,,,,,,,,H.,................,,.:,,.........X--------------------------------------
---X,<...,,,,K,,,..,................,,E.,,..........X-------------------------------------
---X,...<,,..,,,,H.,.....E..........,,..,,...........X------------------------------------
---X,...,,,.E..,,H.,................,,.,,,............X-----------------------------------
---X,...,,,..,,,,..,................,,,.,,.............X----------------------------------
---X,..:,,,,,++,H..,,,,,,...........,,E.,,.............,X---------------------------------
---X,...,,,+++,,,..,,,,H,,,.........,,,.,,..............,X--------------------------------
XXXX,...,,,,,,,,,H.,.....,,.........,,.,,,...............,X-------------------------------
X.Et,..,.,,E.E,,,..,E.....,,........,,H.,,................,X------------------------------
XH.t,..,.,,,,,,,,E.,.......,,.......,,.,,,.................,X-----------------------------
XEEt,..,.,.E..E,,..,.......,A.......,,.:,,..................X-----------------------------
X..t,..,.,,,,,,,,,,,.E......,,......,,..,,..................,X----------------------------
XEEt,..,....E,E,.,,,........,,......,,,,,,...................,X---------------------------
XXXX,.,...,,...,,,L,........,,......,,E,,,....................,X--------------------------
---X,.,.,,....E,,,L,.......,,,......,,,.,,.....................,X-------------------------
---X,,,,.......,.EL,.......,.,,.....,,.E,,......................,X------------------------
---X,,,......H.,..,,.......,.,,.....,,..,,.......................,X-----------------------
---X,,,,,,,,,,,,,,,,.......,.,,.....,,:,,,.......................,.X----------------------
---X,,,..,...,.....,.......,.,,.....,,,.,,........................,.X---------------------
---X,,,,,,,,,,,,,,,,......,..,,.....,,.,,,.........................,.X--------------------
---X,A,E,....,,E,,.,...:..,..,,.....,,E:,,..........................,X--------------------
---X,,,.,..E.,,.,,,,......,..,,.....,,.:,,...........................,X-------------------
---X,.,.,....,,.,,.,......,..,,.....,,,,,,............................,X------------------
---X,,,.,,,,,,,.,,,,,.....,..,,.....,,:,,,............................,.X-----------------
---X,.,...,.,...,,.,,....,...,,.....,,,.,,.............................,.X----------------
---X,,,...,.,...,,,,,....,...,,.....,,E.,,..............................,.X---------------
---X,.,..,,.,,E.,,.,,....,...A,.....,,,:,,...............................,.X--------------
---X,,,..,:.,,..,,,,,....,...,......,,.,,,................................,X--------------
---X,....,,.,,..,,.,,....,E..,......,,..,,.................................,X-------------
---X,....,,.,,..,,,,.,..,....,.....E,,,,,,.................................,.X------------
---X,...,.,.,.,.,,.,.,..,...,,......,,+,,,..................................,.X-----------
---X,,,,,,,,,,,,,,,,,,,,,,,,,,+++++,,,,,,,...................................,X-----------
---X,E.,,..........................,,...,,....................................,X----------
---X,,,,,..........................,,...,,...E.................................,X---------
---X...............................,,,,..,,....................................,X---------
---X...............................,,..,,,,....E................................,X--------
---X...............,...,.......A...,,....,,......................................,X-------
---X..A............,,.,,..,........,,...A,,.......................................,X------
---X...............,.,..,.,.........,,...,,........................................X------
---X...............,....,,,.........,,....,,.......................................,X-----
---X.............,,......,,.........,,....,,....E...................................,X----
---X.....,,,.......,,.....,.........,,,,,,,,.........................................X----
---X.....,W,........,,....,.........,,....,,..........................................X---
---X.....,,,......,,....E.,,,.......,,....,,...........................................X--
---X................,,.......,,,....,,....,,....E......................................,X-
---X..................,.....,,......,,.A:.,,............................................X-
---X.................,....,,........,,.....,,............................................X
---X.................,....,.........,,.....,,............................................X
---X................,,,...,.........,,.....,,............................................X
---X............:..,,..,,,..........,,...,,,,...E........................................X
---X.....................,........E.,,,,,..,,............................................X
---X...............................,,,.....,,............................................X
---X............................E..,,.,....,,............................................X
---X........,,,,..............E...,,..,....,......................,,,,,,,,,,,,,,,,.......X
---X........,,,,,,,,,,,...E...,,,,,.A.,....,......................,...,..,.....E,,.......X
---X,H......,...,,,,,,,,,,,,,,,,,.,...,...,,......................,.E.,..,......,,.......X
---X.,,.....,.....,....,,,,,,.....,....,,,,.......................,...,..,......,,.......X
---X..,,....,...A.,...........A...,...,,,,........................,,,,,,,,...:..,,.......X
---X...,,,..,.....,...A...........,.,,.,..........................,...,..,......,,.......X
---X.....,,,,.....,...............,,,,,....E......................,,,,,..,......,,.......X
---X.......,,,,,..,..............,,,..............................,...,,,,,,,,..,,.......X
---X........H...,,,,,..........,,,................................,,,,,,,,,,,,,,,,.......X
---X.................,,,,,,,,,,.,.................................,...,E....,,..,,.......X
---X........H..........,,.,,,,,,..................................,.E.,.....,,..,,.......X
---X...................,,.....,,..................................,,,,,.....,,..,,......,X
---X........H..........,,.....,,.,,,,,,,,,,,,,,,,,,,,,,,,,,,,,,,,,,,,,,.....,,..,,......,X
---X......H..H.........,,.....,,.,,....,,.,.,.,.,,.....,..,,,.,..,,.........,,E.,,......,X
---X...........H........,.....,,.,,....,,..,,,..,,.....,..,,,.,..,,.........,,..,,......,X
---X.....H..............,.....,,.,,....,,..,,,..,,.:...,E.,,,.,.E,,........,,,,,,,......,X
---XH.HH.....A:.H.H.H.H.,.....,,.,,...E,...E,,E..,.....,..,,,.,..,,.....,,,.,,..,,......,X
---X.....H..............,.....,,.,,....,....,....,.....,..,,,,,,,,,.,,,,....,,..,,......,X
---X...........H........,.....,,.,,,,,,,,,,,,,,,,,,,,,,,,,,,......,,..E..H..,,..,,......,X
---X......H...H.........,.:...,,.,,,,,,.........,,,,,,....,,....E.,.........,,..,,......,X
---X........H..........,,.....,..,,,,,,..E.ttt..,,,,,,Ettt,,......,,,,,,....,,..,,......,X
---X.........H.........,.....,,..,,..,,....tTt..,,..,,.tTt,,...B..,,,,,,,,,,,,,,,,......,X
---X...................,...E.,,..,,..A,....ttt.E,H..,,.ttt,,.B..B.,,,,,,,,,,,,..,,......,X
---X.........H.........,.E...,,..,,..,,.E...H...,,..,,E...,,.B.:B.,.........,...,,......,X
---X.........H.......E,,,,,,,,...,,,,,,.........,,,,,,..E.,,.BE.B.,...:.....,...,,......,X
---X,,,,,,,,,,,,,,,,,,,,,,,,,,,,,,,,,,,,,,,,,,,,,,,,,,,,,,,,...B..,E,,,,,,,,,,,,,,......,X
---X,,,,.,,,,,,,,,,,,,,,,,,,,,,,,,,,,,,,,,,,,,,,,,,,,,,,,,.,......,,,,,,,,,,,,,,,,,.....,X
---X...,.,..............+++++...,........,,,,,,,,,,,,,,,,,.,.......A.,,,,,,........,,,,.,X
---XH..,.,.........,,...........,........,...............,.,.........,...,,............,,X
---X,,,,.,.......,,..,..........,....,,..,.........,,....,.,.........,.E.,,.............,X
---X,,,,.,.......,...,..........,..,,..,.,.......,,..,...,,,,,,,,,,,,,...,,.............,X
---X...,.,.....E,.....,.........,..,...,.,.......,...,...,.,A,.A,.,.A,.A.,,.............,X
---X...,.,.......,,..,..........,.,.....,,......,.....,E.,.,.E..,A,..,...,,.............,X
---X...,.,.........,,...........,.,.....,,......,.....,..,.,.,..,.,..,...,,.............,X
---X...,,,.......H..............,..,,..,.,.......,,..,...,,,,,,,,,,,,,.:.,,.............,X
---X..E,,,..........,,,,,,,,,,,,,....,,..,.........,,....,.,......E.H,...,,.............,X
---X:..,,,..........,...........,........,.............H.,.,.........,,,,,,.............,X
---X...,,,..........,,,,,,,,,,,,,........,,,,,,,,,,,,,,,,,,,,,,,,,,,,,,,,,,,,...........,X
---X...,,,..........,,:......K,,,........,.:.,.:.,.:.,.:.,.,,.,.........H..,,...........,X
---X...,.,..........,,....,,..,,,........,...,...,...,...,.,.,,............,,...........,X
---X...,.,..........,,..,,,.,.,,,........,...,...,...A.A.,.,..,,,,,,,,,,,,,,,...........,X
---X...,.,.......:..,,..,E.,,.,,,........,.A.,.A.E...,...,,,..,,,.....,H..H,,......E....,X
---X.:.,.,..........,,.,,...,.,,,........,...,...,...,...LL,..,,+.....,,.H.,,...........,X
---X...,.,..........,,.,,.W.,.,,,........,...,...,.E.,...LL,.E,,+.....+H.EH,,...........,X
---X...,.,..........,,..,,.,,.,,,........,...,...,...,..:LL,..,,+.....,H...,,...........,X
---X..E,.,..........,,....,,..,,,........,...,..E,...,.H.L,,..,,,,,,,,,,H,H,,...........,X
---X...,.,..........,,........,,,........,...,...,...,...,.,..,,,,,,,,,,,,,,,...........,X
---X:..,.,..........,,:,,,,,,:,,,........,.:.,.:.,.:.,.:.,.,,,,.........A..,,...........,X
---X...,.,..........,,,,,,,,,,,,,........,,,,,,,,,,,,,,,,,,,,,,,,,,,,,,,,,,,,...........,X
---X...,,,..........,...........,........,...............,.,......,,,......,,...........,X
---X...,,,..........,,,,,,,,,,,,,........,...............,.,,,,,,,,,,,,,,,,,,...........,X
---X.E.,,,.........,,.,.........,....,,..,.........,,....,.,............,...............,X
---X...,,,.........,..,.........,..,,..,.,.......,,..,...,,,............,,..............,X
---X...,,,........,....,........,..,...,.,......,.....,..,,,.............,..............,X
---X...,.,........,....,........,..,....,,......,.....,..,,,.............,..............,X
---X...,.,.........,,.,.....H...,...,..,.,.......,,..,.E.,,,.H...........,..............,X
---X...,.,...........,..........,....,,..,.........,,....,,,.............,,.............,X
---X:..,.,............E.........,........,.............H.,.,.............,,.............,X
---X..E,.,......................,.:......,,,,,,,,,,,,,,,,,.,.H....:......,,.............,X
---X,,,,.,,,,,,,,,,,,,,,,,,,,,,,,,,,,,,,,,,,,,,,,,,,,,,,,,.,..............,.........:...,X
---X,,,,,,,,,,,,,,,,,,,,,,,,,,,,,,,,,,,,,,,,,,,,,,,,,,,,,,,,..............,,............,X
---X............,,...,,.........,......,..:..:..,.....,,......H...........,,............,X
---X.....H......K,...,,.........,B..E..,........,....B,,..................,,............,X
---X...,,,,,,,,,,,...,,...H.....,......,........,.....,,......H...........,,............,X
---X...,,,,,,,,,,,.E.,,.........,,,,,,,,........,,,,,,,,..................,,............,X
---X...,,.,.,.,..,...,,.,,,,,...,......,........,.E...,,.....A......E.....,,............,X
---X...,..,E,.,..,:..,,.,,.,,...,.B....,..,,,,,.,...B.,,.....H............,,............,X
---X...,,.,.,.,..,...,,.,,.,,...,,,,,,,,..,...,.,,,,,,,,..................,,............,X
---X...,,,,,,,,,,,,,,,,.,,,,,...,......,..,.A.,.,.....,,....H.............,,....E.......,X
---X...,..,,.H,,........,,.,,...,......,..,...,.,.....,,..................,,............,X
---X...,,,,,..,,E...:...,,.,,...,.B....,.E,,,,,.,.....,,...H..............,,............,X
---X...,..,,..,,,,,,,,,,,,.,,...,......,..,.A.,.,...B.,,..................,,............,X
---X.E.,,E,,.E,,,,,,,,,,,,,,,..,,,,,,,,,.H,...,E,,,,,,,,...H..............,,............,X
---X...,..,,..,,.,E,.,,.,,.,,..AH......,,,,,,,,,H.....,,.........E........,,....E.......,X
---X...,,,,,,,,,,,,,,,,.,,E,,..,,...:..,,,,,,,,,,.....H,..H...............,,............,X
---X.E.,H,....,,.,.,.,,.,,.,,..A,......,......E.,.....,,..................,,............,X
---X...,.,....,,.,,,,,,E,,.,,..,,......,.E......,.....,,..H..............,,.............,X
---X...,H.,...,,.,,,,,,,,,.,,..EH.B....,B...B..B,...B.,,.................,,.............,X
---X...,H.,.:.,,.E.,.,,.,,.,,,,,,,,,,,,,,,,,,,,,,,,,,,,,.A.........E....,.,.............,X
---X...,..,..,,,,,,,,,,.,,.,,,,,,,,,,,H,,,,,H,,,,H,,,,H,................H,..............,X
---X...,H.,..,,,.,.,.,,.,,.,,.........................,,...............,.,..............,X
---X...,H..,.E,,.,.,.,,.,,.,,.........................,,......E.......,,,...............,X
---X...,,,,,,,,,,,,,,,,,,,,,,....H....................,,.E..........,,.,,...............,X
---X..........A..A.A.A.A.......H..H..........H........,,.........,,,.,,.................,X
---XH...A.A.A............A.H.H........................,,.......,,..,,...................,X
---X,,,,,,,,,,,,AA,,A,,,,,,,,,,,,,,,,,,,,,,,,,,,,,,,,,,,,,,,,,,,,,,,,,,,,,,,,...........,X
---XXXXXXXXXXXXXXXXXXXXXXXXXXXXXXXXXXXXXXXXXXXXXXXXXXXXXXXXXXXXXXXXXXXXXXXXXXXXXXXXXXXXXXX
