------------------------------------------------------------XXXXX----------------------------------------------------------------------------------------------
---------------------------------------------------------XXX,,..,XX--------------------------------------------------------------------------------------------
-----------------------------------------------------XXXX,,..,..,..XX------------------------------------------------------------------------------------------
--------------------XXXXXXXXXXXXXXXXXXXXXX------XXXXX,,,,.,..,.,E..,,XXXXXXXXXXXXXXXXXXXXXXXXXXXXXXXXXXXXXXXXXXXXXXXXXXXXXXX-----------------------------------
--------------------X,,,,,,,,,:,,,,,,,,,,,XXXXXX,,,,,..,..,..,.,..,...,,,...,,,,,,,,,,,,,,,,,,,,,,,,,,,,,,,,,,,,,,....,,,,,X-----------------------------------
--------------------XE......,,,,,....E,,......,,...,....,..,.,.,..,..,..,....,,:,...............,:,...,,.........,....,...,X-----------------------------------
--------------------X,......,,,,.A....,,........,...,...,..,.,.,.,..E...,......,.................,....,,........,.....,...,X-----------------------------------
--------------------X,........,.....E.,,.........,...,...,.,.,.,.,.,....,.............................,,........,....,....,X-----------------------------------
--------------------X,H......,........,,..........,A..,..,.,.,.E,..,....,.............................,,........,....,.....X-----------------------------------
--------------------X,..E.E..,........,,............,..,..,.,,,.,.,.....,.............................,,........,....,.....,X----------------------------------
--------------------X,..,,,,,,........,,.............,..,.,.,,,,.,.E....,.............................,,.......,.....,.....,X----------------------------------
--------------------XE.......,E.......,,..............,,.,.XXXXXX.......,.............................,,.......,....,......,X----------------------------------
--------------------X,,,,....,,,,,,...,,................,XX------X,.....,.............................,,.......,....,......,X----------------------------------
--------------------X,,,,.....,,,,,...,,...............,XX--------XX,...,......,.................,....,,.......,....,......,X----------------------------------
--------------------XE........,,E.....,,H........,,,XXXX------------XX,,,.....,:,.............E.,:,...,,......,.....,.......X----------------------------------
--------------------X....E....,,......,,,,,,,,,,XXXX------------------XX,,,,,,,,,,,,,,,,,,,,,,,,,,,,,,,,,,,,,,,....,........X----------------------------------
--------------------X,,,,,,,,.,,..,,,,,....XXXXX------------------------XXXXXXXXXXXX.,LLL,.,..........,,.,,...,....,........X----------------------------------
--------------------X,,,,,,,,.,,E.,,,,XXXXX-------------------------------XXX------X,,,,,,,,XXXXXXXXXXX,...,,,.....,........X----------------------------------
------------XXXXXXXXX:.,......,,...,.EX--------------------------------XXX,,,XX----X.......HXXXX....XXX,.....,.....,........X----------------------------------
------------X,,,,,,,,,,,...E....,..,..XXXXXXXXXXXXXXXXXXXXXXXXXXXXXXXXX,,.....,XX--X.......,XXA.E.E...X,....,,,,,,,.........,X---------------------------------
------------X,HE.E.E,,,..E..,.E.,E.,E.,,...,...,..,...,...t..,...,...,..........X--X.......,XX........X,....,....,,..........X---------------------------------
------------X,.E.E.E,..,,,,,,...,..,..,,...,...,..,...,...t..,...,...,..E.......,X-X....E..,XX.....E..X,.....,A...,..........X---------------------------------
------------X,Ettt..,..,,,,,,...,..,..,,...,...,..,...,...t..,...,...,.....E.E..,X-X.......,XXE.E.....,,.....,....,,.........X---------------------------------
------------X,AtTtEE,.......,.A.,E....,,...,...,..,...,...t..,...,..,....E.....E.X-X..E....,X...,E...,,.E.....,...,,.E.......X---------------------------------
------------X,.ttt..,.....,,,,,,,,..T.,,...,...,..,...,...t..,...,..,.E......E...,XX.......,X.E,..,.EXX.......,....,.........X---------------------------------
------------X,EE.E.E,.....,,.,,,,,....,,...,...,..,...,...t..,...,..,......T.....,XX.......,X.,,,,,,.XX.E.....,H...,,.E......X---------------------------------
------------X,A.....,.E...,,..........,,...,..H,..,...,...t..,...,..,...E....E..E,XX++++++++X,..K,.,HX,........,...,,........X---------------------------------
------------X,,E,E,E,,,,,,,,A...,,...E,,...,...,..,..H,...t.H,...,..,............X-X.......,X.E,.E,..X,........,....,,......,X---------------------------------
------------XXXXXXXXX.....,,....,,..,,,,...,...,..,...,...t..,...,H.,...E........X-X.......,X.,,,,,..XX.E.......,...,,......X----------------------------------
--------------------X.E..E...E..,,E,,,:,...,...,..,...,...t..,...,..,.....E..E..,X-X.......,X..E....E,,.........,...,,......X----------------------------------
--------------------X,,,,..,,,,,,,.,,,,,...,...,..,...,...t..,...,...,.E........,X-X.......,XX...E....,,E........A...,,.....X----------------------------------
--------------------X,,,,..,,,,,,,..,,,,...,...,..,...,...t..,...,...,.....E....X--X....A..,XX.E......X,.........,,,,,,.....X----------------XXXX--------------
--------------------X,,,.,.....,,,,,..XXXXXXXXXXXXXXXXXXXXXXXXXXXXXXXXX,,.....,XX--X.......,XXXXAE.EXX-X,........,....,.....X------------XXXX...,XXXXX---------
--------------------X.,,.,....,,.....EX--------------------------------XXX,,,XX----X,......,X---XXXX---X,......,,,....,....,X--------XXXX,.......:..,,XXX------
--------------------X:.,E,....,,EA,,,,XX------------------------------XXXXXXXXXXXXXX.,,,,,,,XXXXXXXXXXXXX,,,,,,,,,,,,,,....,X-----XXX,,................,X------
--------------------X,.,E,....,,......,,XXXX-------------------------X,,,,,,,,,,,,,,,,,,,,,,,,,,,,,,,,,,,,,,,,,,,,....,....,X-----X,....................,X-----
--------------------X,,,.,....,,......,,..,,XXX---------------------X,,....,:,......,.....,..E....,:,............,...,.....,X-----X......................X-----
--------------------X,,......E,,E....H,,..E...,XXXX---------------XX..,....,,,.....................,............,....,.....X------X......................,X----
--------------------X,,,,..,.,,,,,....,,.........,,XXXX----------X,...,.........................................,....,.....X------X.........E...E.........X----
--------------------X,E...E,.,,,,,,,..,,............,,.XXX-----XX...E.,........................................,.....,....,X------X......E...........E....,X---
--------------------X,.....,......,,.E,,..............,,,,X---X,.,....,...........................,,,........,,,....,.....,X------X........................X---
--------------------X,.....,......,,..,,....E.......,,..,.,XXX,.,E,...,...........................,:,..,,,,,XXXXXXXXXXXXXXXX------X....E...................X---
--------------------X,.....,......,,..,,..........,,...,..,,.,..,..,E.,....,,,......,,.....,,...,,,,,,XXXXXX----------------------X.....................E...X--
--------------------X,A,,,,,......,,E.,,,,,.....,,...,,..,.,..,..,..,.,,,,,,:,,,,,,,.,,,,,,.,,,,XXXXXX----------------------------X.........K...............X--
--------------------XXXXXXXX,,,,,,,XXXXXXXX,,,,,....,....,.,..,...,..,XXXXXXXXXXXXXXX,,,,,,,XXXX--------X-------------------------X..........................X-
---------------------------X,,,,,,,X--X----XXXXX,,.,.....,.,..,...,.,X--------------X.......XXXXXXXXX--X.X------------------------X......................E...X-
-------------------XXX-----X......,XXXXXXXXXXXXXXXXX.....,.,..,....,X---------------X.......,.......,XX:E.X-------------------XXXXX,,,,,,,,,,,,,..............X
-------------------XE.X----X...E..,X,....tt....X----XX,.,..,...,.,,X-----------------X.......,....,,..,,:X-------------XXXXXXX..+,,.A..........,..........,...X
-------------------X.,.X---X,,...,,X,E..EttE..EX------XX,,.,..,,,.X------------------X.......,..,,.....XX-----XXXXXXXXX.,..>....+,,..........T.,..K.....E.+...X
------------XXXXXXXX,..:X--X,,..,,,X,.E..tt...EX--------XX,,,XXXXX-------------------X........,,......,.XXXXXX.,..,..t..,..>....+,,.H..........,..........+..X-
------------Xt<t...,....X--X.,,.,,,X,E..EttE...X----------XXX------------------------X.........,.....,...,L.W,..,..,..t..,.>..XXXXX,,,,,,......,........E....X-
------------<tTt...,...HX--X,,..,,,X,.E..tt...EX--------------------------------------X........,...,,.....,L.,.A,.H,..XXXXXXXX----X,,,,,,,,,,,,,............,X-
------------Xttt...,....X--X,....,,X,...EttE...X--------------------------------------X.........,.,........XXXXXXXXXXX------------X........................:X--
------------X.<....,,.AX---X......,X,EE..tt...EX-------------------------------------X,..........,.........X----XX----------------X.........K............E.,X--
------------XXXXXXXX.,,X---X......,X,...Ett.E.EX------------------------------------X.,....,,,,..,.....,,,,,XX:XEX----------------X........................,X--
-------------------X...X---X,,,,,,,X,,,,,,,,,,,X-----------------------XXXXXXXXXXXXX...,.,,....,,H,,,,,......,.:.X----------------X........................X---
XXXXXXXXXXXXXXXXXXXX,,XXXXXX,,,,,,,XXXXXXXXXXXXX--------------------XXX..........,,....,,.........,,........,,XXXX----------------X.....E.............E...,X---
X..................,..,,.....,.A.,....X-------------------------XXXX...XXXXXXXXXX.....,.,...........,...,,,,...X------------------X........E..............X----
X..................,E.,,.....,,,,,....X-----------------------XX...A.XX--------X......,,.,...........,,,........X-------XXXXX-----X............E.........,X----
X,,,,,,,,,,,,,,,,,,,,,,,,,,,,,,,,,,,,,XXXXXXXX----------------X...XXX---------X......,..,.,.........,.,..........X-XXXXX.....X----XX..............E......,X----
X..,,,,,,,,,,,,,,,,,,,,,...,.,,.,,,E.A,,,,,,,X---------------X..XX-----------X.......,...,.,.......,.,,.....E...,X--X.........X-----XX,.................,X-----
X..,,,.,.,,.,.,,.,.,...,.A.,,,..,,,,.,A......X---------------X..X-----------X.......,.....,.,.....,.,.,........,..XXX.....E....X------XX,.............,,XX-----
X.,A.,.E.,,.,,,,,,.,..A,...,,,E.,,,,.,,......X---------------X.E------------X.......,......,.,...,.,...,......,..,..XX..........XX------XX,,..:.,,,,XXXX-------
X.,,,,.,.,,.,,,,,,.,...,...,,,.,,,,,.,,......X---------------X.X-----------X.......,........,.,.,.,....,.....,..,....XX.......t,,.X-------XX,,,,XXXX-----------
X,,,,,,,,,,,,,,,,,,,,,,,...,..,H,.,,.,,..ttt.X--------------X..X----------X........,.........,.,.,.....,....,..,....E.XX....t,,.E..X--------XXXX---------------
X,,,,,,,,,,,,,,,,,,,,,,,...,.E....,,.,,..tTtHX--------------X..X---------X..........,.........,:,....A.,....,.,...E.....X.t,,.E..,,.X--------------------------
X....,,................,...,......,,.,,E.ttt.X--------------X.X---------X...........,........,.,.,....,....,.,........E..XX.E..,,....X-------------------------
X....,..............E..,...,.E....,,.,,......X--------------X.X--------X,.A..........,......,.,.,.,,..,...,.,..E....E..,,.XX.,,..E.ttXX------------------------
X....,........,........,...,.....:,,.,,......X---X---------X..X-------X.:,...........,......,,...,,.,,...,.,.E.......,,....XX....tt,,..X-----------------------
X.....,......,,..,.....,.E.,E.....,,.,,......X--X,:X------XXHX------XX...,............,,...,.,.....,.,..,.,......E.,,.......XXEtt,,.E.,.X----------------------
X.....,.....,,..,,,...H,...,,,,,,,,,.,,,,,,,AX--X,,.X--XXX...X-----X...,,.,....E........,.,.,.......,..,.,.....E.,,.........X-X,,....,...X---------------------
X.....,......,,.,,.,...,.E.,,,,,,,,,.,XXXXXXXX-X.....XX....XX-----X.:.,.,,.,.............,.,......,,..,.,....H.,,............XX..E.,,.E.t.X--------------------
X.....,.......:,..,....,.............,X--------X......,,.XX------X,.,,.,..H,..............,,,...,,...,.,...E.,,...............XXX.,....t,,.X-------------------
X......,..,,.,.,,,.....,.E...........,X-------X.....E...X-------X..,.,,.....,................,,,....,.,.....,..................X-X..Ett,.E..X------------------
X......,...,,,,.,.,....,.............,X------X...........X----XX....,..A..,,.,.H...................,.,..E.,,....................X-X.t,,....,.X-----------------
X......,....,..,.,.....,........T...H,X------X..........,:XX-X.......,...,...,....................,.,...,,.......................X-XX.E...,...X----------------
X......,........,......,.............,X-----X.....T...E.,,,.X........,.,,.,EE.,...................,,..,,......................E..X---X...,..EtX----------------
X...A...,..............,.E...........,X-----X,...........,,,.,,.......,..E,...,.............E....,,.,,............................X---X.,.E.t,.XX--------------
X......,,,.............,.............,X----X:,..........,,.,...,,......H...,H.E,................,,,,...............................X---X....t,...X-------------
X,,,,,,,,,,,,,,,,,,,,,,,,,,........,,,X-----X.....E..E..,.,....E.,......,T.,.,,.,..............,,,..........................E...E...XX--XX.t,.....XX-----------
X,....,,,,,.,.,.,E.,.,,,,,,........,,,X------X.........,,,........,,....,..E,....,............,,...................................,:.X---XXX.E..E..X----------
X.E..,,.,,,.,.,,,,E,.,,,..,,..A...,,.,X------X,,......,,.,..........,....,A,....,,..........,,,,...................................,,,.XX----XX....X-----------
X....E,,,,,.,.,E,E,,.,,,,,,,.....,,,.,X---XX-X..X..,..,.,............,,...,...H,..,.A...,,,,,,,,,,,,,,.....................E..E..E.,.,.,.XX----XX.X------------
XXXXXXXXXXXXXXXXXXXXXXXXXXXXXXXXXXXXXXX--X:,XX..XXX:,,.,...............,,.,..,,.,,,..,,,,..,:,,:,.,...,,,,,.......................,.,.,....XXX---X-------------
-----------------------X---------------XX.,,..,,X--X,,,..................,.,,..,.:.,,.,.E...,.,,,..,.A..,..,,,,,..................,,,,........XX---------------
--------------------XXXXXXXXXXXX------X.........X---X.,...................,,.,,...,.,,........+,,..,...,..A.,..,,,,,.....E..E....,,,,........,,,XX-------------
--------------------XE...tt....X-----X...........X---X......................,...,,,,..........+,.,,..E.,....,H..,..,,,,,,,,..,,.,,,,.........,,:,.XX-----------
--------------------X...Ett..E.X---XX.........E..,X--X,......................,:,,,.............,,.,,,..,...,...,.....,..,,,,,,:,.,...........,,,,...X----------
--------------------X.E..tt....X--X.............,:,XX..,....................H.,,,:.............,,...,..,...,..,.....,.,,,,::,,,.,....E.......,,,,....X---------
--------------------XE.E.tt.E..X-X.......T.......,,.X...,............E......,,,.,,.............,,:,..,,..,,,,,,,...,...,,,.,,,,.,.................H...XX-------
--------------------X....tt....X-X,...........E.,,,,.,,.,..................,,,..,...............,,,,,,,,,...,,,,,,,.,,,..,,,.,.,........................X------
--------------------X.E..tt....X-X.,,..........,.,.....,,,....E...........,,.....,............,,,,................,,....,,,:.,.,........................X------
--------------------X..E.tt..E.XX....,....E...,.,........,,..............,,.......,........E.+.,:,,................,,.,,,.,,:,,.......................,..X-----
--------------------XE...tt....XX.....X.,,...,,,..........,,............,,.E......,.........+,,.,,,.................,,,....,,,,.....................,,,,.X-----
--------------------X.E.EttE...XX.....XX,:,,,,..............,...........,..........,.......,,,.....,.................,....,,,..,....................,,:,.X-----
--------------------X,,,,,,,,,,XX....X--X,,,,................,.........,............,.....,,,.....A,,.................,..,,..,.,.....................,,,.X-----
--------------------XXXXXXXXXXXXX....X---XX...................,.......,..............,..,,,.........,,................,.,,..,,..,.........................X----
--------------------------------X..A.X---X.,...................,.....,,,.............,.,,,...........,.................,,..,..,..,.....,,,,...............X----
-------------------------------X.....X---X..,,.................,..E.,,.,,.............,,,............,,................,,..,.,.,.,..,,,,,,.,,.............X----
-------------------------------X....X---X.....,.......E.........,...,,.,.,...........,,,..,,.........,:,,...............,.,,,...,.,,,,....,,,...........A..X---
-------------------------------X....X--X.H.....,.................,.,,...,,.........,,,..,,..,,.......,,,................,,,...,,,,,....E..E,.,.............X---
-------------------------------X....X---X.......,.................,.,....,,.......,,,..,......,.....,.,..................,...,,,.LL.E.......,,.............X---
-------------------------------X..H.X----X.....,.,,...............,,.....,,......,,,...,......,E....+,,,................,,.,,....LL.....H...,.,............X---
--------------------------------X...X-----X...,....,.............,,.......,,....,,,...,...:::..,..,++...,,,............,..,,.....LL........E.,,........,,,X----
--------------------------------X...X------X.,......,............,,........,,..,,.....,...::...E.,.+.E.....,,..........,,,,..E...LL....K.....,,.......,,:,X----
--------------------------------X....X------X........,,.........,,:,.......,,.,.,.....,.......,.,.,,,,,,,...,,.........,.,,E.....LL........E,,.........,,,X----
--------------------------------X...EX----XX.,.........,........,,,,........,,.,,......,......,,.,....,,,,,A.,.........,.,,,.....LL.E..E....,,..........,.X----
--------------------------------X....X-XXX:,,.,.........,........,,..........,,:,......,,,...,.,,........,,,,,,........,,,,,.....LL.........,,...........X-----
---------------------------------X...XX...,,.,.,,......,,,,......,,...........,,...H......,,,.,.,..........,..,........,.,,,,,..,,,....E.E.,,............X-----
---------------------------------X.,,.........,,.,...,,,...,......,,..........,,,............,.,...........,,..,.......,,.,,,,,,.,,,,,....,,,.........H..X-----
---------------------------------X,.........E...,.,.,..,....,.....,,...........,.+.........,,,,.............,,.,..........,,....,.,,,,,,,,,,............X------
----------------------------------X..........E...,.X..,......,,.E..,,...........,,.......E,.,.,,............,.H,,.........,,....,.,E..,,,,........,....X-------
-----------------------------------X......T.....,:XX..,........,....,,.........A.,,,..A...,,,..,,...........,..,,..........,....,,...............,,,..X--------
------------------------------------X..........E,X-X.,..........,....,,E..........,.,.,..,,..,,.,,..........,E.,...........,...,.,..............,,:,,X---------
-------------------------------------XX.........X---X,...........,E...,............,.,:.,.,....,,.,.........,.,,...........,,,,,,................,,,X----------
---------------------------------------X.......,X---X..............,..,,............,,,,..,......,,,......,,.E,,...........,...,,..................X-----------
----------------------------------------X.,,.,,.X---X...............,E.,,........E..,.,,,..,...,,,.,,..,,,E.,.,,...........,..,,.................XX------------
-----------------------------------------X:,X....X-X.,,............,.,,..,,.......,,,,,:,,..,..,T,,..,,,,.,.E,,...........,...,,..............A.X--------------
------------------------------------------XXX....XX:,,,,.........,,....,..,,,.....K,,.....,.,..,,,.,..,,,E.,,,............,,.,,................X---------------
--------------------------------------------X...,.,,..,,,.......,.......E,..,,,...,,,,,....,,,..,.,.E.,,,,,,.............,..,,,...............X----------------
---------------------------------------------X.,....E..,.,,....,..........,...,,,.,,.H.,,...,,,..,.,.,.,.,..............,...,,..............XX-----------------
---------------------------------------------X,.........,,,,.,,............,....,,:,,....,,...,,.E..,.,.,.,............,....,.........,,,..X-------------------
---------------------------------------------X..A.....E..,,XX.A.............E,.,.,,,,......,,..,..,.,.E,.,.,.........,,.,,.,,.........,:,,X--------------------
--------------------------------------------X,......E...,:,X-X................,.,,.,.,.......,,.,..,.,..,.,,,......,,.E...,,..........,,,X---------------------
-------------------------------------------X,:.ttt.......,X--X.......E.......,.,..,.,E,........,,,..E.,..,,,.,..,,,..,,.,,,............XX----------------------
--------------------------------------------X,.t.tT...E.XX----X.........E...,.,...,..,,..........,,.,..,,.,:,.,,,..,,..,,.............X------------------------
---------------------------------------------X.ttt.....X------XX............,,...,,...,E...........,.,,,,...,.,,.,,..,,..............X-------------------------
----------------------------------------------XX..,.H.X-------XX...........,,...,..,..,.,E..........,.,,.....,++,..,,,..........H...X--------------------------
------------------------------------------------X,:.XX----------X.........,,...,..,,...,.,...........,,.......,++,.,,.............XX---------------------------
-------------------------------------------------X,X-------------XX...H..,,..,,.E,..,...,,E...........,,.......+.,,,........,....X-----------------------------
--------------------------------------------------X----------------X....,,..,...,...,....,,............,,.......,..,.......,,,..X------------------------------
--------------------------------------------------------------------XX.,,,.,...,...,,.....,,,,..........,,,......,..,......,:,,X-------------------------------
----------------------------------------------------------------------X...,..E,...,..,.....,:,...........,.,....,:,.,,.....,,XX--------------------------------
-----------------------------------------------------------------------X..,..,...,..,,......,............,..,...,,.,.,,,,...X----------------------------------
------------------------------------------------------------------------X..,,..,,..,..,......,............,..,,.,.,H,....,,X-----------------------------------
-------------------------------------------------------------------------XX,..,...,..,.,......,,...........,...,.,...,,...X------------------------------------
---------------------------------------------------------------------------X.,...,..,...,,......,...........,.,,,..ttt.,.X-------------------------------------
----------------------------------------------------------------------------X...,..,...,..,,.....,...........,,....t.tA.X--------------------------------------
-----------------------------------------------------------------------------X.,...,..,...,.,..,,,,...E......,...E.ttt.X---------------------------------------
------------------------------------------------------------------------------X...,..,...,...,,....,........,,A.......X----------------------------------------
-------------------------------------------------------------------------------X.,..,...,...,.......,......,..,,..E..X-----------------------------------------
--------------------------------------------------------------------------------X,.,....,..,.........,,,..,.....,,..X------------------------------------------
---------------------------------------------------------------------------------X,....,..,...,:,.....,:,,....E.E.,X-------------------------------------------
----------------------------------------------------------------------------------XX,.,..,..,,...,,....,,.,.......X--------------------------------------------
------------------------------------------------------------------------------------XXX.,...,.....,....,..E.E.E..X---------------------------------------------
---------------------------------------------------------------------------------------X...,.H.....,..,.,,.,....X----------------------------------------------
----------------------------------------------------------------------------------------X..:....:..,K.,...,.,..X-----------------------------------------------
----------------------------------------------------------------------------------------X..,.......,.,.....,,.X------------------------------------------------
-----------------------------------------------------------------------------------------X..,.....,..,...XXXXX-------------------------------------------------
-----------------------------------------------------------------------------------------X..,,...,,.XXXXX------------------------------------------------------
------------------------------------------------------------------------------------------XX..,:,..X-----------------------------------------------------------
--------------------------------------------------------------------------------------------XX,..,X------------------------------------------------------------
----------------------------------------------------------------------------------------------XX,X-------------------------------------------------------------
------------------------------------------------------------------------------------------------X--------------------------------------------------------------
