-------------------------------------XXXXXXXXXXXXXXXXXXXX--------XXXXXXXXXXXXXXXXXXXXXXX--------------------------------------------
-------------------------------XXXXXX..................X-------XX.......................XXXXX---------------------------------------
------------------------XXXXXXX........................X-------X.............................XX-------------------------------------
------------------XXXXXX..............................X-------X.....E.....:.....E....:.........XX-----------------------------------
-------XXXXX--XXXX....................................X-------X,.........................E.......X----------------------------------
-------X.H.X--X......................................X--------X.,,,,,,,,,....,,,,,................XX--------------------------------
-------XA.AX--X......................................X----XXXX,..........,,,,.....,,,...............XX------------------------------
-------X.:.X--X......................................X----X.t,.......................,,,,,,,,,...:....X-----------------------------
-------XE.EX--X......................................X----XXXX................................,,......X-----------------------------
-------X,,,X--X..,,,:,.......,,,,,,.................X--------X..................................,.....X-----------------------------
------XX+++XXXX,,,,...,,,,,,,,,....,,...............X--------X..................................,......X----------------------------
------X.....,....,,.....,,....,....H,...............X-------X....................................,.....X----------------------------
------X.....,....,,.....,,....,.....,...............X-------X,...................................,.....X----------------------------
------X.....,..E.,,.....,,.E..,.....,................X------X.,,...........,,,,,.................,..E..X----------------------------
------X.....,....,,.....,,....,.....,................X-----X....,,,,.....,,.....,,,,..............,....X----------------------------
------X.....,,,,,,,.....,,,,,,,.....,.................XX---X........,,,,,...........,,............,....X----------------------------
------X.....,,,,,,,.....,,,,,,,.....,.................,.XXX...........................,,..........,.....X---XXX---------------------
------X.............................,:...............,..,...............................,.........,..:..X---X.X---------------------
------X.............................,,,,,,,,.........,..,................................,........,.....X---XtX---------------XXX---
------X.............................,,..,...,,......,...,.................................,.......,.....XXXXX,XXXXXXXXXXX-----X.X---
------X,,,,,,.......................,,.W,..,,.,.....,...,.,,.............,,,,,,,,.........,.......,.....,.............,..XX-XXX,XX--
------X....,,......,,,,,,,..........,,..,.A,..,....,....,,..,,...........,,.....,.........,.......,...E.,.............,...XXX.,,.X--
------X....,,......,....,,..........,,,,,,.,.H.,...:....,....,....,,,....,,.....,.....,,,.,.......,.....,.,,,,,,,,,,,,,...X-X....XXX
------X..E.,,......,....,,....,,,,,,,.....,,...,...,.A..,....,..,T,.,.:.A,,..A..,....H,.,T,,,,,,,,,......,,..........,,...XXX...,,.X
------X....,,......,..E.,,....,,....,.......,..,...,H..H,....:..,,,,,....,,.....,.....,,,,.,......,......,,..........,,...++,...,XXX
------X,,,,,,......,....,,....,,....,.......,...,...,...,....,...........,,.....,..........,.A.W.A,...:..,,..........,,...,:::::,X--
XXXXXXX,,,,,,......,,,,,,,....,,.E..,......,....,...,....,,,,............,,,,,,,,..........,,,,,,,,......,,..........,,...,+::::,XXX
X....XX............,,,,,,,....,,....,...,,,.,..,,...,....,...............,,,,,,,,..........,......,......,,..........,,...,+:::::,.X
X<.<.XX.......................,,,,,,,.,,.....,,.,...,,..,.................................,.......,......,,..........,,...XX:::::XXX
X....XX....,,,,,,,............,,,,,,,.,:.......:,...,.,,XXX..............................,........,...E..,,..........,,...XX:::::X--
X.<.<XX....,,,,,,,..................,.,.....,,,.....,...X-X............................,,.........,.......,,,,,,,,,,,,,....X:X:::X--
X....XX....,....,,..................,.,,,.,,.......,....X-X........................,,,,...........,.......,...........,...X---X.X---
X....XX....,..E.,,..................,.,..,,:.......,....X--X.,,,,,,,,,,,,,......,,,...............,.......,.XXXXXX....,.XX----XXX---
X.....,....,....,,......,,,,,,,.....,.,...,,......,,,...X--X,.............,,,,,,..................,.......XX------XXXXXX------------
X.....,....,....,,......,,....,.....,.,...,,,,,,,,...,,,X--X......................................,...:...X-------------------------
X..H..,....,,,,,,,......,,....,.....,.,..,,.,...........X---X....................................,.......X--------------------------
X.....,.................,,.E..,.....,..,.,,.,..........X--XXX...................................,........X--------------------------
X.....,................,,,....,....,....,,,.,.........:X--X.t,..................................,.......X---------------------------
X:XXXXXXX....,,,,,..A.W,,,,,,,,...A,.....,,,,,,....,,,X---XXX,.................................,........X---------------------------
--------X,,,,.....,,,,,,,,,,,,,,,,,,:..........,,,,...X------X.............,,,,,......,,,,,,,,,........X----------------------------
--------X...:......,...,..............................X------X..,,,,,,,,,,,.....,,,,,,................X-----------------------------
--------X..........E.E.,..............................X------X,,.................................E....X-----------------------------
--------X.........,..WA,..............................X------X...............E.........E....:........X------------------------------
--------X.........,E.E.,.............................X--------X...E....:..........:.................X-------------------------------
--------X.........,...,..............................X--------X.....................................X-------------------------------
--------X..........,H,,..............................X---------XXXXXXXXXXXXXXXXXXXXXXXXXXXXXXXXXXXXX--------------------------------
--------X............................................X------------------------------------------------------------------------------
--------XXXX,,.......................................X------------------------------------------------------------------------------
------------XXXXXXXX,,,,.............................X------------------------------------------------------------------------------
--------------------XXXXXXXX,,,,.....................X------------------------------------------------------------------------------
----------------------------XXXXXXX,,,................X-----------------------------------------------------------------------------
-----------------------------------XXXXXXXX,,.........X-----------------------------------------------------------------------------
-------------------------------------------XXXXXXXX...X-----------------------------------------------------------------------------
---------------------------------------------------XXXX-----------------------------------------------------------------------------
