------------------------------------------X--------------------------------------------------------------------------------------------------------
------------------------------------------X--------------------------------------------------------------------------------------------------------
------------------------------------------X--------------------------------------------------------------------------------------------------------
------------------------------------------X--------------------------------------------------------------------------------------------------------
------------------------------------------X--------------------------------------------------------------------------------------------------------
------------------------------------------X--------------------------------------------------------------------------------------------------------
------------------------------------------XX-------------------------------------------------------------------------------------------------------
-----------------------------------------X.X-------------------------------------------------------------------------------------------------------
-----------------------------------------X.X-------------------------------------------------------------------------------------------------------
-----------------------------------------X.X-------------------------------------------------------------------------------------------------------
-----------------------------------------X.X-------------------------------------------------------------------------------------------------------
-----------------------------------------X.X-------------------------------------------------------------------------------------------------------
-----------------------------------------X.X-------------------------------------------------------------------------------------------------------
-----------------------------------------X.X-------------------------------------------------------------------------------------------------------
-----------------------------------------X.X-------------------------------------------------------------------------------------------------------
-----------------------------------------X.X-------------------------------------------------------------------------------------------------------
-----------------------------------------X..X------------------------------------------------------------------------------------------------------
-----------------------------------------X..X------------------------------------------------------------------------------------------------------
-----------------------------------------X..X------------------------------------------------------------------------------------------------------
-----------------------------------------X..X------------------------------------------------------------------------------------------------------
----------------------------------------X...X------------------------------------------------------------------------------------------------------
----------------------------------------X...X------------------------------------------------------------------------------------------------------
----------------------------------------X...X------------------------------------------------------------------------------------------------------
----------------------------------------X...X------------------------------------------------------------------------------------------------------
----------------------------------------X...X------------------------------------------------------------------------------------------------------
----------------------------------------X...X------------------------------------------------------------------------------------------------------
----------------------------------------X....X-------------------------------------------------------------------------------------XXXX------------
----------------------------------------X....X-------------------------------------------------------------------------------XXXXXX....X-----------
----------------------------------------X....X-------------------------------------------------------------------------XXXXXX...........X----------
----------------------------------------X....X-------------------------------------------------------------------XXXXXX..................X---------
----------------------------------------X....X------------------------------------------------------------XXXXXXX........................X---------
----------------------------------------X....X------------------------------------------------------XXXXXX................................X--------
---------------------------------------X.....X------------------------------------------------XXXXXX.............................>>>>......X-------
---------------------------------------X.....X-----------------------------------------XXXXXXX...................................>..>.......X------
---------------------------------------X.....X-----------------------------------XXXXXX..........................................>..>........X-----
---------------------------------------X.....X-----------------------------XXXXXX................................................>>>>.........X----
---------------------------------------X..E...X----------------------XXXXXX....................................................................X---
---------------------------------------X......X---------------XXXXXXX..........................................................................X---
XXXXXXXXXXXXXXXXXXX--------------------X......X---------XXXXXX..................................................................................X--
X..................XXXXXXXXXXXXXXXXXXXX.......X---XXXXXX.........................................................................................X-
X...<.W.W.W.W.:.:.............................XXXX....................................................................................XXXXXXXXXXXXX
X...........................................................................................................XXXXXXXXXXXXXXXXXXXXXXXXXX-------------
X.:...W.W.W.:.:.H..................................................................XXXXXXXXXXXXXXXXXXXXXXXXX---------------------------------------
-XXXXXXX.................................................XXXXXXXXXXXXXXXXXXXXXXXXXX----------------------------------------------------------------
--------XXXXXXXXXXXXX.......................XXXXXXXXXXXXX------------------------------------------------------------------------------------------
---------------------XXXXXXXXXXXX...........X------------------------------------------------------------------------------------------------------
---------------------------------XXXXXXX....X------------------------------------------------------------------------------------------------------
---------------------------------------X....X------------------------------------------------------------------------------------------------------
---------------------------------------X..E.X------------------------------------------------------------------------------------------------------
---------------------------------------X....X------------------------------------------------------------------------------------------------------
----------------------------------------X...X------------------------------------------------------------------------------------------------------
----------------------------------------X...X------------------------------------------------------------------------------------------------------
----------------------------------------X...X------------------------------------------------------------------------------------------------------
----------------------------------------X...X------------------------------------------------------------------------------------------------------
----------------------------------------X...X------------------------------------------------------------------------------------------------------
----------------------------------------X...X------------------------------------------------------------------------------------------------------
-----------------------------------------X..X------------------------------------------------------------------------------------------------------
-----------------------------------------X...X-----------------------------------------------------------------------------------------------------
-----------------------------------------X...X-----------------------------------------------------------------------------------------------------
-----------------------------------------X...X-----------------------------------------------------------------------------------------------------
-----------------------------------------X...X-----------------------------------------------------------------------------------------------------
-----------------------------------------X...X-----------------------------------------------------------------------------------------------------
-----------------------------------------X...X-----------------------------------------------------------------------------------------------------
------------------------------------------X..X-----------------------------------------------------------------------------------------------------
------------------------------------------X..X-----------------------------------------------------------------------------------------------------
------------------------------------------X..X-----------------------------------------------------------------------------------------------------
------------------------------------------X..X-----------------------------------------------------------------------------------------------------
------------------------------------------X..X-----------------------------------------------------------------------------------------------------
------------------------------------------X..X-----------------------------------------------------------------------------------------------------
------------------------------------------X..X-----------------------------------------------------------------------------------------------------
-------------------------------------------X.X-----------------------------------------------------------------------------------------------------
-------------------------------------------X.X-----------------------------------------------------------------------------------------------------
-------------------------------------------X.X-----------------------------------------------------------------------------------------------------
-------------------------------------------X.X-----------------------------------------------------------------------------------------------------
-------------------------------------------X.X-----------------------------------------------------------------------------------------------------
-------------------------------------------X.X-----------------------------------------------------------------------------------------------------
--------------------------------------------XX-----------------------------------------------------------------------------------------------------
--------------------------------------------XX-----------------------------------------------------------------------------------------------------
--------------------------------------------XX-----------------------------------------------------------------------------------------------------
--------------------------------------------XX-----------------------------------------------------------------------------------------------------
--------------------------------------------XX-----------------------------------------------------------------------------------------------------
--------------------------------------------X-X----------------------------------------------------------------------------------------------------
--------------------------------------------X-X----------------------------------------------------------------------------------------------------
---------------------------------------------XX----------------------------------------------------------------------------------------------------
---------------------------------------------XX----------------------------------------------------------------------------------------------------
---------------------------------------------XX----------------------------------------------------------------------------------------------------
---------------------------------------------XX----------------------------------------------------------------------------------------------------
---------------------------------------------XX----------------------------------------------------------------------------------------------------
---------------------------------------------XX----------------------------------------------------------------------------------------------------
----------------------------------------------X----------------------------------------------------------------------------------------------------
----------------------------------------------X----------------------------------------------------------------------------------------------------
----------------------------------------------X----------------------------------------------------------------------------------------------------
----------------------------------------------X----------------------------------------------------------------------------------------------------
