----------------XXX--------------------------------------------------------------------------------------------------------------------------------
----------------XEX--------------------------------------------------------------------------------------------------------------------------------
XXXXXXXXXXXXXXX-X.XXXXXXXXXXX----------------------------------------------------------------------------------------------------------------------
XE,...........X-X.,.....,..EX----------------------------------------------------------------------------------------------------------------------
X.XXXXX,XXXXX,X-X.XXXXXXX...XXX--------------------------------------------------------------------------------------------------------------------
X.X---X.X---X.X-X.X-----XE..,.X--------------------------------------------------------------------------------------------------------------------
X.X---X.X---X.X-X.X-----XXXXX.X-----XXXXXXX--------------------------------------------------------------------------------------------------------
X.X---X.X---X.X-X.X---------XAX-----XE.E.AX--------------------------------------------------------------------------------------------------------
X.X-XXX,XXX-X,XXX.X---------X.XXXXX-X.....X-------------------------------------------------XXX----------------------------------------------------
X.X-XA...AX-X...,EX---------X.,E.EX-X....EX-------------------------------------------------XEX----------------------------------------------------
X.X-X.....X-X...XXX---------X.XXXXX-X.....X-------------------------------------------------X.XXX--------------------------------------------------
X.X-X....AX-XE..X-----------X.X-----X....EX-------------------------------------------------X.,.X--------------------------------------------------
X.X-X.....X-XXXXX-----------X,XXXXXXX,XXXXX-------------------------------------------------X.XXX-----XXX------------------------------------------
X.X-XE.E.EX-----------------X.........X-----------------------------------------------------X.X-------XEX------------------------------------------
X.X-XXXXXXX-----------------X,XXXXX,XXX-----------------------------------------------------XAX-------XEX-----------XXXXXXX------------------------
X.X-------------------------X.X---X.X-------------------------------------------------------X.X-------X.X-----------XE...HX------------------------
X.X-----------XXXXXXXXXXXXXXX.X---X.X-------------------------XXX-----------------------XXXXX.XXXXXXXXX,XXX---------X.....X------------------------
X.X-----------XE............,.X---X.X-------------------------XEX-----------------------XE..,.,.........,EX---------X....EX------------------------
X.XXXXXXX-----XXXXX,XXXXXXXXX.X---X.X-------------------------X.X-----------------------X,XXXXX,XXXXXXXXX.X---------XA....X------------------------
XE,...,.X---------X.X-------XEX---X.X-------------------------X.X-----------------------X.X---XEX-------X.X---------X....EX------------------------
XXXXXXX.X-------XXX,XXX-----XXX-XXX.X---XXX-XXXXXXXXXXXXX---XXX,XXXXX-----XXXXX---------X.X---X.X-XXXXXXX,XXXXXXX---X,XXXXX------------------------
------XAX-------X.,..EX---------XE,EX---XEX-X.,.......,EX---XE,...,.X-----XE,WX---------X.X---XEX-XH.......A..,EX---X.X----------------------------
------X.XXXXX---X.XXXXX---------X.XXX---X.X-X.XXXXXXXXX.X---X.XXXXX.X-----X.XXX-----XXXXX.X---X.X-X,XXXXXXXXXXX.X---X.X----------------------------
------X.,.EEX---X.X-------------X.X-----XEX-X.X-------X.X---X.X---X.X-----X.X-------XE..,.X---XEX-X.X---------X.X---X.X----------------------------
------X.XXXXX-XXX,XXXXXXX-XXXXXXX,XXXXXXX.XXX,X-------X.X---X.X---X.X-----X.X-------XXXXX.X---XXX-X.X---------X.X---X.X----------------------------
------X.X-----XE.......HX-XE............,.,..EX-------X.X---X.X---X.X-----X.X-----------X.X-------X.X---------X.X---X.X----------------------------
------X.X-----XXXXXXXXX,X-X,XXXXXXXXXXXXX.XXXXX-------X.X---X.X-XXX,XXXXX-XAX---------XXX,X-------X.X---------X.XXXXX.X----------------------------
------X.X-------------X.X-X.X-----------XAX-----------X.X---X.X-XE...E.EX-X.X---------X..EX-------X.X---------X.,...,.X----------------------------
----XXX,XXXXXXXXX-----X.X-X.X-XXXXXXXXXXX.X-----XXXXXXX,X---X.X-X.......X-X.X---------X...XXXXXXXXX,XXXXXXXXX-X.XXXXX.X----------------------------
----XE........,.X-----X.X-X.X-XE........,.X-----XE,....AX---X.X-X.......X-X.X---------X..H,.......,:,.....,HX-X.X---XEX----------------------------
----XXXXXXXXXXX.X-----X.X-X.X-XXXXX,XXXXXXX-----X.XXXXXXX---X.X-XE.....EX-X,XXXXX-----XXX,XXXXXXXXX,XXXXXXX.X-X.X---XXX----------------------------
--------------X.X-----X.X-X.X-----X.X-----------X.X---------X.X-XA......X-XE..,.X-------X.X-------X.X-----X.X-XEX----------------------------------
--------------X.XXXXXXX,XXX,XXX---X.X-----------X.XXXXXXXXXXX.X-X.......X-XXXXX.XXXXXXX-X.XXXXX---X.X-----X.X-XXX----------------------------------
--------------XH,.....,:,....HX---X.X-----------X.,.........,.X-XE.E...EX-----X.,..E.HX-X.,..EX---X.X-----X.X--------------------------------------
--------------X.XXXXXXX,XXXXXXX---X.X-----------X.XXXXXXXXXXX.X-XXXXX,XXX-----X.XXXXXXX-X.XXXXX---X.X-----X.X---------XXX--------------------------
--------------X.X-----X.X---------X.X-----------X.X---------X.X-----X.X-------X.X-------X.X-------X.X-----X.X---------XEX--------------------------
--------------X.X-----X.X---------X.X-----------X.X---------X.X-----X.XXXXXXX-X.X-------X,XXXXXXXXX,XXXXXXX.XXXXXXX---X.X--------------------------
--------------X.X-----X.X---------X.X-----------X.X---------X.X-----X.....,EX-X.X-------XE...E.....H......,.,E...EX---XHX--------------------------
----XXXXXXXXXXX.X-----X.X---XXX---X.X-------XXXXX,XXXXX-----XAX-----X,XXXXX.X-X.X-XXX---XXXXXXX,XXXXXXXXXXXXXXX,XXX---X.X--------------------------
----XE....E...,.X-----X.X---XEX---X.X-------XE.......EX-----X.X-----X.X---X.X-X.X-XEX---------X.X-------------X.X-----X.X--------------------------
----XXX,XXXXXXXXX-----X,XXXXX,XXXXX.X---XXXXX,XXXXXXXXX-XXXXX.X-----X.X---X,XXX,XXX.X---------X.XXX---------XXX.XXXXXXX.X--------------------------
------X.X-------------X.........,.,EX---XW..,.X---------XE.E,.X-----XEX---X.......,.X---------X.,EX---------XE,.,.....,.X--------------------------
------X.X---XXXXXXXXXXX,XXXXXXXXX.XXX---XXXXX.X---------XXXXX.X-----XXX---XXX,XXXXX.X---------X.XXX---------XXX.XXXXXXX.X--------------------------
------X.X---X.,.......,HX-------X.X---------X.X-------------X.X-------------X.X---X.X---------X.X-------------XEX-----X.X--------------------------
------X.X---X.XXXXXXXXXXX-------X.X---------X.XXXXXXX-------X.XXXXX---------X.X---X.XXXXXXXXXXX.X-------------XXX-----X.X--------------------------
------X.X---X.X-----------------X.X---------X.,E.E.EX-------X.,E.EX---------X.X---X.,.A.......,.X---------------------XEX--------------------------
XXX---X.X---X.X-----------------X.XXXXXXXXXXX.XXXXXXX-------X.XXXXX-----XXXXX.X-XXX,XXXXX,XXXXX.XXXXXXXXXXXXX---------XXX--------------------------
XEX---X.X---X.X-----------------X.,.....,.,.,.X-------------X.X---------XE..,EX-XE.EX---XEX---XE,.......,..EX--------------------------------------
X.XXXXX.X---X.X---------XXXXXXXXX.XXXXXXX.XXXXX-----------XXX.X---------XXX,XXX-XXXXX---XXX---XXXXXXX,XXX...X--------------------------------------
X.,...,.X---X.X---------X.,.....,EX-----X.X---------------XH,.X-----------X.X-----------------------XEX-X...X--------------------------------------
X.XXXXX.X---X.X---------X.XXXXXXXXX---XXX,XXX-------------XXX.X-----------XAX---XXX-----------------X.X-XXX,X--------------------------------------
X.X---X.X---X.X---------X.X-----------XE...EX---------------X.X-----------X.X---XEX-----------------XEX---X.X--------------------------------------
X.X---X.X---X.X---------X.X-------XXXXX.....XXXXXXX---XXXXXXX.X---XXXXXXXXX.X---X.X-----------------XXX---X.X--------------------------------------
X.X---X.X---X.X---------X.X-------X...,..E..,.....X---X.,...,.X---XE......,.X---X.X-----------------------X.X--------------------------------------
X.X---X.X---X.X---------X.X-------X,XXX.....XXXXX,X---X.XXXXX.X---XXXXXXXXXXX---X.X---------------------XXX,XXX------------------------------------
X.X---XEX---X.X---------X.X-------X.X-XE...EX---X.X---X.X---X.X-----------------X.X---------------------XE...EX------------------------------------
X.X---XXX---X.XXXXXXXXXXX.X-------X.X-XXX,XXX---X.X---X.X---X.X-------------XXXXX,XXXXXXXXX-XXX---------X,XXX,X------------------------------------
X.X---------X.,.........,EX-------X.X---X.X-----X.X---X.X---XEX-------------X............EX-XEX---------X.X-X.X------------------------------------
X,XXXXXXXXXXX,XXXXXXXXXXXXX-------X.X---XHX-----X.X---X.X---XXX-------------X,XXXXXXX,XXX,XXX,XXXXXXXXXXX.X-X.X------------------------------------
X............EX-------------------X.X---X.X-----X.X---X.X-------------------X.X-----XAX-XE..............,.X-X.X------------------------------------
XXXXXXXXXXXXXXX-------------------X.X---X.X-----XAX---X.X---------XXXXXXXXXXX.X-----X.X-XXXXXXXXX,XXXXXXX.X-X.X------------------------------------
----------------------------------X.X---XEX-----X.X---X.X---------XE........,EX-----XEX---------XEX-----XAX-X.X------------------------------------
------------------------------XXXXX.X---X.X-----X.X---X.X---------X.XXXXXXXXXXX-----XEX-----XXX-XXX-----X.X-X.X------------------------------------
------------------------------XE..,.X---X.X-----X.X---X.X---------X.X---------------XEX-----XHX---------XEX-X.X------------------------------------
------------------------------X,XXX.XXXXX,XXXXXXX.X---X.XXXXX-----X,XXXXXXXXXXXXX---XEX-----X.X---------XXX-X.X---XXXXXXXXX------------------------
------------------------------X.X-XE,...........,EX---X.,E.EX-----XE..........,.X---XEX-----X.X-------------X.X---XE.A.E.EX------------------------
------------------------------X.X-XXXXXXXXXXX,XXXXX---X.XXXXX-----XXXXXXXXXXXXX.X---XEX---XXX,XXX-----------X,XXXXX.......X------------------------
------------------------------XAX-----------X.X-------X.X---------------------X.X---XHX---XE,..EX-----------X.....,.......X------------------------
------------------------------X.X-----------X.X-------X.X---------------------X.X---XXX---X.XXXXX-XXX-----XXX,XXXXX.......X------------------------
------------------------------X.X-----------X.X-------XEX---------------------X,X---------XAX-----XEX-----XE..X---XE......X------------------------
----------------------------XXX.X---------XXX,XXX-----X.X-------------XXXXXXXXX,XXXXXXXXX-X.X-----X.X---XXX...X---X.......X------------------------
----------------------------XE,EX---------X....HX-----XEX-------------XE....E,,.,.E....EX-X.X-----XEX---X.,..EX---XE.E.E..X------------------------
----------------------------X.XXX---XXXXXXX.....XXXXXXX.X-------------X......,,.,.......X-X,XXXXX-X.X---XAXXXXX---XXXXXXX,X------------------------
----------------------------X.X-----XE.E.E,..E..,.....,.X-------------XH.....,,.,.......X-XE..,EX-XEX---X.X-------------X.X------------------------
----------------------------X.X-----XXXXXXX.....XXXXXXX.X-------------X......,,.,......HX-XXXXX.XXX,XXXXX.X-----------XXX.XXX----------------------
----------------------------X.X-----------X.....X-----X.X-------------X......,,.,.......X-----X.,.......,.X-----------XH...EX----------------------
----------------------------X.X-----------XXXXXXX-----X.X-------------XE.....,,.,......EX-----X.XXXXXXXXX.X-XXX-------XXX.XXX-XXXXXXX--------------
----------------------------X.X-----------------------X.X-------------X,,,,,,,,.,,,,,,,,X-----X.X-------X.X-XHX---------X.X---XE.E.EX--------------
----------------------------X.XXXXXXXXX---------------X.X-------XXXXXXX,,,,,,,,,,,,,,,,,XXXXXXX.X-------X.X-X.XXX-XXXXXXX.X---XXX,XXX--------------
----------------------------XE,...A..EX---------------X.X-------XE...,,.......,H,.......,.....,EX-------XEX-X.,EX-XE....,.X-----X.X----------------
----------------------------XXX.......X---------------X,XXXXXXXXX,XXXXX,,,,,,,,,,,,,,,,,XXXXXXXXX-------XXX-X.XXX-XXX.XXX,XXXXXXX.X----------------
------------------------------X.......X---------------X.....A.....X---X......,,.,.......X-------------------XEX-----X.X-XE......,.X----------------
------------------------------X.......X---------------XXXXXXXXXXXXX---XE.....,,.,......EX---------XXXXXXXXX-X.X-----X.X-XXX,XXXXX.X----------------
------------------------------X......EX--------------------XXXXXXX----X......,,.,.......X---------XE....,.X-X.X-----X.X---X.X---X.X----------------
----------------------XXX-----X.......X----------------XXXX...H...XXXXX......,,.,.......X---------XXXXXXX.X-X,XXXXXXX.X---X.XXX-XAX----------------
----------------------XEX-----XE..E...X---------------X...........,E,.,......,,.,......EX---------------XEX-XE......,.X---X...X-X.X----------------
----------------------X.X-----XXXXXXX,XXXXX----------X..>>>.......XXXXX......,,.,.......X---------XXXXXXX.X-XXX,XXXXX.X---X.XXX-X.XXXXX------------
----------------------X.X-----------XE..,.X----------X..>.>...H...X---XE.,,,E,,.,.E.A..EX---------XE....,.X---X.X---X.X---XEX---X.,..EX------------
------------------XXXXX,XXXXXXX-----XXXXX.XXXXXXX----X..>>>.......X---XXXXXXXXX,XXXXXXXXX---------X,XXXXX,XXXXX.X---XAX---XXX---X.XXXXX------------
------------------X.........,EX---------X.,E.E.HX-----X.........XX------------X.X-----------------X.X---X.....,.X---X.XXX-------XEX----------------
------------------X,XXXXXXXXX.X---XXX---XAXXXXXXX------XXXXXXXXX--------------X.X-------------XXX-X.X---XXX,XXX.X---XE,.X-------XXX----------------
------------------X.X-------X.X---XEX---X.X-----------------------------------X.X-------------XEX-X.X-----X.X-X.X---XXX.X--------------------------
----------------XXX.X---XXXXX.X---X.XXXXX.X-------------------XXX-------------X.X-----------XXX,XXX.X-----X.X-X.X-----X.XXXXXXXXXX-----------------
----------------XE,.X---XE..,.X---X.,...,.X-------------------XHX-------------X.X-----------XE.A..,EX-----X.X-X.XXX---X.,EEEEEEH.X-----------------
----------------XXX.X---XXXXX,XXXXX.XXXXX.X-----XXXXX---------X.X-------XXXXXXX,XXXXXXX-----XXXXX,XXX---XXX,X-X.,EX---X.XXXXXXXXXX-----------------
------------------X.X-------X.....,.X---X.X-----X...X---------XEX-------X.,.E.....E.,.X---------XEX-----XE.EX-X.XXX---X.X--------------------------
------------------X.XXXXX---XXXXXXX.XXX-X,XXXXXXX.E.X---------X.X-------X.XXXXXXXXXXX.X---------X.X-----X...X-XEX-----X.X--------------------------
------------------X.,...X---------X.,EX-X.......,...X---------X.X-------X.X---------X.X---------XEX-----XE.EX-XXX-----X.X--------------------------
------------------XXXXX,X---------XXXXX-XXX,XXXXXXX,X-----XXXXX,XXX-----X.X---------X.X---------X.X-----X,XXX-------XXX.XXXXX-----------XXX--------
----------------------XAX-----------------X.X-----X.X-----XE,....EX-----X.X---------XAX---------X.X-----X.X---------XE.....EX-----------XEX--------
------------------XXXXX.X-----XXX-------XXX.X-----X.X-----X.XXXXXXX-----X.X---------X.X---------XXX-XXXXX.X---------XXXXX,XXX-----------X.X--------
------------------X...,.X-----XEX-------XE,.X-----X.X-----X.X-----------X.X---------X.X-------------XH.E,.X-------------X.X-------------X.X--------
------------------X,XXX.X-XXXXX.XXX-----XXX.X-----X.X-XXXXX.X-----------X.XXXXXXXXXXX.X-----XXX-----XXXXX.XXX-----------XAX-----XXXXXXXXX,XXXXXXX--
------------------X.X-XEX-XE..,E,.X-------XEX-----X.X-XE..,.X-----------X.,E.E...E.E,.X-----XEX---------X.,AX-----------X.X-----XE..,.,..E..,..EX--
------------------X.X-XXX-XXXXX.XXX-XXX---XXX-XXXXX.X-XXXXX.X-----------XXXXXXX,XXXXXXX-----X.X---------X.XXX-----------X.XXX---XXXXX.XXXXX,XXXXX--
------------------X.X---------X.X---XEX-------XH..,.X-----X.X-----------------X.X-----------XEX---------X.X-------------X.,HX-------X.X---X.X------
------------------X.XXXXXXX-XXX,XXXXX.X-------XXXXX.X-----X.X-----------------X.X---XXXXXXXXX.X---XXXXXXX,XXXXXXXXXXX---XXX.X-----XXX.X---XEX------
------------------XE,.....X-X.......,.X-----------X.X-----X.X-----------------X.X---XE......,.X---XE.........E....,EX-----X.X-----XE,.X---X.X------
------------------XXXXXXX,XXX,XXXXXXX.XXXXXXX-----X.XXXXXXX,XXX---------------XAX---X,XXXXXXX.X---X,XXXXXXXXX,XXXXX.X-----X.X-----X.XXX---X.X------
------------------------X...,.X-----X.,.....X-----X.,.......,EX---------------X.X---X.X-----X.X---X.X-------X.X---X.X-----X.X-----X.X-----X.X------
------------------------XXXXX.X-----X.XXXXX,XXXXXXX.XXXXXXXXX.X---------XXXXXXX,XXXXX.X---XXX,XXXXX.X-------X.X---X.XXXXXXX,XXXXXXX.X-----XAX------
----------------------------XEX-----X.X---X.,.....,.X-------X.X---------X.E..E......,.X---XE......,.X-------X.X---XH,.....,:,.....,HX-----X.X------
----------------------------XXX-----X.X---X.XXXXXXX.X-------X.X---------XXXXXXXXXXXXX.X---XXXXXXXXX.X-------X.X---XXXXXXXXX,XXXXXXX,X-XXXXX.XXXXXXX
------------------------------------X.X---X.X-----X.X-------X.X---------------------X.X-----------X.X-------X.X-----------X.X-----XEX-XE.E,.,....EX
------------------XXXXXXX-XXX-XXXXXXX,XXX-X.X-----X.X-------X.X-----XXX-------------X.X-----------XAX-------X.XXXXX-XXXXXXX.X-----XXX-XXXXXXXXXXX,X
------------------XE..,EX-XEX-XH,......EX-X.X-----X.X-------X.X-----XEX-------------XEX-----------X.X-------X.,..EX-XE....,.X-------------------X.X
------------------X,XXX.X-X.X-X.XXXXXXXXX-X.XXX---X.XXXXX---X,XXXXXXX.X-------------XXX-------XXXXX,X-------X.XXXXX-X,XXXXX.X-------------------X.X
------------------X.X-X.X-XAX-X.X---------XE,EX---X.,E.EX---XE......,.X-----------------------XE...EX-------X.X-----X.X---X.X-------------------X.X
------------------X.X-X.X-X.X-X.X-----XXX-XXX.X---X.XXXXX---XXXXXXXXX.X-----------------------X,XXXXX-XXXXXXX,X-----X.X---X,XXXXX-XXXXXXXXXXXXXXX.X
------------------XAX-X.X-X.X-X.X-----XEX---X.X---X.X---------------X.X-----------------------X.X-----XE.....EX-----XAX---XH...EX-XE............,EX
------------------X.X-X.XXX,XXX,XXXXXXX.X---X.X---X.X-----------XXX-X.X---------XXXXXXXXX-----X.X-----X,XXXXXXX-----X.X---XXXXX,XXX,XXXXXXX,XXXXXXX
------------------X.X-XH,.....,:,.....,HX---X.X---XAX-----------XEX-X.X---------XE.E.E.EX-----X.X-----X.X-----------X.X-------X.....X-----XEX------
------------------XEX-XXXXXXXXX,XXXXXXX.X---X.X---X.X-----------X.XXX,XXX-------X.......XXXXXXX.X-----X.X-----------X.XXX-----XXXXXXX-----X.X------
------------------X.X---------X.X-----X.X---X.X---X.X-----------X.,.....X-------X.......,.....,.X-----X.X-----------XE,EX-----------------XEX------
------------------X.X-----XXX-X.X-----X.XXXXX.X---X.XXXXX-XXX---X.XXXXX,X-------XE......XXXXXXX.X-----X.X-----------XXXXX-----------------XXX------
------------------X.X-----XEX-X.X-----X.,...,EX---X.,E.EX-XEX---X.X---XEX-------X......EX-----X.X-----X.X------------------------------------------
------------------X.X-----X.X-X.X-----X.XXXXXXX---X.XXXXX-X,XXXXX,X---X.X---XXX-X....A..X-----X.X-----X.X------------------------------------------
------------------X.X-----X.X-X.X-----X.X---------X.X-----X......EX---XEX---XEX-XE.....EX-----X.X-----X.X------------------------------------------
------------------X,XXXXXXX,XXX,XXXXXXX,X---------X.X-----XXX,XXXXX---X.X---X.X-XXX,XXXXX-XXXXX,XXXXXXX,X------------------------------------------
------------------XE...........H.......EX---------X.X-------X.X-------XEX---XEX---X.X-----XH.E.........EX------------------------------------------
------------------XXXXXXXXXXXXXXXXX,XXXXX---XXXXXXX,XXX-----X.X---XXX-XXX---X.X---X.X-----XXXXXXXXXXXXXXX------------------------------------------
----------------------------------XAX-------XE,......EX-----X.X---XEX-------XEX---X.X--------------------------------------------------------------
----------------------------------X.XXXXXXXXX.XXXXXXXXX-----X,XXXXX.X---XXXXX,XXXXX.X--------------------------------------------------------------
----------------------------------X.,...E...,.X-------------XE....,.X---XE........,.X--------------------------------------------------------------
----------------------------------XXXXXXXXXXX.X-------------XXXXXXX.X---X,XXXXXXXXXXX--------------------------------------------------------------
--------------------------------------------X.X-------------------X.X---X.X------------------------------------------------------------------------
--------------------------------------------X.XXXXXXXXX---------XXX,XXXXX.X------------------------------------------------------------------------
--------------------------------------------X.,......EX---------XE......,.X------------------------------------------------------------------------
--------------------------------------------X.XXXXXXXXX---------XXXXXXXXX.X------------------------------------------------------------------------
--------------------------------------------XEX-------------------------XEX------------------------------------------------------------------------
--------------------------------------------XXX-------------------------XXX------------------------------------------------------------------------
