--------------------------------------XXXXXXXXXXXXXXXXXXXXXXXXX
--------------------------------------XB........B.,.,.,.,.,...X
--------------------------------------X...........,.,.,.,.,.E.X
--------------------------------------X......B....,.,.,.,.,...X
--------------------------------------X...XXXXX,,,XXXXXXXXX...X
------XXXX----------------------------XB..X---XE.EX-------X...X
------X..X----------------------------X...X---X,,,X-------X.B.X
------X..X----------------------------XE..X---X...X-------X.,.X
------X..X----------------------------X.B.X---X,,,X-------X,.,X
------X..X----------------------------X...X---X.E.X-------X,.BX
------X..X----------------------------X..EX---X,,,X-X-----X,.,X
--XXXXX..X----------------------------X...X---X...XXBX----X,.,X
--X..>X..X----------------------------X,HAX---X,,,X...X---X,.BX
--X.XXX..X----------------------------XK.BX--X...,....X---X,.,X
--X.XXX..X-----------XXXXXXXXXXXBXXXXXX,,,XXX...,.....X---B,.,X
--X...X..X--------XXX.......,.,.,.,.,A,.,.,.,..,.:....X---X,.,X
--X...,..X------XX..........H.,.,.,.,.,E,.H.,B,.B.X...X---X,.,X
--X...,..X------X...........,.,.,A,.B.,.,.,.,,...XXE..X---X,.,X
--X...X..X-----X........XXXXXXXXXXXXXXXXXXXXX...X-X...X---X,.,X
--X...X..X-----X......XX-------------------X.,.X--X.E.X---B,.,X
--X,XXX..X----X.....XX--------------------XE..X---X...X---X,.,X
--X,X-X..X----X....X---------------------X...X----X..EX---X,.,X
--X.X-X..X---X....X-----XXXXXXXXXXXXXXBXX:..X-----X...X---X,.,X
--X.X-X..X---X....X----X......,AE......,...X------X...X---X,.,X
XXX.X-X..X--X....X----X.E.,,,,XXX,,,,..W,.X-------X,,,X---X,.,X
X...X--X.X--X....X---X...,..A.X-X....,...,X-------X...X---X,B,X
X.XXX--X.X--X...X---X...,.....XXX...H.,..BX-------X,,,X---X,.,X
X.X--XXXXX--X...X---XE.,...............,..X-------X...X---X,.,X
X.X-X...XX--X,,.X---XB,A..,H,...E.,,,.XXX:X-------X,,,X---X.,.X
XEXX..:<.XXXX..,XXXXXA,...,:,.....,H,BX-XHX-------X...X---X...X
X.XX..<.<,++,.......X,,...,,,.....,,,.XXX,XXXXXXXBX,,,XXXXX..BX
XEXX...<.XXXX.........,.................,...,.,.,.,...,.,E,...X
X.X-X...X---X.........,..E..............,:..,A,.,.,.E.,.,.,.E.X
XEX--XXX----XA........,.................,...,.,.,.,...,.,E,...X
X.X---------XXX.....X,,...,H,.....,,,.XXX,XXXXXXXXB,,,XXXXX,,,X
XEX------------XXLXXXA,B..,E,.....,E,BX-XAXXXXXXXXX...XXXXB..BX
X.X-------------XLX-XB,...,,,...E.,,,HXXX.,......XX,,,XX......X
X.XXXXXXXXXXXXXXXLX-X..,H..............,.HXXXX.E.XXA..XXE.....X
XE.E.......+..LLWLX-X.E.,...H.XXX.....,...X-XX...XX,,,XX......X
XXXXXXXXXXXXXXXXXXXXB,...,....X-X....,...,.XXX.E.XXH.EXXB...B.X
------------------X...,...,,,,XAX,,,,...,.,BXX..HXX,,BXX......X
-----------------X..E..,.....H,.E......,.,E,XX...XXE..XX.E...BX
----------------X......BXXXXXXX+XXXXXXX.,.,,XX.E.XX,,,XX......X
---------------X.E..E..X------X+X------XE,H,BXK.X-X...XX....E.X
--------------X.......X-------XHX-----XB,H.,XX.X-X...X-XE.....X
-------------X.E...BBX--------XXX----XBB...,XXX-X....X-X......X
------------X....E.BXXXXXXXXXXXXXXXXXB,....,XXBX.....XX.......X
-------------X.E...,.E,,,E,,,,E,,E,,E,..E..,,,E.....X-X.E....EX
--------------X..E,.,.........................,.E..X--XW......X
---------------X.,.,,,E,,,E,E,,,E,E,,E,E,,E,,,,.XXX--X.K..E..BX
----------------XXXXXXXXXXXXXXXXXXXXXXXXXXXXXXXX----X.:.B...BAX
----------------------------------------------------XXXXXXXXXXX
