------------------------------------XXX------KXXHX-----
------------------------------------XHX------X.W.X-----
------------------------------------XEX------H.EHX-----
------------------------------------XWX------XX+XX-----
--------------------------------XXXXX,XXXXXXXXX,XXXXXXX
--------------------------------X...,.,...,.........,:X
--------------------------------X.:.,.,...E,,,,,,E,,,.X
-------------------X------------X...,.,.............,HX
------------------XHX-----------X...XXXXXXXXXXXX....,.X
-----------------X...X----------X...X-----------XX..,.X
----------------X.:...X-----XXXXX,,,XXXX----------X.,.X
---------------X......HX--XX,.........,.XX--------X.,.X
XXXXXXXXXXX---X.,.....X-XX...,.......,....X--------X,.X
X...,.....X--X.,.XA..,.X,.E..,.......,....,X-------X,.X
XW..,.E.E.X-X...X-X.X.,..,....XXX,XXXX...,..X------X,.X
X.E.,.....XXA....X-X-X...,..XX--X.X---XX.,E..X-----X,.X
XHE.,.....,,.E..:.X-X,....XX----X.X----XX.....X----X,.X
X...,...E.XX.....X--X.,,.XXX----X.X---X.XX..,,X----X,.X
X.E.,.E...X-X..HX--X....XX..XXXX..HXXX.EX-X,...X---X,.X
XK..,.....X--X.X---X....XX.E,...,,,..,,,HXX....X---X,.X
XXXXXXXXXXX---X---X,...X--X,.,.......,.,X--X....X--X,.X
------------------X.,,.X--X.,.,.....,.,.X--X..,,X--X,.X
------------XXXXXXX...X---X..,,....,.,..X---X,..X-X.,.X
------------XW,...,...X---X....,,,,,,...X---X...X-X.,.X
---------XXXX.,...,...XAXX.,...,,,.,...,HXXXX...XX..,.X
---------XE+,.,...,.E.,....,...,,W,....,.:..,.E.,...,.X
---------XA+,.,..XX...XXXX.,...,.,.,...,.XXXX...,...,.X
---------XE+,.,..XX...X---X...,,,.,.,...X---X...,...,HX
---------XK+,.,.,XX...X---X..,.,...,.,,.X---X,..XXXXXXX
---------XE+,.,.,XX.,,X---X,,.,.....,..,X---X.,,X------
---------X.+,.,.,XX,...X-X.,.,......,.,,X--X....X------
---------XE+,.,.,XX....XX..E,...,,,..,,E.X-X....X------
---------XA+,.,.,X-X....XXX.XXXX...XXXX.X-X,...X-------
---------XE+,.,.,X-X..,,.X-X----X:X----X-X..,,.X-------
---------XXXX.,..X--X,.E..XX----X.X-----X..E..X--------
------------X.,..X---X....,.XX--X.X---XX,....X---------
-----------XX.,...X---X..,....XXX,XXXX...,..X----------
-----------+..,,...X---X.,....,.....,....,.X-----------
-----------+X.,,....X---XX...,.......,....X------------
------------X.,E.....X----XX.,.......,..XX-------------
------------X.,A,.....X-----XXXXX,XXXXXX---------------
------------XE,A,......XX-------X.X-------XXXX---------
------------X.,EA,,,.....XXXXXXXX.XXXXXXXX.H..XXXXXXX--
------------X.,AAAE.,,...,,,,,,,,.,,,,,,,,....LLLLLL>--
------------X..,,,,,,,,,,,,,,,,,,.XXXXXXXX....XXXXXX>--
------------X:.E..................X------X....X--------
------------XXXXXXXXXXXXXXXXXXXXXXX-------X,,,X--------
------------------------------------------X...X--------
------------------------------------------X+++X--------
------------------------------------------X<:<X--------
------------------------------------------X...X--------
------------------------------------------X<W<X--------
------------------------------------------XXXXX--------
