------XXXXXXXXXXXXXXXXXXXXXXXXXXXXXXXXXXXXXXX-XXXXXXXXXXXXXXXXXXXXXXXX-------------
------X.....................................XXX....................:.X-------------
------X.....................................,.,......................X-------------
------X.....................................,.,.XXX..................X-------------
------X...XXXXXX,XXXX,,,,,,,,,,,,,,,,,,,,,,,,,,,X-XXXXXXXXXXXXXXXX...X-------------
------X...XXXX-X.X--X....:..................,.,.XX---------------XHE.X-------------
------X...XXEX-X.X--XH.......XXX............XXX..X---------------XXXXX-------------
-XXXXXX...XX.X-X.X--X........X-XXXXXXXXXXXXXX-XE,X---XXXXXXXXXXXX-XX---------------
-X.<,+,...XXEX-X.X--X........XX---XXXXXXXXXXXX....XXXX..........XXXXXX-------------
-X..XXX...XX.XXX,X--X..E...E..X---XH......,E,,...T,,,,..........XXAHAX-------------
-X.<.XX...XXE.Et.X--X.XXX.XXX.X---X..:....XXXXXXXXXXXX.....XXX..XX...X-------------
-X...,,...XX...XXXXXX,X-X,X-X,XX-XX.......XXXXXXXXXXXX,,,,,X-X..XX.E.X-------------
-X.<:,,...XXE.EX--X...XXX.XXX..XXX,.......,................XXX..XX...X-------------
-X...,,...XXE.EXXXX....,...,......,.......,.................,...,,...X-------------
-X.<.XX...XX...XX......,...,......,.W.K.A.,.................,...,,...X-------------
-X...XX...XXE.EXX......,...,.......,,....,..................,...XX...X-------------
-X,XXXX...XX...XX......,,,,,.........,,,,...................,...XX...X-------------
-X,X--X...XXXXXXX...........................................,...XX...X-------------
-X.X--X...XXXXXXX...XX,,,,,,,,,XX,,,,,,,,,,XX,,,,,,,,,,XX...,...XX...X-------------
XX.X--X...XXEEtXX...XX.........XX,,,,,,,,,,XX,,,,,,,,,,XX...,...XX...X-------------
X..X--X...X-XXXXX...,...........,,,,,,,,,,,,,,,,.......,,...,...XX...X-------------
XXXX--X...X-----X...,...........,,.,,.....,,,,A,.......,,...,...XX...X-------------
------X...X-----XX..,.....,,,.E.,,,.....E.,,,,,,,,,,,,,,,,,,,...XX...X-------------
------X...,XXXXXXX..XX....,H,...,,........,,,..,,,,....,,...,...XX...X--------XXX>>
------X...,..E.:,...XX,,,,,,,...,,...:T...,,,..,,,,....,,E..,...,,...XXXXXXXXXX...X
------X...,....XXX........,.....,,...,K...,,,..,,,,....,,...,.:.,,.H,LLHLLL,++,...X
------X...XXXXXX-X........,.....,,......W.,,,..,,,,....,,...,...XX.,,XXXXXXXXXX...X
------X...X-----XX........,.....,,,.......,,,,A,,,,,,,,,,,,,,...XX...X--------XXXXX
------X...X-----X.........,...E.,,.,,.....,,,,,,.......,,...,...XX...X-------------
------X...X-----X.........,.....,,,,,,,,,,,,,..........,,...,...XX...X-------------
------X.E.X-----X.........,....XX,,,,,,,,,,XX,,,,,,,,,,XX...,...XX...X-------------
------X...X-----X.........,,,,,XX,,,,,,,,,,XX,,,,,,,,,,XX...,...XX...X-------------
------X...XXXXXXX,,,,,,........,,..........,,...............,...XX...X-------------
------X...XX....,,,,,,,........,,..........,,...............,...,,...X-------------
------X....,H...,,,,,,,........,,..........,,...............,...,,...X-------------
------X...XX..E.,,,,,,,........,,..........,,...............,...XX...X-------------
------X...XX....,..,,,,........,,..........,,...............,...XX..EX-------------
------X....,....,..,,,,........,,..........,,..............XXX..XX...X-------------
------X...XX....,,,,,,XXXXXXXXXXX,,,,,,,,,,XXXXXXXXXXXX,,,,X-X..XXE..X-------------
------X...XX...E......XXE......XX.......E..X----------X....XXX..XX...X-------------
------X....,........H.XX..EE.EEXX.HE..K...HX----------X.........XX..EX-------------
------X....,.:....E...XX...E.EEXX..........X---------X.,........XX...X-------------
------X.....,,.XX.XXAXXXE.E....XX....W...E.X--------XE..XXXXXXXXXXE..X-------------
------X.......,XX,XX,XXXXXXE.EEXX.E....E...X-------X...XXXXXXX---X...X-------------
------X.............A.XXXXXE.EEXX....:.....X------X..XXX.E..EX---X..EX-------------
------X...............,..,t....XX..........X-----X,,X-X......tXXXX...X-------------
------X...............XXXXtE.EEX-X,,,,,,,,X----XX...XX..E.E..t,..,E..X-------------
------X..............XX---XXXXXX--X......X-----X,E.XXXXXXXXXXXXXXX...X-------------
------X..:...........XXXXXXXXXXXXXXXXLXXXXXXXX-X,,,X-XXXXXXXXXXXXX...X-------------
------X......................E,XXAXXXLX-XXH.EXXX,..XXXE..............X-------------
------XXX.H..................,.,,.,XXEX-X.......,...,................X-------------
--------X...............XXX.,.....,XX,X-XE......,....,...............X-------------
--------XXXXXXXXXXXXXXXXX-X.,......XX,E-X.....XXXXXXXXXXXXXXXXXXXXXXXX-------------
-------------XX-----------X,.......XX,XXX.....X------------------------------------
-------------XX-----------X........,..........X------------------------------------
-------------XX-----------X.........,.........X------------------------------------
--------XXXXXXXXXXXXXXXXX-X.........,.........X------------------------------------
--------X...............X-X..........,........X------------------------------------
--------X...............X-X....:,....,.....:..X------------------------------------
--------X...............X-X....,,....,........X------------------------------------
--------XtttttttttttttttX-X....,,.....,.......X------------------------------------
--------X.E.............X-X...,..,....,......EX------------------------------------
--------X.........E.....X-X.E.,AE,...:.,......X------------------------------------
--------X.....E.......E.X-XXXXX++XXXXXXXXXXXXXX------------------------------------
--------X.............E.X-----XH:X-------------------------------------------------
--------X...............X-----XWHX-------------------------------------------------
--------XXXXXXXXXXXXXXXXX-----X..X-------------------------------------------------
------------------------------XXXX-------------------------------------------------
