-----------------------------------------------------------XXXX>>XXXXX---------------------------------------
-----------------------------------------------------------X:...E...WX---------------------------------------
-----------------------------------------------------------XXXXX+XXXXX---------------------------------------
-------------------------------------------------------------XXX+XXX-----------------------------------------
--------------------------XXXXXXXXXXXXXXXXXXXXXXXXXXXXXXXXXXXX,,,,,XXXXXXXXXXXXXXXXXXXXXXXXXXXXXXXXXXXX------
--------------------------X...............................,,:.......:,,...............................X------
--------------------------X...............................,,.........,,...............................X------
--------------------------X.............................E.,,.........,,..E............................X------
--------------------------X...............................,,....E....,,...............................X------
--------------------------X...............................,,.........,,...............................X------
--------------------------X...,,,.........................,,.........,,.........................,,,...X------
--------------------------X...,..,,,,,....................,,.........,,.....................,,,,..,...X------
--------------------------X...,.......,,,,..............E.,,.........,,..E.............,,,,,......,...X------
--------------------------X...,...........,,,,,...........,,.E..W..E.,,...........,,,,,...........,...X------
--------------------------X...,................,,,,,......,,.........,,.......,,,,................,...X------
--------------------------X...,.....................,,,,..,,.........,,..,,,,,....................,...X------
--------------------------X...,...................XXXXXXXXXX,,,,,,,,,XXXXXXXXXX...................,...X------
--------------------------X..,....................X--------X.........X--------X....................,..X------
--------------------------X..,....................XXXXXXXXXX,,,,,,,,,XXXXXXXXXX....................,..X------
--------------------------X..,...........................,.X,,,,,,,,,X.,...........................,..X------
--------------------------X..,..........................,.,....E.E....,.,..........................,..X------
--------------------------X..,.........................,.,.E.........E.,.,.........................,..X------
--------------------------X..,........................,.,...XX,,,,,,X...,.,........................,..X------
--------------------------X..,........................,,...XXX,,,,,,XX...,,........................,..X------
--------------------------X..,........................,,..XX..........X..,,........................,..X------
--------------------------X..,........................,,..XX..H.E..H..X..,,........................,..X------
--------------------------X..,........................,,..,,AXXXXXXXXA,..,,........................,..X------
--------------------------X..,........................,,..XX..........X..,,........................,..X------
--------------------------X..,........................,,..XX..E....E..X..,,........................,..X------
--------------------------X..,........................,,...XX,,X,XX,XX...,,........................,..X------
--------------------------X.,.........................,,....X,,X+XX,X....,,.........................,.X------
--------------------------X.,..........................,,...............,,..........................,.X------
--------------------------X.,...........................,,......:......,,...........................,.X------
--------------------------X.,............................,,...........,,............................,.X------
--------------------------X.,.............................,,........:,,.............................,.X------
--------------------------X.,.............................,,:........,,.............................,.X------
--------------------------X.,.............................,,.........,,.............................,.X------
--------------------------X.,.............................,,...:.....,,.............................,.X------
--------------------------X.,.............................,,,,,,,,,,,,,.............................,.X------
--------------------------X.,.............................,,.........,,.............................,.X------
--------------------------X.,.............................,,.........,,.............................,.X------
--------------------------X.,.............................,,.........,,.............................,.X------
--------------------------X.,.............................,,.........,,.............................,.X------
--------------------------X,..............................,,.........,,..............................,X------
--------------------------X,..............................,,.........,,..............................,X------
--------------------------X,..............................,,.........,,..............................,X------
--------------------------X,..............................,,.........,,..............................,X------
--------------------------X,..............................,,.........,,..............................,X------
--------------------------X,..............................,,.........,,..............................,X------
--------------------------X,..............................,,.........,,..............................,X------
--------------------------X,..............................,,.........,,..............................,X------
--------------------------X,..............................,,......:..,,..............................,X------
--------------------------X,..............................,,.........,,..............................,X------
--------------------------X,..............................,,.........,,..............................,X------
--------------------------X,..............................,,.........,,..............................,X------
--------------------------X,..............................,,..XX++X..,,..............................,X------
--------------------------X...............................,,:XXX++XX:,,...............................X------
--------------------------X...............................,,XX..E..XX,,...............................X------
--------------------------X...............................,XX..XXX..XX,...............................X------
--------------------------X...............................,XX.EX-X.E,X,...............................X------
--------------------------X...............................,XX..XXX..XX,...............................X------
--------------------------X...............................,X.,.....,.X,...............................X------
--------------------------XXXXXXXXXXXXXXXXXXXXXXXXXXXXXXXXXX.XX,,,XX.XXXXXXXXXXXXXXXXXXXXXXXXXXXXXXXXXX------
-----------------------------------------------------------X.XX...XX.X---------------------------------------
---------------------------------------------------------XXXEX+E.E,X.XXXX------------------------------------
--------------------------------------------------------XHHA.X+...XX.HHHX------------------------------------
--------------------------------------------------------X....XX,,,XX....X------------------------------------
--------------------------------------------------------XAAA.AX...XXEAAAX------------------------------------
--------------------------------------------------------XXXX,X+.E.,X,XXXX------------------------------------
-----------------------------------------------------------XXX+...XXXX---------------------------------------
--------------------------------------------------------------X,,,X-------XXXXXXXXXXXXX----------------------
--------------------------------------------------------------X...X+------X:.........:X----------------------
--------------------------------------------------------------XE..,+------X....AW.....X----------------------
------------------------------XXXXXXXXXXXXXXXXXXXXXXXXXXXXXXX-X,,,XX------XBB.........X----------------------
------------------------------XA.....BB.B.X.................X-X,,,XXXXXXXXX...:.......XXXXXXXXXXXXXXXXX------
------------------------------XE..........,.................X-X...E..E...,,...........,,.............:X------
------------------------------X...........,E...H............X-X.E.......E,,...........,,..........E...XXXXX--
------------------------------X.........E.,.................X-XE.E..E.E..,,.:.........,,..............,,,AX--
------------------------------XE..........XE.E.........E.E.EX-XXXXXXXXXXXXX.,,,,,.....XXX,XXXXXXXXX...,,,.X--
------------------------------X,,,,,,,XXXXXXXX,,,,,,,XX,,,XXX------------XX.,,,,,.....XXXXXXXXXXX-X:..,,,HX--
--------------------------XXXXX,,,,,,,XXXXXXXX,,,,,,,XX,,,XXX------XXXXX--XH.E..E.X,XX.....E...HX-X...,,,.X--
--------------------------X.................................X------XH.AX--XX,,,,,,XEXX,XXXXXXX,,X-X..E,,,.X--
--------------------------X...........................E.....X------X...XXXXX,,,,,,X,XX,XX----X..X-X...,,,.X--
--------------------------X.................................X------X..EXE.,:....E.,,,...X----X..X-X...,,,.X--
----------------XXXXXXXXXXX..........:......................X-XXXXXX...X,XX,,,,,,,,H,...XXXXXX,,XXX...,,,EX--
----------------X,X,XX,X,XX.................................X-XE..E,...X.XX.......,.,...,+.......,,..E,,,.X--
----------------X,X,XX,XEXX.E.,,,,,,,,,.:...................X-X.XXXX...X+XX.......,.,...,+.......,,...,,,.X--
----------------X.......,XX...,.......,........E........E..EX-X,X--XA...E,,.....:.,.,...,+.E.....,,E..,,,.X--
----------------X.......,XX...,.HH.H..,...XEXXX,XX,,,XXXX...XXX,XXXXXXXXXXX......XX+XX..,+.......,,...,,,.X--
----------------X.......,XX...,.HHH.H.,...XXXXX,XX,,,XXXX...,,,..,,......XX,,,,,,XX.XX..,+.......,,...,,,.X--
----------------X,,,,XX,XXX...,.......,..:XX...........XX...,,,E.,,.......+,.....,.EXX..,+.......,,...,,,.X--
----------------XXXXXXX+X-X...,..HHH..,...,,E........E.,,...,,,..,,......XX,,,,,,XXXXX..,+.......,,.E.,,,.X--
----------------XXXXXXX+X-X.E.,,,,,,,,,..W,,...........,,...XXX,XXXX,XX,,XX......XXXXX..,+.......,,++++,,.X--
--------------XXX.......XXX..............A,,...........,,E..:XX,XXXX,XX,,XX.............,+..E....,,.HH,,,.X--
--------------X.,..E....,.X...............XX....E.....EXX...X-X.XE..E...A,,:XXX...XXX...,+.......,,...,,,.X--
--------------X,,.......,,X...............XXXXXX.,.XXXXXX...X-XEXX.......,,:X-X...X-X...,+.......,,..E,,,EX--
--------------XXX.XXXXXEXXXXXXX,,,,,,,XX,,X-XXXX,,,XXXX-X...X-X.XXX.....E,,.:XX,,,XXX...,+.:.....,,...,,,.X--
-----------XHXXXXEXXXXX.XXXEXHX,,,,,,,XX..X-X.XX...XX.X-X...X-XEXH......H,,:,A,.E.,.,...,+.......,,E..,,,.X--
-----------XHEX.,.,HX.,E,.XX,XX.......XX..X-XE,,...,,EX-X...X-X.XXXXXXXXXXX,,.,...,W,...,+.......,,...,,,.X--
-----------XH.X,,.,,X,,.,,XX,AXE.E.E.EXX.EX-X.,,...,,.X-X...XXX.XXXXXXXXXXX...,.E.,A,...,+.E.....,,..E,,,.X--
-----------XH.XXXEXXXXX.XXXX,XX.......XX..X-X.XX...XX.X-X...,,A.+H....H.,A,.XXB,,,XXX...,+.......,,...,,,.X--
-----------X,.X.,.,.X.,E,.XX,HXH.E.E.EXX..X-XEXX,,,XXEX-X...XXX,XXXXXXXXX.X.X-X..HX-X...,+.......,,..E,,,.X--
-----------X,.X.,.,.X.,.,.XX,HX.......XX..X-X.,,,,,,,.X-X...XXX,XXXXXXXXXXX.XXX...XXX...,+.......,,...,,,.X--
-----------XX,X,,E,,X,,.,,XXXXXE.E.E.EXX..X-X...,,,...X-XE..+,.E.E.E.HHAX-X..E......,...,+W.....H,,E..,,,EX--
------------X.XXX.XXXXX.XXXXX-XXXXXXXXXX..X-X...E..:..X-X..E+,..........X-XXXXX,,,X+XXXXXXXXXXXXXXX...,,,.X--
------------X...,..E.E.E,...X----------XEAX-XE.......EX-X...+,.E.E.E.HHHX---X:X,,,X+X-------------X..E,,,HX--
------------XXXXXXX,,,XXXXXXX----------XXXX-XXXXX+XXXXX-XXXXXXXXXXXXXXXXX--X....,,X.X-------------X...XXX+X--
------------------X...X-------------------------X.X------------------------XE..E,.,.X-------------X,,,X-X.X--
------------------X+++X-XXXXXXXXXXXXXXXXXXXXXXXXX,+XXXXXXXXXXXXXXXXXXXXXXXXXXXXXXXX.X-------------X+++XXX+XXX
------------------X...X-X.................XX..E.X.XXE.AXXE................X-XXXXX-XAX-------------X+++XX....X
------------------X,,,X-X.W....:.:....:...XXXX..,.,,.XXXX.,,,,,,,.,,,,,,,.X-X...XXX,X---XXXXXXXXXXX,,,XX.E.EX
------------------X..EX-X........A..::....X--X..,H,,.X--X.,H..E.,E,..E.H,EX-X.:.,.H.X---X......E......,,E.E.X
------------------X...X-X....:..XXX.......XXXX..,.,,.XXXX.,,,,,.+,+.,,,,,.X-X...XXX,X---X.:..........E,,.E.EX
------------------X...X-X....BB.X-X...:...XX....,.,,..AXX.....,.+H+.,E....X-X.E.X-X.X---X.............,,E...X
------------------X...X-X...XXX.X-X.XXX...XX.XX.,A,,.+XXX.,,,.,.+++.,,,,,.X-X...X-X.X---X...XXXXXXXXXXXX..E.X
------------------X...X-X...X-X.X-X.X-X...XX.+X.,.,,.XXXX.,H,.,....H...E,.X-X...X-XWX---X...X--------XXH.E.EX
------------------X...XXX...X-X.X-X.X-X...XX....,.,,...XX.,.,.,...,,,,,,,.X-X...X-X.X---X...XXXXXXXXXKXXXXXXX
------------------X...,+,...X-X.X-X.X-X.E.XXE...,H,,..EXX.,.,E,...,E......X-X...X-X.X---X...........+.X------
------------------X...,+,...X-X.XXX.X-X...XX....,.,,...XX.,.,,,...,,,,,...XXX...X-X.X---X...........++X------
------------------X...,+,...X-X..W..X-X...XX....,H,,...XX.,E...E.E...E,...+,,...XXX.X---X.............X------
---XXXXXXXXXXXXX--X...XXX...X-X..A..X-X...XX....,+,,...XX.,...,,,,,,,.,...+,,E..,.,EX---X...XXXXXXX...X------
---X.,,,,,,,,,,X--X...X-X...X-XE...EX-X.E.XX....,.,,...XX.,A.W,E...E,.,...+,,...XXX.X---X...X-----X:.EX------
---X.,,E.....,,X--X...X-X...X-X.:::.X-X...XX....,.,,...XX.,...,.,,,,,.,...XXX...X-X.X---X...XXXXXXX...X------
---XE,,......,,X--X...X-X...X-XW...:H-X...XX....,.,,...XX.,...,.,E....,...X-X...X-X.X---X.............X------
---X.,,.,,,..,,X--X...X-X...X-XXX:XXX-X.E.XX....,.,,...XX.,...,.,,,...,...X-X...X-X.X---X.E...........X------
---X.,,.XXX..,,X--X...X-X...X---------X...XX....,.,,...XXE,E.E,.,K,..E,...X-X...X-X.X---X.............X------
---X.,,.XXX..,,X--X...X-X...XXXXXXXXXXX...XX....,.,H...XX.,,,,,.,,,,,,,...X-X...X-X.X---XXXXXXXXXXX,,,X------
---X.,,.+.,E.,,X--X...X-X...............:.XX...HX+XH..AXX.................X-X...X-X.X-------------X,,,X------
---X.,,.+.,..,,X--X...X-XE................XXX,XXX,XXX,XXX.................X-X...X-X.X-XXXXXXXXXXX-XE.EX------
---XE,,.+.,..,,X--X.E.X-X.................X-X,XXXLXXX,X-X................EX-X...X-X.X-X:.....E..:-X...X------
---X.,,.+.,..,XX--X...X-XXX,,,XXXXXXX,,,XXX-XE..,E,..EX-XXX+++XXXXXXX+++XXX-X...X-X.X-X....,,,,AX-XE.EX------
---X.,,.+.,..,X---X...X---X+++X-----X+++X---XXXXX+XXXXX---X,,,X-++X-X,,,X---X..EX-X.X-X....,.,,EX-XHEAX------
---X.,,.+.,..,XXXXX...XXXXX,,,XX++XXX,,,XXXXXXXXX,XXXXXXXXX,,,XXX,XXX,,,XXXXX...X-X.X-X....,.,,.X-XXXXX------
---X.,,.+.,E.,+.,.,...,.....................................................,...XXX.X-X...E,.,,.X------------
---X.,,.+.,..,+.,.,...,.E........:...........E.....:..E.....................,...,.,EX-X....,.,,.X------------
---X.,,.+.,..,+.,.,...,...............E.....................................,...XXX,X-X....,.,,EX------------
---XE,,.+.,..,XXXXX...XXXXX,XXXXXXXXXXXXXXXXXXXXXXXXX,XXXXXXXXXXXXXXXXX,XXXXX...X-X.X-X....,,,,.X------------
---X.,,.+.,..,X---X...X---X.X-----------------------X.X---------------X.X---X...X-X.X-X....E....X------------
---X.,,.+.,E.,XX--X...X---X.X-XXXXXXXXXXXXXXXXXXXXX-X.X-XXXXXXXXXXXXX-X+XXXXX...X-X.X-X,XXXXXXXH:------------
---X.,,.+.,..,,X--X...X---X.X-X...........,W,..E.EX-X.X-XH..........X-X.XH,,X...X-X.X-X.X--------------------
---XT,,.XXX..,,X--X...X---XEX-X...........XXX.....X-X.X-X......E...EXXX...XXXE..X-X.X-X,XXXXXXXXXXX----------
---X.,,.XXX..,,X--X...X---X.X-X...........X-XH.H..X-X.X-X...........XX,....EX...X-X.X-X...........:----------
---X.,,.,,,..,,X--X...X---X.XXX...........X-XH.H..XXX.XXX..........EXXH...XXX...X-X.X-X...,,,,,,,.X----------
---X.,,......,,X--X.E.X---X.,+,.....:.....X-XH.H.E,+L.,,,.:.....:...XXHH..++,...X-XWX-X..E,,,,,,,EX----------
---X.,,.E....,,X--X...X---X.XXX.,+++++++,.X-XH.H..XXX.XXX.,+++++++,.XXXXXXXXX.:.X-X.X-X...,,,,,,,.X----------
---X.,,,,,,,,,,X--X...X---X,X-X,,.......,HX-XHXXXXX-X,X-XE,.......,,X-------X...X-X.X-X...,.....,.X----------
---XXXX,XXXXXXXX--X...X-XXX+XXXXX,,,,,,,XXXXXXXXX-XXX+XXXXX,,,,,,,XXXXXXXXX-X...X-X.X-X...,..:..,.X----------
---++XX.X---------X...X-X...........:...........X-X..E...................EX-X...X-X.X-X...,,,,,,,.X----------
---XE.,.XXXXXXXXX-X...X-X...:...................X-X.......................X-X...X-X.X-X...,,,,,,,.X----------
---X..,A,.....,.X-X...X-X.......................X-X.........W.:.A.........X-X...X-X.X-XE..,,,,,,,EX----------
---XE.XXXXXXXXX.X-X...XXX.,,,.:...........:.,,,.X-X.,,,.:...........:.,,,.XXX...X-X.X-X...,,,,,,,.X----------
---X..X-------X.X-X...,+,.,.,...............,.,.X-X.,.,...............,.,.,+,...X-X.X-X...,,,,,,,.X----------
XXXX,,XXXXXXXXX,X-X...,+,.,.,...............,.,.X-X.,.,...............,.,.,+,...XXX.X-X...,,,,,,,.X----------
XA,...........,.X-X...,+,.,.,.....,,,,,..:..,.,.X-X.,.,...............,.,.,+,...,.,EX-X...,.....,.X----------
X.,...........X.X-X...,+,.,.,....,,,,,,,....,.,.X-X.,.,...............,.,.,+,...XXXXX-X...,..:..,.X----------
X.,..........AX.X-X...,+,.,.,....,,...,,....,.,.X-X.,.,......E.....E..,.,.,+,...X-----X...,,,,,,,EX----------
X.,H..,,,,,...X,X-X...,+,.,.,...,X,<+<+XX...,.,.X-X.,.,.E.............,.,.,+,...X-----X...,,,,,,,.X----------
X.+,,,,:,,:...t.X-X...,+,.,.,...XX.+++.XX...,.,.X-X.,.,....:..........,.,.,+,...X-----X...,,,,,,,.X----------
X.+...,,H,,...t.X-X...XXX.,.,..XX..,,,..XX..,.,.X-X.,.,...............,.,.XXX...XXXXXXX...........X----------
X.,,,,,,,,:...t.X-X...X-X.,.,..XX.......XX..,.,.X-X.,.,...............,.,.X-X...,..++.,...........X----------
X.,...,:,,,...t.X-X...X-X.,.,..XX.......XX..,.,.X-X.,.,...............,.,.X-X...,.E++.,...........X----------
X.,HE........At.X-X...X-X.,.,..XX...A...XX..,.,.X-X.,.,...............,.,.X-X...,..++.,..........EX----------
X.,.....:.....t.X-X...X-X.,.,..XX<.....<XX..,.,.X-X.,.,...............,.,.X-X...XXXXXXX...........X----------
XE,E.........At.X-X..EX-X.,.,..XX,XX,XX,XX..,.,.X-X.,.,...............,.,.X-X...X-----X:..........:----------
X.,tttttttttttt.X-X...X-X.,.,..XXXXX+XXXXX..,.,.X-X.,.,...............,.,.X-X...X-----XXXXXXX,,,XXX----------
X...............X-X...X-X.,.,..++.......++..,.,.X-X.,.,...........:...,.,.X-X...XXXXXX------X...X------------
XXXXX,,,,,,,XXXXX-X...X-X.,.,..XXXX,,,XXXX..,.,.X-X.,.,...............,.,.X-X...XXHHHHXXXXXXX...X------------
----XXXXXXXXX-----X...X-X.,.,.+XX.XX+XX.XX+.,.,.X-X.,.,...............,.,.X-X...XXH.,HX.........X------------
------------------X...X-X.,.,.+XX,X,,,X,XX,.,.,.X-X.,.,......:........,.,.X-X...XXH.,HX.........X------------
------------------X...X-X.,.,.,XX.......XX,.,.,.X-X.,.,...............,.,.X-X...XX,.,HX........EX------------
------------------XE..X-X.,.,.,XX.......XX,.,.,.X-X.,.,...............,.,.X-X...XXH.,HX...XXXXXXX------------
------------------X...X-X.,.,.,XX.......XX,.,.,.X-X.,.,...............,.,.X-X.E.XXH.,HX...X------------------
------------------X...X-X.,.,.,XX..X,XX.XX,.,.,.XXX.,E,...............,.,.X-X...XXH.,HX...X------------------
------------------X...X-X.,.,.,,X..XXXX.XX,.,.,.,+,.,.,...............,.,.X-X...XXX+XXX...X------------------
------------------X...X-X.,.,.,,X..X--X.XX,.,.,.,+,.,.,...............,.,.X-X...X-X+XXX,,,XXXXXXX------------
------------------X...X-X.,.,.,,X..X--X.XX,.,.,.,+,.,.,...............,.,.X-X...X-XE..........,,X------------
------------------X...X-X.,.,.,,X..XXXX.XX,.,.,.,+,.,.,...............,.,.X-X...X-X.........:.,,X------------
------------------X...X-X.,.,.,,X...H...XX,.,.,.,+,.,.,...............,E,.X-X...X-X...........,,X------------
------------------X...X-X.,.,.,XXXXX,XXXXX,.,.,.,+,.,.,...............,.,.X-X...XXX.....,,,...,,X------------
------------------X...X-X.,.,.,X---XXX---X,.,.,.,+,.,.,...............,.,.X-X...,+,.....,HH...,HX------------
------------------X...X-X.,.,.,XX--------X,.,.,.XXX.,E,...............,.,.X-X...XXX.....,HH...,,X------------
------------------X...X-X.,.,.,,,XX-XX-XX,,.,.,.X-X.,.,...............,.,.X-X...X-X.....,HH..E,,X------------
------------------X...X-X.,.,.,,,.,X,XX,.,,.,.,.XXX.,.,...............,.,.X-X.E.X-XXX,,.,HH...,,X------------
------------------X..EX-X.,.,...............,.,.,HX.,.,...............,.,.X-X...X--XH.,.,HH...,.X------------
------------------X...X-X.,.,...............,.,.,HX.,.,...............,.,.X-X...X--XH:,.,,,...,:X------------
------------------X...X-X.,.,...............,.,.,HX.,.,...............,.,.X-X..:X--XH:,..E....,:X------------
------------------X...X-X.,.,...............,.,.,.X.,.,...............,.,.X-X...X--XH:,,,,,...,:X------------
------------------X...X-X.,.,...............,.,.,WX.,.,...............,.,AX-X...X--X,.HH,,,...,.X------------
------------------X...X-X.,.,...............,.,.XXX.,.,...............,.,.X-XE..X--XHXXXXXXX,XXXX------------
------------------X...X-X.,.,...............,.,.X-X.,.,..E...E...E...E,.,.X-X...X----------X+X---------------
------------------X...X-X.,,,...............,,,.X-X.,,,...............,,,AX-X...X-XXXXXXXXXX.XXXX------------
------------------XE..X-X.................:.....X-X.......................X-X..EX-X::::::::..:.::------------
------------------X.:.X-X.......................X-X.......................X-X...X-XHHHHHHHH...HHX------------
------------------X...X-X.......................X-X.......................X-X...X-X:::::::::::::X------------
------------------X+++X-XLLLLLLLLLLLLLLLLLLLLLLLX-X+++++++++++++++++++++++X-X+++X-XXXXXXXXXXXXXXX------------
------------------X...X-X+++++++++++++++++++++++X-X+++++++++++++++++++++++X-XLLLX----------------------------
----------------XXX,,,XXX,,,,,,,,,,,,,,,,,,,,,,,XXX,,,,,,,,,,,,,,,,,,,,,,,XXX,,,XXX--------------------------
----------------XH..............................,.,..............................BX--------------------------
----------------X.....,,,,,,,,,,,,,,,,,,,,,,,,,,XXX,,,,,,,,,,,,,,,,,,,,,,,,,,....BX--------------------------
----------------X.....,.........................X-X.........................,.....X--------------------------
----------------X.....,.........................X-X.........................,.....X--------------------------
----------------X.....,.........................X-X.........................,.....X--------------------------
----------------X.....,.........................X-X.........................,.....X--------------------------
----------------X.....,.........................X-X.........................,.....X--------------------------
----------------X.....,.........................X-X.........................,.....X--------------------------
----------------X.....,.........................X-X.........................,....HX--------------------------
----------------XX,XXXX.........................X-X.........................XXXX,XX--------------------------
--------------XXXX,XXXX.........................X-X.........................X-XX,XXXX------------------------
--------------X..X.XXX,.........................X-X.........................,XXX.XX.X------------------------
--------------XH.X,XX,,.........................X-X.........................,,,X,XXHX------------------------
--------------X.....W,,.........................X-X.........................,,,.L,.:XX-----------------------
--------------X:.....,,.........................X-X.........................,,,.....,X-----------------------
--------------X...:..,,.........................X-X.........................,,,.....,X-----------------------
--------------XW.....,,.........................X-X.........................,,,..E..,X-----------------------
--------------X......,,.........................X-X.........................,,,.....XX-----------------------
--------------X......,,.........................X-X.........................,,,....WX------------------------
--------------X.E...EX,.........................XXX.........................,XXH....X------------------------
--------------XXXX+XXX,.........................+.,.........................,XXX+XXXX------------------------
--------------XXXX,XXXX.........................+.,.........................XXXX,XXXK------------------------
--------------XE......,.........................+.,.........................+H...EX--------------------------
--------------XXXXXXXXX.........................+.,.........................XXXXXXX--------------------------
----------------XXXXXXX.........................+.,.........................XXXXXXX--------------------------
----------------X.....,.........................+.,.........................,H.H.WX--------------------------
----------------X.....,.........................+.,.........................,.....X--------------------------
----------------X.....,.........................XXX.........................,.....X--------------------------
----------------X.....,.........................X-X.........................,.....X--------------------------
----------------X.....,.........................X-X.........................,.....X--------------------------
----------------X.....,.........................X-X.........................,.....X--------------------------
----------------X.....,.........................X-X.........................,.....X--------------------------
----------------X.....,.........................X-X.........................,.....X--------------------------
----------------X.....,.........................X-X.........................,.....X--------------------------
----------------X.....,.........................X-X.........................,.....X--------------------------
----------------X.....,.........................X-X.........................,.....X--------------------------
----------------X.....,.........................X-X.........................,.....X--------------------------
----------------X.....,,,,,,,,,,,,,,,,,,,,,,,,,,X-X,,,,,,,,,,,,,,,,,,,,,,,,,,....AX--------------------------
----------------X...............................X-XA..............................X--------------------------
----------------XXXXXXXXXXXXXXXXXXXXXXXXXXXXXXXXX-XXXXXXXXXXXXXXXXXXXXXXXXXXXXXXXXX--------------------------
