------------------------------------------------------------------------------------------------------------------------------------------------------------------X++++
------------------------------------------------------------------------------------------------------------------------------------------------------------------X...X
----------------------------------------------------------------------------------------------------------------------------XXXXXXXXXXXXXXXXXXXXXXXXXXXXXXXXXXXXXXX,,,X
----------------------------------------------------------------------------------------------------------------------------X.................,...,.H.................X
----------------------------------------------------------------------------------------------------------------------------X.,,,,,,,,,,,,,,,,,...,,,,,,,,,,,,,,,,,...X
----------------------------------------------------------------------------------------------------------------------------X.,...............,...,...............,...X
----------------------------------------------------------------------------------------------------------------------------X.,...............,...,...............,...X
----------------------------------------------------------------------------------------------------------------------------X.,...............,...,...............,...X
----------------------------------------------------------------------------------------------------------------------------X.,...............,...,...............,...X
----------------------------------------------------------------------------------------------------------------------------X.,...............,...,...............,...X
----------------------------------------------------------------------------------------------------------------------------X.,...XXX,,,XXX...,...,...............,...X
----------------------------------------------------------------------------------------------------------------------------X.,...X-X...X-X...,...,...............,...X
----------------------------------------------------------------------------------------------------------------------------X.,...XXX,,,XXX...,...,...............,...X
----------------------------------------------------------------------------------------------------------------------------X.,...,.,.,.,.,...,...,...............,...X
----------------------------------------------------------------------------------------------------------------------------X.,...,.,.A.,.,...,...,...............,...X
----------------------------------------------------------------------------------------------------------------------------X.,...,.,.,.,.,...,...,...............,...X
----------------------------------------------------------------------------------------------------------------------------X.,...,.,A,A,.,...,...,...............,...X
----------------------------------------------------------------------------------------------------------------------------X.,...,.,.,.,.,...,...,...............,...X
----------------------------------------------------------------------------------------------------------------------------X.,...,.,.W.,.,...,...,...............,...X
----------------------------------------------------------------------------------------------------------------------------X.,...,.,.,.,.,...,...,...............,...X
----------------------------------------------------------------------------------------------------------------------------X.,...XXX,,,XXX...,...,,,,,,,,,,,,,,,.,...X
----------------------------------------------------------------------------------------------------------------------------X.,...X-X...X-X...,...,,............,.,...X
----------------------------------------------------------------------------------------------------------------------------X.,...XXX,,,XXX...,...,,............,.,...X
----------------------------------------------------------------------------------------------------------------------------X.,...............,...,,............,.,...X
----------------------------------------------------------------------------------------------------------------------------X.,...............,...,,............,.,...X
----------------------------------------------------------------------------------------------------------------------------X.,...............,...,,............,.,...X
----------------------------------------------------------------------------------------------------------------------------X.,...............,...,,............,.,...X
----------------------------------------------------------------------------------------------------------------------------X.,...............,...,,.....E......,.,...X
----------------------------------------------------------------------------------------------------------------------------X.,...............,...,,............,.,...X
----------------------------------------------------------------------------------------------------------------------------X.,...............,...,,............,.,...X
----------------------------------------------------------------------------------------------------------------------------X.,...............,...,,............,.,...X
----------------------------------------------------------------------------------------------------------------------------X.,...............,...,,............,.,...X
----------------------------------------------------------------------------------------------------------------------------X.,...............,...,,............,.,...X
----------------------------------------------------------------------------------------------------------------------------X.,...............,...,,............,.,...X
----------------------------------------------------------------------------------------------------------------------------X.,...............,...,,,,,,,,,,,,,,,.,...X
----------------------------------------------------------------------------------------XXXX--------------------------------X.,...............,...,...............,...X
--------------------------------------------------------------------------------------XX..:.X-------------------------------X.,...............,...,...............,...X
--------------------------------------------------------------------------------------X..X...X------------------------------X.,...............,...,...............,...X
--------------------------------------------------------------------------------------X,X-XX..X------------XXXXX------------XH,...............,...,...............,...X
--------------------------------------------------------------------------------------XHX---X..X--XXXX----X.....X-----------X.,...............,...,...............,...X
--------------------------------------------------------------------------------------X.X----X..XX....X--X.......X----------X.,...........XXX.,...,.XXX...........,...X
--------------------------------------------------------------------------------------X.X-----X....X...XXX..,,,E.XXXXXXXXXXXX,,...........X-X.,...,.X-X...........,...X
--------------------------------------------------------------------------------------X.X------XXXX-X....,..,.,..,..A..A.,H,,.............XXX.,...,.XHX...........,...X
--------------------------------------------------------------------------------------X+X------------XXXXX..,,,..XXXXXXXXXXXX,,...............,...,.,.,...........,...X
------------------------------------------------------------------------XXX-----------X+X-----------XXX--XE..A...XXXX-------X.,...............,...,.,.,...........,...X
------------------------------------------------------------------------XHX-----------X.X-----------XHX---X.....X-XHX-------X.,...............,...,.,.,...........,...X
------------------------------------------------------------------------X.X-----------XEX-----------X.X----XXXXX--X.X-------X.,...............,...,.,.,...........,...X
------------------------------------------------------------------------X.X-----------X.X-----------X.X-----------X.X-------X.,...............,...,.,.,...........,...X
------------------------------------------------------------------------XAX-----------X.X-----------X.X-----------XEX-------X.,...........XXX.,...,.XXX...........,...X
------------------------------------------------------------------------X.X-----------X.X-----------X.X-----------X.X-------X.,...........X-X.,...,.X-X...........,...X
------------------------------------------------------------------XXXXXXX.XXXXXXXXXXXXX.XXXXXXXXXXXXX.XXXXXXXXXXXXX.XXXXXXXXX.,...........XXX.,...,.XXX...........,...X
------------------------------------------------------------------X...E.........,.............,......E......,.............A.,.,...............,...,...............,...X
------------------------------------------------------------------XXXXXXX.,,,,,,,,,,,,,.,,,,XXXXXXXXX.XXXXXXXXXXXXX.XXXXXXXXX.,...............,...,...XXXXXXXXXXXXX...X
------------------------------------------------------------------------X.,...........,.,...X-------X.X-----------X.X-------X.,...............,...,...XXXXXXXXXXXXX...X
------------------------------------------------------------------------X.,.,,,,,,,,,.,.,.,,XXXXXXX-X.X-XXXXXXXXX-X.X-------X.,...............,...,...XX....A....XX...X
------------------------------------------------------------------------XB,.,.......,.,.,.,.E...H.X-X.X-XB....A.X-X.X-------X.,...............,...,...XX.H....A..XX...X
------------------------------------------------------------------------X.,.,.:..:..,.,.XXX.......X-X.X-X.......X-X.X-------X.,...............,...,...XX.........XX...X
------------------------------------------------------------------------X.,.,.......,.,AX-X..E....X-X.X-X....E..X-X.X-------X.,...............,...,...XX.........XX...X
------------------------------------------------------------------------X,,.,...E...,.,.X-XE....H.X-X,X-X.......X-X.X-------X.,...............,...,...XX..E....:.XX...X
------------------------------------------------------------------------X.,.,.....B.,.,.X-X.......X-X.X-X.......X-X.X-------X.,...............,...,...XX.........XX...X
------------------------------------------------------------------------X.,.,.A.....,.,,X-XA.E....X-X.XXX..W....X-X,X-------X.,...............,...,...XX....E....XX...X
------------------------------------------------------------------------X.,.,.......,.,.X-X.......X-X.,.,.....A.X-X.X-------X.,...............,...,...XX.........XX...X
------------------------------------------------------------------------X.,.,,,,,,,,,.,.X-XXXXXXX+X-X.,.,,XXXXXXX-X.X-------X.,...............,...,...XX......E..XX...X
------------------------------------------------------------------------X.,...........,.X-------X.X-X.,...X-------X.X-------X.,...............,...,...XX..E......XX...X
--------------------------------------------------------XXXXXXXXXXXXXXXXX.,,,,,,,,,,,,,.XXXXXXXXX+XXX.,,,,XXXXXXXXX.XXXXX---X.,...............,...,...XX.........XX...X
------------------------------------------------------XX,.,.,.,E,.,...............,.........,........E........,.........X---X.,...........,,,.,...,...XX.....E...XX...X
----------------------------------------------------XX..,E,.E.,.,.XXXXXXX.,,,,,,,,,,,,,.XXXXXXXXX,,,,.,,,,XXXXXXXXX.XXXXX---X.,...........,.,.,...,...XX.........XX...X
---------------------------------------------------X,.W.,.,.,.,.,X------X.,...........,.X-------X...,.,...X-------X.X-------X.,...........,,,.,...,...XX.A.......XX...X
--------------------------------------------------X.A,..XXXXXXXXX-XXXXX-X.,.,,,,,,,,,.,.X-XXXXXXX,,.,.,.,,XXXXXXX-X.X-------X.,...............,...,...XX.........XX...X
--------------------------------------------------X,.,.X----------X...X-X.,.,.......,.,.X-X...E...,.,.,.,.....A,X-X.X-------X.,...............,...,...XXXXX,,,,,,XX...X
--------------------------------------------------X.,.X---XXXXXXXXX,,,X-X.,.,.E...E.,.,,X-X.E.....XXX.XXX.K.E.,.X-X,X-------X.,...........,,,,,...,,,,XXXXX,,,,,,XX...X
--------------------------------------------------X.H,X--X...E........X-X.,.,.......,.,.X-X....A..X-X.X-X....,..X-X.X-------X.,...........,.,.,...,.,.,.+.+.A..:.XX...X
------XXX-----------XXX-------XXX-----------XXX---X...XXX...........A.X-X,,.,...A...,.,.X-X.......X-X,X-X...,.:.X-X.X-------X.,...........,.,.,...,.A.,.+.+......XX...X
------X.X-----------X.X-------X.X-----------X.X---XH.:,.,.............X-X.,.,.......,.,.X-X.E.E...X-X.X-X..E....X-X.X-------X.,...........,.,.,...,.,.,.+.+......XX...X
------XHXXXXXXXXXXXXX,X-------XAXXXXXXXXXXXXXAX---X...,.,.............X-X.,.,.E...E.,.,.X-X....A..X-X.X-X.E..E..X-X.X-------X.,...........,.,.,...,.,.,.+.+......XX...X
-----X.................X-----X.................X--X...,.,.............X-X.,.,.......,.,AX-X..:....X-X.X-X,......X-X.X-------X.,.......:...,.,.,...,.,.,.+.+......XX...X
----X.E....E...E.....H..X---X...:.A.,,,,,.E.:...X-X.H.,.,...,,,,XXXXXXX-X.,.,,,,,,,,,.,.X-XXXXXXXXX-X.X-XXXXXXX+X-X.X-------X.,...........,.,.,...,.,.,.+.+......XX...X
----X...A.:.......:.....X---X......,.....,......X-XH..,.H...,H..X-------X.,...........,.X-----------X.X-------X.X-X.X-------X.,...........,.,.,...,.,.,.+.+..:...XX...X
----X:..................X---X.E.E.,.,,,,,.,.....X-X...,.,...,.,,XXXXXXXXX.,,,,,,,,,,,,,.XXXXXXXXXXXXX.XXXXXXXXX+XXXBXXXXXXXXX.,...........,,,,,...,,,,XXXXXXX,,,XXX...X
----X...................X---X....,.,.....,.,....X-X...,.,...,.,.L.L..E..........,...........B.,.............,.............A.,.,...............,...,...X-----X+++X-X...X
--XXX..........A........XXXXX...,.,..E....,.,...XXX+++XXX...,.,,XXXXXXXXX.XXXXXXXXXXXXX.XXXXXXXXXXXXXXXXXXXXXXXXXXX.XXXXXXXXX.,...........,,,.,...,...X-----X+++X-X...X
--X.,.E.................,.+.+E..,.,....K..,.,...+.+...X-X...,T..X-------X.X-----------X.X-------------------------X.X......,,.,...........,.,.,...,...X-----X...X-X...X
--XXX...................XXXXX...,.,.......,.,...XXX,,,X-X...,,,,XXXXXXX-X.X-----------X.X-------------------------X.X.H...:,,.,...........,,,.,...,...X-----X...X-X...X
----X................A..X---X....,.,.E...,.,..B.X-X...X-X.............X-X.X-----------XEX-------------------------XEX......,,.,.......:.......,...,...X-----X...X-X...X
----X...A.:.......:.....X---X.E.E.,.,,,,,.,.....X-X...X-X.............X-XAX-----------X.X-----------XXX-----------X.X......,,.,...............,...,...X-----X...X-X...X
----X.......E...........X---X.....A,.....,......X-X...X-X.............X-X.X-----------X.X-----------X.X-----------X.X...E..,,.,...............,...,...X----X...X--X...X
----X..E................X---X...:...,,A,,...:.E.X-X.T.X-X.............X-XXX-------XXXXX+X-----------XHX-----------X.X......,,.,...............,...,...X----X...X--X...X
-----X.................X-----X.................X--X..HX-X..........A..X-----------XH..+.X-----------X.X-----------X.X.:....,,.,...............,...,...X---X...X---X...X
------X,XXXXXXXXXXXW,,X-------XAXXXXXXXXX,H,W,X---X...X-X.E...........XXXXX-------XXXXXXX-----------XHX-----------XAX......,,.,...............,...,...X--X...X----X...X
------X.X---------X...X-------X.X-------X.....X---XH..X-X.............t...X-------------------------X.X-----------X.X,,,,,,,,.,...............,...,...X--X...X----X...X
------X,XXXXXXXXXXX,,,XXXXXXXXX,XXXXXXXXX,,,,,X---X...X-X..........A..t...X-------------------XXXXXXX,XXXXXXXXXXXXX,X,,,,,,,,.,...............,...,...X-X...X-----X...X
------X......................................AX---X..,X--X............t...X-------------------X...............................,...............,...,...X--X...X----X...X
-----X.....................E....,,,,,,,,,,,....X--X.,.X---XXXXXXXXXXXXXXXXX-X-----------X-----X......................H..H..H..,...............,...,...X--X...X----X...X
-----X..................E......,.,.......,.,...X--X,..,X------------------XX.XX-------XX.XX---X..:............................,...............,...,...X---X...X---X...X
----X.........................,...,,,,,,,,..,...X-X..,..XXXXXXXXXX-------X..,..X-----X..E..X--X...,,,,,,,,,,,,,,,,,,,,,,,,,,,,,.....:.:.:.:...,...,...X----X...X--X...X
---X.E.......................,..,,.,....,.,,.,...X-X.,..,.,.,.L.+.XXX--XX..H.,,.XX-XX.......XXX...,...........................................,...,...X----X...X--X...X
--X.....XXXXXXXXXXX.XXX.XXX.,,,,....,,,,,...,,,,,.X-XX..,.,.,HL.+....XX...,.X..,..X....,X.....X...,...........................................,...,...X-----X...X-X...X
-X......X---------X.X-X.X-X.,.,.,,.,.....,.,,.,,,..X--XX,.,.,.L.+........,XX-XX.,,..,,XX-XX...,...,...........................................,...,...X----X...X--X...X
Xtt.....X->XXXXXXXX,XXX,XXX.,.,...,.,,,,,,,.,.,,,...X---XXXXXXXXXX......,X-----X..,,.X-----X..,...,...........................................,...,...X----X...X--X...X
X.t.....X->.....+.L.,.,.,.,.,.,...,.,.....,.,.,,,...X-------------XXX..XX-------XX.XX-------XX,...,...........................................,...,...X---X...X---X...X
X.t.....X->.....+.L.,.,.,.,.,.,...,.,.....,.,.,,,.H.X----------------XX-----------X-----------X...,...........................................,...,...X--X...X----X...X
X.t.....X->.....+.L.,.,.,.,.,.,...,.,.....,.,E,,,...X-----------------------------------------X...,...........................................,...,...X--X...X----X...X
Xtt.....X-XXXXXXXXX,XXX,XXX.,.,...,,,,,,,,,.,.,,,...X---XXXXXXXXXXXXX-------------------------X...,,,,,,,,,,,,,,,,,,,,,,,,,,,,,.....:.:.:.:...,...,...X-X...X-----X...X
-X...A..X---------X.X-X.X-X.,.,.,,..,,,,,,.,,.,,,..X--XX,.,.,.,.t...X-------------------------X...............................,...............,...,...X--X...X----X...X
--X.....XXXXXXXXXXX.XXX.XXX.,,,,..,,....,.,,,,,,,.X-XX.A,.,.E.,.t...X-------------------------X...............................,...............,...,...X--X...X----X...X
---X..A......................,,.,,,,,,,,,,...,...X-X,...,.,.,.,.t...X-------------------------X...............................,...............,...,...X---X...X---X...X
----X........E.................,.,......,,.,,...X-X..,..XXXXXXXXXXXXX-------------------------XXXXXXXXXXX,,,,,,,,,XXXXXXXXX...,...............,...,...X----X...X--X...X
----X...........................,,,,,,,,,,,..E..X-X,.,.X--------------------------------------------XXX-X.........X-------X...,...............,...,...X----X...X--X...X
-----X..................E....H.................X--X.,.X-----------------------------------XXXXXXXXXXX,XXX,,,,,,,,,XXXXXXX-X...,...............,...,...X-----X,,,X-X...X
-----X.........................................X--X..,X-----------------------------------X.............................X-X...,...............,...,...X-----X...X-X...X
------X,XXXXXXXXXXXXX,XXXXXXXXX,XXXXXXXXXXXXX,X---X.B.XXXXXXXXXXX-------------------------X.E...........................X-X...,...............,...,...X-----X,,,X-X...X
------X.X-----------X.X-------X.X-----------X.X---X...,.,.....H.X-------------------------X.............................X-X...,...............,...,...X-----X...X-X...X
------X,XXXXXXXXXXXXX,X-------X,XXXXXXXXXXXXX,X---X...,.,.......X-------------------------X.............................X-X...,...............,...,...X-----X,,,X-X...X
-----X.................X-----X.................X--X...,.,.......X-------------------------X.............................X-X...,...............,...,...X-----X...X-X...X
----X...:...,,,,,...:...X---X...:...,,,,,...:.E.X-X:..,.,....E..X-------------------------X...........,,,,,,,,,.........X-X...,...............,...,...XXXXXXX+++XXX...X
----X......,.....,......X---XE.....,.....,......X-X...,.,.......X-------------------------X...........,.......,.........X-X...,...............,...,...,...........,...X
----X..<..,.......,.<.B.X---X.....,.,,,,,.,.H...X-X...,.,.:.....X-------------------------X..........,.........,........X-X...,...............,...,...,.:...A...E.,...X
----X....,.........,....X---X....,.,.....,.,....X-X...,.,.......X-------------------------X..........,.........,........X-X...,...............,...,...,...........,...X
--XXX...,...........,...XXXXX...,.,...H...,.,...XXX,,,XXXXXXXXXXX-------------------------X.....,,,,,,,,,,,,,,,,,,,,,...X-X...,...............,...,...,......A....,...X
--X.,...,...........,...,.,.+...,.,.......,.,...,.+...X-----------------------------------X.....,...,,.........,,...,...X-X...,...............,...,...,,,,,,,,,,,,,...X
--XXX...,...........,...XXXXX...,.,...W...,.,...XXX,,,X-----------------------------------X.....,...,.,.......,.,...,...X-X...,...............,...,...............,.A.X
----X.:..,.........,....X---X....,.,.....,.,....X-X...X-----------------------------------X.....,...,..,.....,..,...,...X-X...,...............,...,...............,...X
----X.....,.......,...<.X---XE....,.,,,,,.,...A.X-X...X-----------------------------------X.....,...,...,,,,,...,.:.,...X-X...,,,,,,,,,,,,,,,,,...,,,,,,,,,,,,,,,,,...X
----X......,.....,......X---X......,.....,......X-X.:.X-----------------------------------X.....,...,...,.K.,...,...,...X-X...................,...,...................X
----X...<...,,,,,...:...X---X...:...,,,,,...:...X-X...X-----------------------------------X.....,...,...,,,,,...,...,...X-X...................,...,..........H...H.H..X
-----X.................X-----X.................X--X...X-----------------------------------X.....,...,..,...B.,..,...,...X-X...................,...,...................X
------XAXXXXXXXXXXXXX,X-------X,XXXXXXXXXXXXX,X---X...X-----------------------------------X.....,...,.,.......,.,...,...X-XXXXXXXXXXXXXXXXXXXXXXXXXXXXXXXXXXXXXXXXXXXXX
------X.X-----------X.X-------X.X-----------X.X---X...X------------------------------------XX...,...,,.........,,...,...X----------------------------------------------
------XXX-----------X++-------XXX-----------++X---X...X--------------------------------------X..,,,,,,,,,,,,,,,,,,,,,...X----------------------------------------------
--------------------------------------------------X..,X---------------------------------------XX....,...........,.......X----------------------------------------------
--------------------------------------------------X.,.X---------------------------X-----------X-X....,.........,........X----------------------------------------------
--------------------------------------------------X,..,X------------------------XX.XX-------XX.XXXX..,.........,........X----------------------------------------------
--------------------------------------------------X..,..XXXXXXXXXXXXXXXX-------X.,,..X-----X..E..X-X..,,,,,,,,,.........X----------------------------------------------
---------------------------------------------------X.,T.,.,.,.,.,.,...H.XXX--XX,,..,,.XX-XX.......XXXX..................X----------------------------------------------
----------------------------------------------------XX..,.E.,A,.,.,........XX,....X..,..X....,X.....XXX.................X----------------------------------------------
------------------------------------------------------XX,.,.,.,.,.,.............XX-XX.,,..,,XX-XX...+.+.................X----------------------------------------------
--------------------------------------------------------XXXXXXXXXXXXXXXX.......X-----X..,,.X-----X..+.+...........:.....X----------------------------------------------
------------------------------------------------------------------------XXX..XX-------XX.XX-------XX+.+.................X----------------------------------------------
---------------------------------------------------------------------------XX-----------X-----------XXX.................X----------------------------------------------
------------------------------------------------------------------------------------------------------X.....:......:....X----------------------------------------------
------------------------------------------------------------------------------------------------------X.................X----------------------------------------------
------------------------------------------------------------------------------------------------------X.................X----------------------------------------------
------------------------------------------------------------------------------------------------------X,,,,,,,,,,,,,,,,,X----------------------------------------------
------------------------------------------------------------------------------------------------------X.................X----------------------------------------------
------------------------------------------------------------------------------------------------------X,,,,,,,,,,,,,,,,,X----------------------------------------------
-------------------------------------------------------------------------------------------------------X...............X-----------------------------------------------
-------------------------------------------------------------------------------------------------------X..H...:....H..X------------------------------------------------
--------------------------------------------------------------------------------------------------------X.............X------------------------------------------------
---------------------------------------------------------------------------------------------------------X.....E.....X-------------------------------------------------
---------------------------------------------------------------------------------------------------------X..........X--------------------------------------------------
----------------------------------------------------------------------------------------------------------X........X---------------------------------------------------
-----------------------------------------------------------------------------------------------------------X..:...X----------------------------------------------------
-----------------------------------------------------------------------------------------------------------X.....X-----------------------------------------------------
------------------------------------------------------------------------------------------------------------X....X-----------------------------------------------------
-------------------------------------------------------------------------------------------------------------X..X------------------------------------------------------
-------------------------------------------------------------------------------------------------------------X.X-------------------------------------------------------
--------------------------------------------------------------------------------------------------------------X--------------------------------------------------------
