---------------------------------------------------------------XXXXXXXXXXXXXXX------------------------------
---------------------------------------------------------------XH.H.H.H.H.H.HX------------------------------
---------------------------------------------------------------X.............X------------------------------
---------------------------------------------------------------XE.E.E.E.E.E.EX------------------------------
---------------------------------------------------------------X.............X------------------------------
---------------------------------------------------------------X.............X------------------------------
--------------------------------------------------------------XXX,,,,,,,,,,,XXX-----------------------------
--------------------------------------------------------------X:....E........:X-----------------------------
--------------------------------------------------------------X...........E...X-----------------------------
--------------------------------------------------------------X.XXXXXXXXXXXX,,X-----------------------------
--------------------------------------------------------------X.X----------X..X-----------------------------
--------------------------------------------------------------X.X----------X..X-----------------------------
--------------------------------------------------------------XEX----------X..X-----------------------------
--------------------------------------------------------------X.X---X------X.EX-----------------------------
----------------------------------------------------------XXXXX+X--XX------X..X-----------------------------
----------------------------------------------------------XE....X--XX------X..X---------------XXXXXXXXXXX---
----------------------------------------------------------X,XXXXX-X.EX-----X..X---------------X.........X---
----------------------------------------------------------X.X-----X.AXXXXXXX..X--------XXX----X.....ttt.X---
----------------------------------------------------------X.X----X...,........X--------X.X----X.H...t.t.X---
----------------------------------------------------------X.X----X...A,..E....X--------XTX----X.....ttt.X---
----------------------------------------------------------X.X---XAXXX.XXXXXXXXX--------X.X----X.........X---
----------------------------------------------------------X.X---X.X-X.X----------------X.X----XXX,,.....X---
----------------------------------------------------------X.X--X,X---X,X--XXX---XXX----X+XXXXXX-X+,.....X---
----------------------------------------------------------X.X--X.X---X.X--X.X---<.X----X.XXE..X-<.,..H..X---
----------------------------------------------------------X.X--X.X---X<X--XTX---X.X----X<XX..EX-X.X.....X---
----------------------------------------------------------X.X--X.X---XAX--X.X---X.X----X.XX...X-X.XX,,,XX---
----------------------------------------------------------XHX--X.X---X.X--X.X---X.X----X.XXE.EX-X.XX....X---
----------------------------------------------------------X.X--X.X---XAX--X.X---X.X----X.XX.E.X-X.XXE..EX---
----------------------------------------------------------X.X--XEX---X.X--X.X---X.X----X.XXE.EX-X.XX....X---
----------------------------------------------------------XtX--X.X---X.X--XHX---X.X----X.XX...X-X.XX....X---
----------------------------------------------------------X.X--X.X---X.X--X.X---X.X----X.XX..EX-XEXX....X---
----------------------------------------------------------X.X--X.X---X.X--X.X---X.X----XEXX.E.X-X.XXE.E.X---
----------------------------------------------------------X.X--X.X---X.X--X.XXXXX.X----X.XXE.EX-X.XXX:XXX---
----------------------------------------------------------XHX--XTX---X.X--XEXX,XX.X----X.XX...X-X.X---------
------------------------------------------------------XXXXX,X--X.X---X.X--X.A,A++.X----X.XX...X-X.X---------
------------------------------------------------------X...,.X--X.X---X.X--X.XX,XX.X----X.XXE.EX-X.X---------
------------------------------------------------------X.XEXXX--X.X---XEX--X.XXXXX.XXXXXX.XX..EX-X.X---------
------------------------------------------------------X.X------X.X---X.X--XHX---XHXX..XXHXXE..X-XHX---------
------------------------------------------------------X.X------XHX---XHX--X.X---X.XX..XX.XX.E.X-X.X---------
------------------------------------------------------X.X------X.X---X.X--X.X---X.XX..XX.XX,,,X-X.X---------
------------------------------------------------------X.X----XXX,XXXXX,XXXX,XXXXX,XX,,XX,XX,,,XXX,XXXXX-----
------------------------------------------------------X.X----X........E...............................X-----
------------------------------------------------------X.X----X........................................X-----
------------------------------------------------------X,XXXXXX....................................H.ttX-----
------------------------------------------------------X.....XX......................................t.X-----
------------------------------------------------------X.E.E.XX....................................H.ttX-----
------------------------------------------------------X.....XX........................................X-----
------------------------------------------------------X.E.E.,,..,,,,,,,,,,,,......................H.H.H-----
------------------------------------------------------X.....,,..,,,,,,,,,,.,..........................XXXXXX
------------------------------------------------------X.E.E.,,..........E,.,..,,,,,,E,,...............XX...X
------------------------------------------------------X.....,,...........,.,,,,,,,,,,,,...............XX...X
------------------------------------------------------X.E.E.,,..,,,,,,,,,,.....,......................XX...X
------------------------------------------------------X.....,,..,E...........E.,......................+,...X
------------------------------------------------------X.E.E.,,..,,,,,,,,,,,,,,,,..E...................+,...X
------------------------------------------------------X.....,,............,,.E,,......................+,.E.X
------------------------------------------------------X.E.E.,,............,,..,,.......,,,,,,,,,,,....+,...X
------------------------------------------------------X.....,,................,,.......,.,,,,,,,,,....XX.A.X
------------------------------------------------------X.E.E.,,................,,,,,,,,,,.,....E.......XX...X
------------------------------------------------------X.....XX................,,,,,,,,.E.,,,,,........XX...X
--------------------------------------------XXX-------X.E.E.XX.......................,,,,,,,,,........XXXXXX
--------------------------------------------XAX-------X.....XX.......................,,.E...,,+++++++.X-----
--------------------------------------------XEX-------XXXXXXXX..............................,+++++K++.X-----
--------------------------------------------X.X--------------X...............,,,......................X-----
--------------------------------------------XEX--------------X.....,,,,,,.,,,,.,......................X-----
--------------------------------------------X.X--------------X.....,.,t.,.T.,,,,......................X-----
--------------------------------------------XEX--------------X.....,,,t,,.,,,.........................X-----
--------------------------------------------XAX--------------XXXXXXXXXXXXXXXXX,,,,,,,,XXXXXXXXXXXX,,,XX-----
--------------------------------------------XEX------------------------------X........X--------XXX,,,XXX----
--------------------------------------------X.X------------------------------X........X--------X.......X----
--------------------------------------------XEX-----------------------XXXXXXXXXXLLLXXXXXXX-----X...E...X----
--------------------------------------------X,X-----------------------X.XX............XX.X-----X.......X----
------------------------------------------XXX,XXXXXXXXXXXXXXX---------X.XX:...........:X.X-----X.....A.X----
------------------------------------------X.................X---XHXXXEX.XX............XX.X-----X.......X----
------------------------------------------X,,....,,,,,..,.T.X---X..E..,.E,..,,,...,,,.,,EX-----XXXXXXXXX----
------------------------------------------X......,,.....,...X---X,,,,,,.,,..,.,...,.,.,,.X------------------
------------------------------------------X..,,,,,,..,,,,,,,X---X.,...,.XX:.,,,...,,,.:X,X------------------
------------------------------------------X..,,,++,..,,,,,,,X---X.,.E.,.XX............XXEX------------------
------------------------------------------X....,.,,.....,...X---X.,...,,XX:...........:X.X------------------
------------------------------------------X....,.,,,,,..,...X---X.,...,,XX............XX.X------------------
------------------------------------------X.,,,,.,,,,,..,...XXXXXE,:.A,EXX:...........:XXX------------------
------------------------------------------X.......,.....,...,.AXX.,,,,,.XX............X---------------------
------------------------------------------X.......,..,,,,...XXXXX.,,,,,.HX:.,,,...,,,.:---------------------
------------------------------------------X,,,,,,,,.........X---X,,.H.,.EX..,.,...,.,.X---------------------
------------------------------------------X,,,,,,,,......,,.X---X,,,,,,.XX:.,,,...,,,.:---------------------
------------------------------------------X.,,....,,,,,,,,,.X---X.H.E.,.XX............X---------------------
------------------------------------XAXXXXX.,,....,,,,,,,,,.X---XXXXXXXXXX:...........:---------------------
------------------------------------X,HE.,,.,,,,,...........X------------X..,,,,,,,,,.X---------------------
------------------------------------XXXXXXX.,,,,,...........X------------X:.,.......,.:---------------------
------------------------------------XX----X................HX------------X::X,,,,,,X:X:---------------------
------------------------------------XA----XXXXXXXXX,XXXXXXXXX---------------X......X------------------------
------------------------------------XXXXXXXX------X.X-----------------------X.E...EX------------------------
------------------------------------XXX....X------XEX-----------------------X,,,,,,X------------------------
------------------------------------XXXE.EEX------XKX-----------------------X.E...EX------------------------
------------------------------------XXX....XXXXXXXXXX-----------------------X,,,,,,X------------------------
------------------------------------X....A........X-------------------------X.E...EX------------------------
------------------------------------X.............X-------------------------X,,,,,,X------------------------
------------------------------------XXXXXXXXX,XXXAX-------------------------X.E.A.EX------------------------
--------------------------------XXXXXXXXXXXXX,XXX,XXXXXXXXXXX---------------X,,,,,,X------------------------
---------------XXXXXXXXXXXXXXXX-X...........................X---------------X.E...EX------------------------
---------------X.+,...,...E,.EX-X.H.........................X---------------X,,,,,,X------------------------
---------------X:XXXXXX..A.XXXX-X...........................X---------XXXXXXX,,,,,,XXXXXXXX-----------------
---------------X.X----X....XXXXXX...E.......................X---------X.................,,XX----------------
---------------X.X----X.:..XX..L,...........................X---------XE...............E,::X----------------
---------------X.HXXX-X,XX,XX..L,...........................X---------XXX,XXXXXXXXXXXX,XXXXX----------------
---------------X.HXEX-X.XX.XX..L,...........................X-----------X.X----------X.X--------------------
-------------XXX,HX.XXXXXX.XX,,XX...........................X-----------XEX----------XEX--------------------
-------------XE......AXX-X.XX..XX...........................X---------XXX,XXXXXXXXXXXX,XXX------------------
-------------XXXXXXXX,XX-X.XX...X............E..............X---------X,,H,.E........,H,,X------------------
------------------XXX.XX-X..,...X...........................X---------X,,,,........E.,,,,X------------------
------------------XE..X+-XXXX...X......................E....X---------X..................X------------------
------------------XXX,X-----X...X...........................X---------X..................X------------------
------------------XXX,XXXXX-XE..X...........................X---------X..................X------------------
------------------X.......X-X..EX...........................X---------X..E......:........X------------------
--------------XXXXX.,,,...X-X...,...........................X---------X.......A...A....E.X------------------
--------------XE.,L.>.,...XXXXX,,...........................X---------X..................X------------------
--------------XXXXX.>,,...,:................................X---------X.,,,...........,,,X------------------
------------------X.....E.,.................................X---------X.,.,...........,.,X------------------
------------------X......A,.................................X---------X.,,,...........,,,X------------------
---------XXXXXXX--XXXXX,,,,...................XXX,XXXX,XXX,XX---------X..................X------------------
---------X.....XXXXXXXX.......................X-XEX--XEX-XEX----------XXXXXXX,,,,,,,XX+++X------------------
---------X..E.EX......,.......................X-X.X--X.X-X.X---------------X.........X----------------------
---------X.EE..X....E.,.:.....................X-XXX--XXX-XXX-----------XXXXX.........X----------------------
---------X....E,......,.......................XXXXXXXXXXXXXXX----------X...,.E.E...E.X----------------------
---------X.....,...E..,.......................,............AX----------XE.XX....W....X----------------------
---------X.EE.EX......,.......................,.............X----------X..XXXXXXXXXXXX----------------------
---------X.E...X....E.,...,,,,,,,,,...........,...E.......EAX----------XE.X-----------------------XXX-------
---------XXXXEXX......,...,.......,...........,.............X----------X..X-----------------------X.X-------
---------------X....E.,...,,,,,,,,,...........,.A.....E....AX----------XE.X-----------------------X.X-------
---------------X......,.......H...............,.............X---XXXXXXXX..X-----------------------XtX-------
----------XXXX-X,,,,,,,.......................,............AX---X..,..,,E.X-----------------------X.X-------
----------X::X-X......,.......................,...........E.X---XAA,A.,,.AX-----------------------XAX-------
----------X..X-X....E.,.......................,...E........AX---X,XBXBBXBXX-----------------------X.X-------
----------X::X-X......,.......................,.............X---XAXXXXXXXXXXXXXXXXXXXXXXXXXXXXXXXXX,X-------
----------X..X-X...E..,.......................XXXXXXXXXXXXXXX---X.X...XX..E.....,,,,,,,,,,,..XH...E.X-------
----------X::X-X......,.......................X-----------------XAX.EHt,A.......,.,.,,.,,.,E.+..E..TX-------
----------X..X-X...E..,.......................X-----------------XAX.T.XX........,,,,,,,,,,,..X......X-------
XXXXXXXXX-X::XXX......,.......................X-----------------X.XXXXXXXXX,,,XXXXXXXXXXXXXXXXXXX+XXX-------
:.......X-X....,...E..,.............,,,,,,,,,.X------XBBXXXXXXBXX+XBXXXXBBXA..A-----------:.......:X--------
X......EX-X....,......,.............,.......,.X------XB........B.AB.......X..AX-----------X........X--------
X.ttt...X-X....,...A..,.............,,,,,,,,,.X------X..........BB.......BX...X-----------X.ttt....X--------
X.t.t...X-X..XXX......,.................H.....X------X...........B........X,,,X-----------XEt.tH.E.X--------
X.ttt...XXX..X-X......,.......................X------X.............E......XX+XX-----------X.ttt....X--------
X............X-X......,.......................X--XXXXX.......E...........HXX+XX-----------:.......:X--------
X............X-X....E.,.......................X--X...X.H..................X.E.X-----------XXXXXXXXXX--------
:XXXXXXXXXX..X-X......,.......................XXXX.E.,....................,...X-----------------------------
----------X.:X-X....E.,.......................,..X...,....................,.E.X-----------------------------
----------A..A-X......,..:....................,..X.E.,....E......E....E...,...X-----------------------------
----------XXXX-XA.....,.......................,..L...,..........BBB.......,...X-----------------------------
---------------X....A.,....:..................,..L.E.,..........BTB.......,.E.X-----------------------------
---------------X......,.......................,..L...,..........BBB.......,...X-----------------------------
---------------X......,..E..:.................,..X.E.,..E................E,...X-----------------------------
---------------X,,,,,,,.......................,..X...,....................,.E.X-----------------------------
---------------X......,.......................XXXX.E.,...................H,.E.X-----------------------------
---------------X......,...E.:................:X--XX,XX.H...E.....E...E....X...X-----------------------------
---------------X......,...:...................X--XX+XX....................XXXXX-----------------------------
---------------X......,.................XXXXXXX--X...X....................X---------------------------------
---------------X......,.................X--------X.H.X....................X---------------------------------
---------------X......,.................X--------X...XB...,,,,,,,,,,,,...BX---------------------------------
---------------XXXX+XXX.................X--------X...XBB..,,,,,,,,,,,,...BX---------------------------------
-----------------X..X-X.................X--XBBXXBX...XXXXXXXXX,,,,XXXXXXXXX---------------------------------
-----------------X..X-X.................X--XB..,.....X----XX,X,,,,X-----------------------------------------
-----------------X..X-X.................X--X...,.....X----X,,X,,,,XXXX--------------------------------------
-----------------X..X-X.................X--X..E,....EX----X,,.......EX--------------------------------------
-----------------X,.X-X.................X--X...XXXXXXX----X,,.E.E.E..X--------------------------------------
-----------------X,.X-X.................X--X..HX----------X,,........X--------------------------------------
-----------------X.,X-X.................X--X...X----------X,,........X--------------------------------------
-----------------X..X-XXXXXXXXXXXXXXX,XXX--X...X----------X,,........X--------------------------------------
-----------------X..XXXXXXXXXXXXXXXXX+XXX--X...X---XXXXXXXX,,........X--------------------------------------
-----------------X.,.,......+,,,,,......XXBX,,,XXBXX.....XX,,,,,,,,,,X--------------------------------------
-----------------X.,.,E.....AA,,,A......XX.E..:,E.XXE....XXX,XXXXXXXXX--------------------------------------
-----------------X,..,......+,,,,,.....HXB.,...,.BXX,XXX,X-X.X----------------------------------------------
-----------------XXXXXXXX,XXXXXXXXXXXXXXXXXX,,,XXXXX.X-X.X-X.X----------------------------------------------
------------------------X.X----------------X...X---X.X-X.X-X.XXXXXXXXXXXXXXXXX------------------------------
------------------------XEX----------------X...X---X.X-X.XXX+X..XX...........X------------------------------
------------------------X+X----------------X...X---X.X-X.....,E.XX...........X------------------------------
------------------------X+X----------------X...X---XEX-XA....,..XXE.........TX------------------------------
------------------------X.X----------------X...X---X.XXXXX,XXX.HXXX...XXX....X------------------------------
--------------------XXXXX.X----------------X...X---X.,.......XXXXXX,,,XXX....X------------------------------
--------------------W.AA+.X----------------X...X---X.,....E..X.........XX....X------------------------------
--------------------XXXXXHX----------------X...X---XXXXXXXX,,X..E.E.E..XX....X------------------------------
-------------------------------------------X...X----XXXXXXX..X,,,,,,,,.,.....X------------------------------
-------------------------------------------X,,,XXXXXX...E....,......,,.,.....X------------------------------
-------------------------------------------X.......XXE.......,......,,.,.....X------------------------------
-------------------------------------------X.......XX........,......,,EXX....X------------------------------
-------------------------------------------XXXXXX,XXXXXXX,,,,,......,,.XX....X------------------------------
------------------------------------------------X,XXXXXXX,,,,,......,,.XX....X------------------------------
------------------------------------------------X..EXX..,...........,,.XX...EX------------------------------
------------------------------------------------X...XXE,,.....,,,...,,EXX....XXXXXXXXXXXXXXXXXXXXXXXXXXXXXX-
------------------------------------------------X...XX.,,.....+.,...,,.XX....+t.......t.........,t....E...X-
------------------------------------------------X....,.E,.....+,,.E.,,.XX....+t.EE..E.t.E.E.E.E.,t..E...E.X-
------------------------------------------------X....,.,,...........,,.XX....+t.......t.........,t........X-
------------------------------------------------X....,.,,.T.......+++,E,.....XXXXXXXXXXXXXXXXXXXXXXXXXXXXXX-
------------------------------------------------X....,E,,.........+K,,.,.....X------------------------------
------------------------------------------------X....,.,,,,,,,,,,,,,,,.,.....X------------------------------
------------------------------------------------X...XX.,,,,,,,,,,,,,,,.XX....X------------------------------
------------------------------------------------X...XXE..E..E...E...E.TXX....X------------------------------
------------------------------------------------X...XXXX,,,XXXXXXXX,,,XXX....X------------------------------
------------------------------------------------X...XXXX...XXXXXXXX...XXX....X------------------------------
------------------------------------------------X............................X------------------------------
------------------------------------------------X.............E..............X------------------------------
------------------------------------------------X............................X------------------------------
------------------------------------------------XXXXXXXXXXXXXXXXXXXXXXXXXXXXXX------------------------------
