---------XXX---------------------------------------------------------------------------------------------------------------
---------X.X--------------XXX---------------XXX---------------XXX----------------------------------------------------------
---------X.XXXXXXXXXXXXXXXX+XXXXXXXXXXXXXXXXX+XXXXXXXXXXXXXXXXX+XXXXXXXXXXXXXXXXXXXXXXXXX----------------------------------
---------X.XX.......,...,.,.,.,...,...,...,.,.,.,...,...,...,.,.,.,...,...,...,.....,.,.X----------------------------------
---------X.XX+XXXXXXXXXXXXXXXXXXXXXXXXXXXXXXXXXXXXXXXXXXXXXXXXXXXXXXXXXXXXXXXXX+XXXXXXX,X----------------------------------
---------X.XX+X--------XXXXXXXXXXXXXXXXXXXXXXXXXXXXXXXXXXXXXXXXXXXXXXXXX----XXX,XXX---X.X----------------------------------
---------X.XX,XXXXXXXXXX,,,,,,.,.,.,.,.,.,.,.,.,.,.,.,.,.,.,.,.........X---XX.,,,.X---XXXXXXXXXX---------------------------
---------X.XX.,,,.,,,.XX,...,,.,.,.,.,.,.,.,.,.,.,.,.,.,.,.,.,.........XXX-X,.,.,.X---XXX.......XX-------------------------
---------X.XX.,,,.,,,.XX,,,,,,.,.,.,.,.,.,.,.,.,.,.,.,.,.,.,.,..,,,,,,,..X-XX.,,,.X---XXX.........XX-----------------------
---------X.XX.........XX+++XXXXXXXXXXXXXXXXXXXXXXXXXXXXXXXXXXX..,.....,..X--XXX,XXX---X.............XX---------------------
---------X.XX.........XX+++X---------------------------------X..,.,,,.,..X----X.X-----X...............X--------------------
---------X.XX.........XX,,,XXXXXXXXXXXXXXXXXXXXXXXXXXXXXXXXXXX..,.,,,.,..X----X,X-----X................X-------------------
---------X.XX.,,,.,,,.XX...,,.,,,...,,,...,,,...,,,...,,,...XX..,.,,,.,..X--XXX.XXX---X.................X------------------
---------X.XX.,,,.,,,.XX...,,.,.,...,.,...,.,...,.,...,.,...XX..,.....,..X--X.,.,.X---X..................X-----------------
---------X.XX,,,,,,,,,XX...,,.,,,...,,,...,,,...,,,...,,,...XX..,,,,,,,..X--XXX.XXX---X...................X----------------
---------X.XX.......,.XX+++XXXXXXXXXXXX+++XXXXXXXXXXXXXXX+++XX......XX+++X----X,X-----X....................X---------------
---------X.XX.......,,XX,,,X--------XXX,,,XXXXXXXXXXX---X,,,XX......XX,,,XXXXXX.XXXXX-X.............,,,.....X--------------
---------X.XX.........XX...X--------X.,...,.........X---X...XX,,,,,,XX..........,...X-X.........,,,.,,,......X-------------
---------X.XXXXXX,XXXXXX,,,X------XXX.,...,.........XXX-X,,.XX......XX..........,...X-X.........,.,.,,,.......XX-----------
---------X.X----X.X----X,.,X------X<,.,...,.........,.X-X.,,XXXXXXXXXX..........,...X--X........,,,.,,,.........XX---------
XXXXXXXXXX,XXXXXX,XXX--X,,,X------XXX.,...,.........,.X-X...XXXXXXXX-XXXX+XXXXXXXXXXX---X........<..,,,...........XX-------
X........,.,........X--X...X--------X.,...,.........,.X-X.........,.X---X+X----XXXXX----X.......,,,.,,,.............XX-----
X........,.,........X--X,,,X------XXX.,...,.........XXX-X,,........,XXXXX,XXXXXX,,,XX---X.......,.,.,,,...............X----
X........,.,........X--X,.,X------X<,.,...,.........X---X,,,,,,....,XX.,...,.XX.....X---X.......,,,.,,,......<........X----
X........,.,........X--X,,,X------XXX.,...,.....,,,,X---XXXXXXXXX...XX.,,,,,.XX.....XXXXX...,,,.....,,,.......,,,.....X----
X........,.,........X--X...X--------X.,...,.....,..,XXXWAXAAXWXXX...XX,,,:,,,XX,.....,,.....,,.,...........,,,,,,.....X----
X.......,,,,,.......X--X,,,X------XXX.,...,.....,,,,XX,,,,,,,,,XX..,XXXXX+XXXXXX.......,......,,,,,,,......,.,,,,.....XXXXX
XH.....,.....,.....HX--X,.,X--X>--X<,.,...,.......H.XH,.......HXX..,X---XWX----X........,.....,,.,..,......,,,,,,.....,.,.X
X.....,..,,,..,.....XXXX,,,XXXXXXXXXX.,...,.........XX,.,,,,,.,XX.,..XXXXXXXXXXX.........,,.:.,.,,,.,.........,,,.....,.,.X
X.....,.,...,.,.....,.+,..,++,...X--X.,...,.....,,,,XH,.,...,.,,,.,.........,++,...........,,,,.,,,.,.................,.,.X
X.....,.,...,.,.....,.+,..,++,...X--X.,...,.....,..,XX,.,...,.,,,,..........,+,,............,:,.,,,.,.................,.,.X
X.....,.,...,.,.....,.+,...++,...X--X.,...,.....,,,,XH,.,...,.,,,.,.........,+,,...........,,,,.,,,.,.................,.,.X
X.....,..,,,..,.....XXXX,,,XXXXXXXXXX.,...,.......H.XX,.,,,,,.,XX.,..XXXXXXXXXXX.........,,...,.,,,.,.........,,,.....,.,.X
XH.....,.....,.....HX--X,.,X------X<,.,...,.........XH,.......HXX..,X-XXXXXXXX-X........,.....,,.,..,......,,,,,,.....,.,.X
X.......,,,,,.......X--X,,,X------XXX.,...,.....,,,,XX,WA,AA,W,XX..,X-X:,,K,.XXX.......,....,,,,,,,,,......,.,,,,.....XXXXX
X........,.,........X--X...X--------X.,...,.....,..,XXXXXXXXXXXXX...X-X,,,.,.XX,.....,,.....,..,...........,,,,,,.....X----
X........,.,........X--X,,,X------XXX.,...,.....,,,,X---XXXXXXXXX...X-X..,,,.XX.....XXXXX...,,,.....,,,.......,,,.....X----
X........,.,........X--X,.,X------X<,.,...,.........X---X,,,,,,.....X-XW.....XX.....X---X.......,,,.,,,.......<.......X----
X........,.,........X--X,,,X------XXX.,...,.........XXX-X,,........,X-XXXXXX.XXX,,,XX---X.......,.,.,,,...............X----
X........,.,........X--X...X--------X.,...,.........,.X-X..........,X------X.XXXXXXX----X.......,,,.,,,.............XX-----
XXXXXXXXXX,XXXXXXXXXX--X,,,X------XXX.,...,.........,.X-X...XXXXXXXXXXXXXXXX.XX,XXXX----X........<..,,,...........XX-------
---------X.XXXXXXXX,XXXX,.,X------X<,.,...,.........,.X-X.,,XXX-----X........,,.+,HX---X........,,,.,,,.........XX---------
---------X.XX.+,,,,,,,XX,,,X------XXX.,...,.........XXX-X,,.XXXXXXXXX.XXXXXXXXX.XXXX--X.........,.,.,,,.......XX-----------
---------X.XX,XXX.....XX...X--------X.,...,.........X---X...XX,H,:,...XXXXXXX-X.X-----X.........,,,.,,,......X-------------
---------X.XX,X-X.,,,.XX+++X--------XXX+++XXXXXXXXXXX---X+++XX,.,.,.........X-X.X-----X.............,,,.....X--------------
---------X.XX,X-X.,,,.XX,,,XXXXXXXXXXXX,,,XXXXXXXXXXXXXXX,,,XX,.,:,....,,,..XXX.X-----X....................X---------------
---------X.XX,X-X.,,,.XX...,,.,,,...,,,...,,,...,,,...,,,...XX,:,.,.,,,,.,,,XX,.X-----X...................X----------------
---------X.XX,X-X.....XX...,,.,.,...,.,...,.,...,.,...,.,...XX,.,:,.,.,,.,,.XXX.X-----X..................X-----------------
---------X.XX,X-XXXXXXXX...,,.,,,...,,,...,,,...,,,...,,,...XX,.,,,.,,,,.,,,X-X.X-----X.................X------------------
---------X.XX,X---XEX--XXXXXXXXXXXXXXXXXXXXXXXXXXXXXXXXXXXXXXX,........,.,..X-X.X-----X................X-------------------
---------X.XX,X---XXXXX-------XXXXX-------XXXXX-------XXXXX--XXXX...,,,,.,,,X-X.X-----X...............X--------------------
---------X.XX,XXXXX,,,XXXXXXXXX,,,XXXXXXXXX,,,XXXXXXXXX,,,XXXXXXX...,.,,.,,.XXX,XX----X,,...........XX---------------------
---------X.XX.+,...............................................L,...,,,,.,,,XX,,,X----XXX.........XX-----------------------
---------X.XX.XXXXXXXXXXXXXXXXXXXXXXXXXXXXXXXXXXXXXXXXXXXXXXXXXXX......,,,..XX,X,X----XXX.......XX-------------------------
---------X.XX.X-------------------------------------------------X...........XX,,,X----XXXXXXXXXX---------------------------
---------X.XX,X-----------XXX---------------XXX---------------XXXXXXXXXXXXXXXXX,XX----X.X----------------------------------
---------X.XX,XXXXXXXXXXXXX+XXXXXXXXXXXXXXXXX+XXXXXXXXXXXXXXXXX+XXXXXXXXXXXXXXX,XXXXXXX,X----------------------------------
---------X.XX.......,...,.,.,.,...,...,...,.,.,.,...,...,...,.,.,.,...,...,...,.....,.,.X----------------------------------
---------X.XXXXXXXXXXXXXXXXXXXXXXXXXXXXXXXXXXXXXXXXXXXXXXXXXXXXXXXXXXXXXXXXXXXXXXXXXXXXXX----------------------------------
---------X.X---------------------------------------------------------------------------------------------------------------
---------XXX---------------------------------------------------------------------------------------------------------------
