--------------------------------------------------------XXXXX-------------------------------
-------------------------------------------------XXXXBBBX,,,XXXXXAXX------------------------
-------------------------------------------------X.............A.:.X------------------------
-------------------------------------------------X.E.......:....W..X------------------------
-------------------------------------------------X....,,,,........:X------------------------
------------------------------------------------XX,,,,:..,,........X------------------------
------------------------------------------------X,.E...:.,,........XX-----------------------
------------------------------------------------Xttttt,..,,.......:,X-----------------------
------------------------------------------------XX,,,,,,,,,......E.,X-----------------------
-------------------------------------------------X....,,,,.........,X-----------------------
-------------------------------------------------X.E.....:...:.....XX-----------------------
-------------------------------------------------X................BX------------------------
-------------------------------------------------XXXXXXXXXXXXX....BX------------------------
-------------------------------------------------------------A....BX------------------------
-------------------------------------------------XXXXXXXXXXXXX.....X------------------------
-------------------------------------------------X..E,E.E.E,E......X------------------------
----------------------------------------------XXXX...,,....,,......X------------------------
-------------------------------------------XXAH,,,...,,..:.,,.....:X------------------------
------------------------------------------X,...,,,...,,....,,......X------------------------
----------------------------------------XX..,..,,,...,,....,,......XX-----------------------
---------------------------------------XA...,..,,,,,,X,,,,,,X,,,,,,,X-----------------------
--------------------------------------X.....,..,,,,,,XX,,,,XX,,,,E,,X-----------------------
--------------------------:XXXX:X-----X,.....,.,,,...,,....,,......,X-----------------------
--------------------------XA.A.AX----X..,....,.,,,...,,....,,......XX-----------------------
--------------------------X.....X----X...,...,.,,,...,,....,,......X------------------------
--------------------------XA.A.HX---XA....,...,,,,...,,....,:....HHX------------------------
--------------------------X...ttX---X......,..XXXX...,,....,,...:..X------------------------
--------------------------:A.AtTX---X,,.....XX---X.:E,E.E.E,E....HHX------------------------
--------------------------XXXXXXX---X..,...X-----XXXXXXX,,,XXXXXXX,X------------------------
------------------------------------X...,,.X-----------XXXXX-----X,X------------------------
------------------------------------X.....X----------------------X,X------------------------
------------------------------------XXHHHXX----------------------X,X------------------------
----------------------------XXXXXXX:XX,,,X:XXXXXXXXXXXX---------:XH:X-----------------------
-------------------------X:X....,,,,,,,,,,,,E,,,,,,.:..XX-------X...X-----------------------
-----------------------XX.......,,,,,,,,,,,,,,,,,,,......X------XE.EX-----------------------
---------------------XX.........,,,,,,,,,E,,,,,,,,,....E..X-----XE.EX-----------------------
--------------------X...........,,,,,,,,,,,,,,,,,,,.......X-----X...XXXXXXXXXXXXXXXXXXX:XX--
--------------------X.........:.,,E,XX,,,,,,,,XX,,E........X----XE.E,....E.E.E.E,E.EE.E,+.X-
-------------------X...:......XXX,XXXXE,E,EE,EXXXXXX.....T..X---XE..,....AAAAAAAAAAAAAW.XX:-
-------------------X.......XXX--X:X--X........X-----XX......X---X...,....E.E.E.E,E.E.E.EXX:X
--------------:XXXX.:....XX-----X:X--XE.E.EE.EX-------X.....:AAAX...,...,,,,,,,,,,,,,,,,X-AA
--------------X..E,......X------XWX--XH.E.EE.EX-------X.:...,...,...,...,...:...,,......X-AA
--------------XE.,,.....X-------XXX--X........X--------X....,...,..:,...,E....E.E,E.E.EXX-AA
--------------:,.E,.....X------------XH.E.EEAEX--------X,,,,,...X..:X...,..EXXXXXXX,,XXX--AA
--------------XXXXX,,,,,X------------XXXXXXXXXX--------X,,,,,...X,,XX...,E..,...AA,....X--AA
------------------X,,,,,X------------------------------X,,,,,...........,..EX.....,,..EX--AA
-----------------BX,,,,,XXXXXXXXXX---------------------X,,,,,.E.........,E..XE....H,...X--AA
---------------XH.,.....,..E,E.E..HX----------XXXXX----X,,,,,...........,..EXA....A,.:EX--AA
--------------XH..,.....,...,......HX---HXXXXXX,,,HX---X,,,,,........,,B,E..XA..E.XXE..X-X,X
--------------H...,.....,...,E.E.E.EH---XE.E.E,,.,.X---X,,,,,...T....,,,,..EX++,,,XX..:X-XHX
-------------X,,,.,.....,...,........X--Xttt,.,,.,.X---X,,,,,E.......,,,,...,KW,,,,,...XXHX-
-------------X,.,XX.....,...,E..E.E.EX--XE.E,E,,.,.X---X,,,,,.......H,,,,...X+XXXXXXHHBXHX--
------------X.,,,XX.....,...,.........X-Xtttt.,...EX---X,,,,,........,,,,...X,XXXXXXX-------
-------XXXXXX....,,.....,...,E.E.E.E.EX-XE.E..XXXXXX---X:...,........,,,,..ABE.E.E.EX-------
-------X,,,.,....,,.....,...,.........X-X.....X--------X....,..E.......B,...X....:.HX-------
-------X,<,.,....,,.....,...,E.E.E.E.EX-XE....X--------X....:....B......,AAXXE.E.E.EX-------
-------X,,,.:.,,,,,.....,...,....T....X-X.....X--------X,,,,XXXXXXX,,,,XXXXXX:::..ttX-------
-------X....,.,.,,,.....,...,E.E.E.E.EX-X..:..XXXXX----X,,,,X-----X....X----XE:EE.t.X-------
-------XXXXXX,,,,,,.....,...,.........XXX....,XXHAX----XEE.EBXXXX:X....X----XXXXXXXXX-------
----------XXX<...XX.,,,.,..E,E.E.E.E.E,+,.:..E.,EAX----XEE.E,...EAX.E:.X-----HHHHHHHHX------
----------XE,,.T.XX.,H,.,H..,,,.......,+,W...,H,.AX----X....,....AH....X-----H.E,:.EHX------
----------XXX<...,,.....,...,,,E.E.E.E,+,...E,.,EAX----XEE,E,..H.AH...AX-----H.,:,:,HX------
-------XXXXXX,,,,,,.....,...,,,.......XXX....,XX.AX----X,,,,,.:...XAEAXX-----HEA,,A,HX------
-------X.E.E,<,.,,,.....,...,,,E.E.E.EX-X..:..XXXXX----XEE,EBA,,,,XXXXX----XXX,A,KA,XX------
-------X,>,.,,,,,,,.....,...,,,.......X-X.....X--------X,,,,XXX,,,XXXXXXXXXAXX.A..A,.X------
-------X>>,E,,...,,.....,...,,,E.E.E.EX-XE..:.X--------XEE,EX-X..E..E,.E..E.XXEAE.A,EX------
-------X,,,.,....,,...,T,...,,,.......X-X.....XXXXX----X,,,,X-XE....,,......XX.A..A,.X------
-------XXXXXXH...,,...,,,T..,,,E.E.E.EX-XE.E..X,,,XX---XEE,EX-X.....,,.....XXXEAE.A,EX------
------------X.,,,XX.....,.....,.......X-Xttt,.L,,,AX---X,,,,X-XE.E..E,,E..EAXX.A..A,.X------
------------XH,.,.,.....,.....,.E.E.E.X-XE.E,E,,H,.X---XEE,EX-X,,,,,,,.,,,,AXXEAE.A,EX------
-------------XH,W.,.....,.....,......X--X,tt,.,,,,.X---X,,,,X-XE,,,,,T,,,,,HXX.A..A,.X------
-------------X.:.:,.....,.....,E.E.E.X--HE.E.EL.,.AX---XEE.EX-X..E.,E,,E..EAXXEAE.A,EX------
--------------XX.:,.....,.....,.....X---XXXXXXXXXXXX---X....X-XE....,,.....AXX.A..A,.X------
----------------XX,.....,.B..E,E..XX---X:XXX:---------X.EE.EXXX,,...,,...,,,XB.A..A,.X:X----
------------------X,,,,,XXXXXXXXXXXXX--X,.E,.X--------X.....XAH.,,..E,.E.,..,,,AE.A,E..X----
------------------X,,,,,XX--------XEX-XA,...,A------XX......XA,E,AA.A,AAA,.E,,.....,,,.X----
------------------X.......XXXXXXXXXtXXX,.....,XXXXXX..E.E.E.XA,,XXXXEAEXXX,,,,E.E.E,E,EX----
------------------XA:.E....A,,E,,,,,,E....:.E..,,,,,,......XXE.E.AXH..AX-X.,,.,...,,.,.X----
-------------------X....:E.E,,,,,,E,,..........,E,,,,..E.E.XX.....XXE.EXXX.,E,E,A,E.E,EX----
-------------------X.......,,,,,,,,,E..E.......,,,,,,...:.XXX.EE.E+,E.E,,.E,..,AHA...,.X----
-----XXXXX----------XH.E...,,E,,,,,,,....,,,...,,,,,,..E..XX:.....+,...,,..,E.AHHAE.E,EX----
--XAXX,,,XX-----------XXA:.E,,,,,,,,,:.,,,,,,,E,,,,,,B..XX--X.....+,E.E,,.E,..,AAA...,.X----
-X.........X------------XXXXXXXB...XXXXXX,K,XXXXXXXXXXXX----X..E..XX...XXX.,E,E.E.E,E,EX----
-X.........X-------------------X,,,X----X,,,X-----X:X---:X--X.:..BX-XXX--X.,,,....,.,,.X----
XE....T...E.X------------------:HAAX----X,,,X-AAAXX,XXXX,XXXX,,,,.X------X.,E.E.E.E,E,EX----
X...........X------------------X,,,X----X,,,X-AA...E,,,,,,,,,,,,,.X------X.,,,,,,,,,,,.X----
X...B.....:.X---------XXXXXXXXXA,,AXXX--X,,,X-A..H.,,,E,E,E,E,E,E.:X-----X:.E.E.E.E.E.:X----
X...........X---------X.............:X--X,,,X-X....E,,,,,,,ttttt,.X------XXXXXXXXXXXXXXX----
X...........X---------X.....:...,tEt,XAXX+++XXX....,ttEtEtE,E,E,E.X-------------------------
XE.E........X---------X.:.......ttEt,XAE.E.E.E.....E,,,,,,,,,,,,,.X-------------------------
X.........ttXXXXXXXXXXX.........T...:XA.:.....:.E..,,,E,E,EtEtE,E.X-------------------------
XE.E...:..tHt.HE.E.E.E,...........E..XXE.E.E.E.....Etttt,,,,,,,,,.X-------------------------
X......:..ttXXXXXXXXXXX,.:......ttttEXX.....:......,,,E,E,E,E,E,E.X-------------------------
XE.E..A.A.E.X---------X.,...:.....E.:XXE.E.E.E.....E,,,,,,,,,,,,,.:X------------------------
X.:.........X---------X.,,.....:.....XX.........E..,,,E,E,E,E,EtE.X-------------------------
X...........X---------X...,,....,tEtEXHE.:.E.E.....E,,,,ttt,,,,,,.X-------------------------
-X.........X--------XX,....,....tttttXX....:.......,,,E,E,E,E,E,E.X-------------------------
--XXXXXXXXX--------X..,.....,....E.:EXHEHE.E.E.E.E.E,,,,,,,,,,,,,.X-------------------------
-------------------X.E,......,,,:....XXXXXXXXXXXXXX,,,E,E,E,E,E,E.X-------------------------
-------------------X..,.........,,..,X------------X,,,,,,,,,,,,,,.:X------------------------
-------------------X.E,.......E...,,.X-----------XX,,,E,E,E,E,E,E.X-------------------------
--------------------X..,,,,,.....,....X----------:,,,,,,,,,,,,,,,.X-------------------------
--------------------X...,...,,,,,...E.X-----------X,,,E,E,E,E,E,H.X-------------------------
--------------------X:XE,E.E.E,E..E.XX------------X...............X-------------------------
-----------------------XXXXX..,.:.XX--------------XXXX:XXXXXX:XXXXX-------------------------
----------------------------XXXXXX--------------------X------X------------------------------
