-------------------------------------------------------------------------------------->>>------------------------
------------------------------------------------------------------------------------XXX,XXX----------------------
------------------------------------------------------------------------------------X.....X----------------------
----------------------------------------------------------------------------XXXXXXXXX..W..XXXXXXXXX--------------
----------------------------------------------------------------------------X......,,.....,,......X--------------
----------------------------------------------------------------------------X.E.E..,,A.H.A,,..E.E.X--------------
----------------------------------------------------------------------------X......,,.....,,......X--------------
----------------------------------------------------------------------------X.E.E..,,..H..,,..E.E.X--------------
----------------------------------------------------------------------------X......,,.....,,......X--------------
----------------------------------------------------------------------------X.E.E..,,..H..,,..E.E.X--------------
----------------------------------------------------------------------------X......,,.....,,......X--------------
----------------------------------------------------------------------------X.E.E..,,..H..,,..E.E.X--------------
----------------------------------------------------------------------------X......,,.....,,......X--------------
----------------------------------------------------------------------------X.E.E..,,..H..,,..E.E.X--------------
----------------------------------------------------------------------------X......,,.....,,......X--------------
----------------------------------------------------------------------------X.E.E..,,..H..,,..E.E.X--------------
----------------------------------------------------------------------------X......,,.....,,......X--------------
----------------------------------------------------------------------------X.E.E..,,..H..,,..E.E.X--------------
----------------------------------------------------------------------------X......,,.....,,......X--------------
----------------------------------------------------------------------------X.E.E..,,..H..,,..E.E.X--------------
----------------------------------------------------------------------------X......,,.....,,......X--------------
----------------------------------------------------------------------------X.E.E..,,..H..,,..E.E.X--------------
----------------------------------------------------------------------------X......,,.....,,......X--------------
----------------------------------------------------------------------------X.E.E..,,..H..,,..E.E.X--------------
----------------------------------------------------------------------------X......,,.....,,......X--------------
----------------------------------------------------------------------------X.E.E..,,++H++,,..E.E.X--------------
----------------------------------------------------------------------------X......,,.....,,......X--------------
----------------------------------------------------------------------------X.E.E..,,..H..,,..E.E.X--------------
----------------------------------------------------------------------------X......,,.....,,......X--------------
--------------------------------------------------------------XXXXX---XXXXX-X.E.E..,,.,,,.,,..E.E.X--------------
--------------------------------------------------------------X...X---X...X-X......,,.,T,.,,......X--------------
--------------------------------------------------------------X.H.X---X.H.X-XXXXXXXXX.,,,.XXXXXXXXX--------------
--------------------------------------------------------------X...X---X...X---------XE...EX----------------------
--------------------------------------------------------------X.H.XXXXX.H.X---------XXXXXXX----------------------
--------------------------------------------------------------X...........X--------------------------------------
--------------------------------------------------------------X.E.......E.X--------------------------------------
--------------------------------------------------------------X...........X--------------------------------------
------------------------------------------------------------XXX...........X-----XXXXXXXXXXXXXXX------------------
------------------------------------------------------------X.............X-----X:...........:X------------------
------------------------------------------------------------X.......E.....X-----X..E..........X------------------
-------------------------------------------------------------X............X-----XA........E...X------------------
-------------------------------------------------------------X............X-----X.............X------------------
-------------------------------------------------------------X.E........E.X-----X........E....X------------------
-------------------------------------------------------------X............XXXXXXX.............X------------------
--------------------------------------------------------------X.................,.............X------------------
------------------------------------------------------------XXX.................,............AX------------------
------------------------------------------------------------X.......E.........E.,......:......X------------------
------------------------------------------------------------X...................,.............X------------------
-------------------------------------------------------------X..................,......:......X------------------
-------------------------------------------------------------X.E........E.XXXXXXX.............X------------------
-------------------------------------------------------------X............X-----X...:.....:...X------------------
-------------------------------------------------------------X............X-----X....ttttt....X------------------
--------------------------------------------------------------X:.........:X-----X....t...t...EX------------------
------------------------------------------------------------XXX...........X-----X.E..t.:.t....X------------------
------------------------------------------------------------X.....:...:...X-----X....t...t...EX------------------
-----------------------------------------------------------X..............X-----X....ttttt....X------------------
-----------------------------------------------------------X...:.........:X-----X...:.....:...X------------------
----------------------------------------------------------X...............XXXXXXX......:......X------------------
----------------------------------------------------------X.....................,.............X------------------
---------------------------------------------------------X......................,......:......X------------------
---------------------------------------------------------X....................E.,.............X------------------
--------------------------------------------------------X.......................,.............X------------------
--------------------------------------------------------X.......................,............AX------------------
--------------------------------------------------------X.................XXXXXXX.............X------------------
-------------------------------------------------------X..................X-----X........E....X------------------
-------------------------------------------------------X..................X-----X.............X------------------
------------------------------------------------------X...................X-----XA........E...X------------------
------------------------------------------------------X...................X-----X..E..........X------------------
-----------------------------------------------------X....................X-----X:...........:X------------------
-----------------------------------------------------X....................X-----XXXXXX+++XXXXXX------------------
----------------------------------------------------X.....................X----------X+++X-----------------------
----------------------------------------------------X.....................X----------X...X-----------------------
--------------------------------------------------XX......................X----------X.H.X-----------------------
------------------------------------------------XX................XXXXX.H.X----------X...X-----------------------
-------------------------------------------------X................X---X...X----------X.:.X-----------------------
--------------------------------------------------X,,,,,,,,,,,,,,X----X.H.X----------XXXXX-----------------------
-------------------------------------------------X.:..........:.X-----X...X--------------------------------------
------------------------------------------------X..............X------X.H.X--------------------------------------
------------------------------------------------X..............X------X...X--------------------------------------
-----------------------------------------------X...E.......E..X-------X.H.X--------------------------------------
----------------------------------------------X.H............X--------X...X--------------------------------------
---------------------------------------------X.H............X---------XXXXX--------------------------------------
--------------------------------------------X.H............X-----------------------------------------------------
--------------------------------------------X..............X-----------------------------------------------------
-------------------------------------------X............:.X------------------------------------------------------
--X---X---X---X---X-----------------------X.E............XXXXXXXXXXXXXXXXXXXX------------------------------------
-X.X-X.X-X.X-X.X-X.X----------------------X................................X-------------------------------------
X.W.X...X.H.X...X.H.X---------------------X............................E.XX--------------------------------------
X..................X----------------------X.............................X----------------------------------------
XW..............E.X-----------------------X............................,X----------------------------------------
X........E...E....:X---------------------X......................XXXXXXXHX----------------------------------------
XX..................XXXXXXXXXXXXXXXXXXXXX.......................X-----X.X----------------------------------------
--XX................,.,.,.,.,.,.,.+...,.+.......................X-----XHX----------------------------------------
----X<.W.H.E..A.H.H.,H,H,H,H,H,H,H+H.H,.+.......................XXXXXXX.XXX--------------------------------------
--XX................,.,.,.,.,.,.,.+...,.+.......................XXE,,H+H,EX--------------------------------------
XX..................XXXXXXXXXXXXXXXXXXXXXXXXXXX...............:.XXXXX.XXXXX--------------------------------------
X........E...E....:X--------------------------X...............XX----XHX------------------------------------------
XA..............E.X---------------------------X:.............XXXXXXXX,X:X----------------------------------------
X..................X--------------------------X.............,.,..E...E..X----------------------------------------
X.A.X...X.H.X...X.H.X-----------------------XXX............,.,.E...E...EX----------------------------------------
-X.X-X.X-X.X-X.X-X.X------------------------X............,,,,....E...E.,X----------------------------------------
--X---X---X---X---X-------------------------X:..........,.,..E.E...E...EX----------------------------------------
--------------------------------------------X..........,.,.E.....E...E.:X----------------------------------------
------------------------------------------XXX........:XXXXXXXXXXX,,,XXXXX----------------------------------------
------------------------------------------X..........X----------X...X--------------------------------------------
------------------------------------------X:........X-----------X...X-------X------------------------------------
------------------------------------------X.......XX------------X...X-------XXX----------------------------------
----------------------------------------XXX.....HX--------------X...X-------X:.XX--------------------------------
----------------------------------------X:.....HX---------------X...X-------X....XX------------------------------
----------------------------------------X.....HX----------------X...X-------X......XXXXXXXXXXXXXXXXXXXX----------
----------------------------------------X.....X-----------------X...X-------X.......,,.,,.E..........:X----------
----------------------------------------X.E..X------------------X...X-------X.........,,.,,.E.E.E.....X----------
----------------------------------------X..XX-------------------X...X-------X...........,,.,.......A.HX----------
----------------------------------------X:X---------------------X...XXXXXXXXX.............,,,,....E...XXXXXXXXXXX
----------------------------------------XX----------------------X...........+...............,,,,......++...:,...X
----------------------------------------X-----------------------X...........+.H.H.H.H.H.H.H.:.,.,...W.++.H..,.E.X
----------------------------------------------------------------X...........+...............,,,,......++...:,...X
----------------------------------------------------------------XXXXXXXXXXXXX.............,,,,.:..E...XXXXXXXXXXX
----------------------------------------------------------------------------X...........,,.,.......A.HX----------
----------------------------------------------------------------------------X.........,,.,,.E.E.E.....X----------
----------------------------------------------------------------------------X.......,,.,,.E..........:X----------
----------------------------------------------------------------------------X......XXXXXXXXXXXXXXXXXXXX----------
----------------------------------------------------------------------------X....XX------------------------------
----------------------------------------------------------------------------X:.XX--------------------------------
----------------------------------------------------------------------------XXX----------------------------------
----------------------------------------------------------------------------X------------------------------------
