------X--------------------
------XX-------------------
-----X..XX-----------------
-----X.<..X----------------
----X......X---------------
----X.......XX-------------
---X...W......X------------
---X...........X-----------
---X............X----------
--X......E.......XX--------
--X..........E.....X-------
-X..................X------
-X.....E...E.E..E....XX----
X......................X---
X..................E....X--
X.........HH.HHHH.E.....X--
X.......E...............X--
X..........E.E.E.........X-
X...............E........X-
X.....E...E..E...........X-
X.......E................X-
X............W...........X-
X........................X-
X.........................X
X.........................X
X.........................X
X.........................X
X........................X-
X........................X-
X........................X-
X........................X-
X.......................X--
X.................XXXX>>X--
XXXXXXX..........X---------
------X..........X---------
------X.........X----------
------X........X-----------
------X.......X------------
------X.E.....X------------
------X......X-------------
------X..E..X--------------
------X....X---------------
------X.E..X---------------
------X...X----------------
------X..X-----------------
------X.X------------------
------X.X------------------
------XX-------------------
------X--------------------
