-------------------------------------------------------XXXXXXXXXXXXXXXXXX-----------------------
-------------------------------------------------------X,..,..........,.X-----------------------
-------------------------------------------------------X,..,..........,.X-----------------------
----------------------------------------------XXXXXXXXXX,..XXXXXXXXX..,.X-----------------------
----------------------------------------------X,,,,,,,,,,..XXXX-XXXX..,,XXXXXXXXXXXXXXXXXXXXXXXX
----------------------------------------------X,...........XX.X-X.XX........,T................,X
------------------------XXXXXXXXXXXXXXXXXXXXXXX,...........XXtXXXtXX........,........E.....:..,X
------------------------X......................,...XXXXXXXXXX.....XXXXXXXXXXX.................,X
------------------------X......................,.XXXXXXXXXXXX.....XXXXXXXX--X.:...............,X
------------------------X..,,,,,,,,,,,,,,,,,,,,,,XXXX...............E....X--X.................,X
------------------------X..,....................XXX.......,,,...,,,......XXXX...........:.:...,X
------------------------X..,..<.................XXX.......,,,...,,,.....:..XX...........::::..,X
------------------------X..,....................XX........,.,,,,,,,........XX............::...,X
------------------------X..,....................,,........,.,,.,,,,........,,........:........,X
------------------------X..,....................,,........,.,,,,,,,........,,.................,X
------------------------X..,....................,,........,,,...,,,......E.,,.....E...........,X
------------------------X..,....................,,.........................,,...............:.,X
------------------------X..,....................XX................E...E....XX.................,X
------------------------X..,....................XXX,,,,......XXX...........XX..........E......,X
------------------------X..,....................XXX,,,,......X-X...........XX.:...:...........,X
------------------------X..,...............,,,,,,XXXXXXX,,,,,XXX.E.,,,.....XX...............E.,X
------------------------X..,...............,,,...,+,.........,.,...,.,.....XX..........:......,X
------------------------X..,...............,,,...,+,.........,.,,,,,,,,,,..XX.................,X
------------------------X..,...............,,,...,+,.........,.,,,,...,.,..,,....E....:.......,X
------------------------X..,...............XXXXXXXXXXXXXX....,.,,,,...,,,..,,.............E...,X
------------------------X..,...............XXXXXXXXXXXXXX....,.,,,,...,.,..,,.................,X
------------------------X..,...............,,.,,,.,,,,.,,....,.,,,,,,,,,,..XX...E......E......,X
------------------------X..,...............XX.,,,.,,,,.,,....,.,...,,,.....XX.................,X
------------------------X..,.....,,,,,,,,,,XXTX:AXXAXXXXXX,,,XXX.E.,,,.E...XX.:...............,X
------------------------X..,.....,........WXX..H.AAAA,...+...X-X...........XXXXXX.............,X
------------------------XXXXXX,,,,+++++++XXXXXX:AXAXAX,,,X...XXXXXXXXXXXXX,XXXXXX.........:...,X
-----------------------------X,,,,,,,,,,,XXXXX,,,,:.XXXXXX...X.H...............XX.:...........,X
-----------------------------X......E....,,,XX,,,,..XHHHHX...X.H.:.............XX.............,X
-----------------------------X:..........,,.,.......XHHHH+...X.H...............XX.............,X
-----------------------------X...........,,,XXXXXXX.XXXXXX...X,,,,,,,,,,,......,,.............,X
-----------------------------X.............B:HAAH:X......,...X..........,......,,.............,X
-----------------------------X......E.E....BXAHA.HX.XXXXXX,,,X,,,,,,,,,,,......,,.............,X
-----------------------------X.............BXHAH.AX.XXX--X...X.................,,.............,X
-----------------------------X..............XXXX++X+XWX--X...X.................XX.............,X
-----------------------------X..............XX,,..+.X.X--X...................,,XX..........:..,X
-----------------------------X......E...E.E.XX,,..X.X.X--X...................,.XX.:...........,X
-----------------------------X..............XX,,,,X.+.X--X...................,.XX,,...,,,,,,,,,X
------XXXXXXXXXXXXX----------X..............XXXXXXX,X,X--X........,,,,,,,,,..,,XX.,...,......,,X
------X...........X----------X........E.....X:,,,,..X.X--X....,...,,,,,,,,,....XX.,...,......,,X
------X...........X----------X..............X,,,,,..X.XXXX..,,,,..,,,,,,,,,....,,.,...,......,,X
------X...........X----------X..............X.......X.,..+.,,,.,,.......,,,....,,.,...,......,,X
------X....,,,....X----------X......E.....E.X.....,,XXX..+..,,.,...,,,,.,,,....,,.,...,......,,X
------X..,H.A.,...X----------X..........E...X.....,.X-X..+...,,....,..,.,,,....,,.,...,......,,X
------X..,A...H...XXXXXXXXXXXX.......E......X.....,,X-XXXX.........,,,..,,,....XX.,...,......,,X
------X.,..H.A.,..,,,,,,,,,,,X..............,:,,,,,:XXXXXX.....................XX.,:..,......,,X
------X.,AHA..A,..,,,,,,,,,,,+.T............X+XXXXXXXX...+.....................XX.,...,......,,X
------X.,A.H.AA,..,,,,,,,,,,XX......E.E.....X+XXXXXXXX...+.....................XXT,...,......,,X
------X.,H....H,..XXXXXXXXXX-XXXXXXXXX.....WX...W,...+...+...........,,,,,,,,,,XX.,...,......,,X
------X..,.H..,...X-------------XXXXXXXXXXXXXXXXXXXXXXX+XX......,,,,,,,,,,,...:XX:,...,......,,X
------X...,,,,....X-------------XH...A....AXXX--------X.XXXXXXXXXXXXXXX::XXXXXXXX,,,,,,,,,,,,,,X
------X...........X-------------X.AH.,,,.A.,..XXXHHHH-X.X-----------------------XXXXXXXXXXXXXXXX
------Xtt.........X-----------XX,.,,H,,,A,.,....+HHHH-X.XXXXX-----------------------------------
------X.t.........X---------XX,XX.,,,.H.,,.,..XXXXXXX-X.....X-----------------------------------
------XXXXXXXXXXXXX---------X,XXX.,H,H,,H,.XXX--------XXXXX.X-----------------------------------
----------------------------X,X-XA,.,,,,.A,X--------------X.X-----------------------------------
----------------------------X,X-X,,,,.H,,,,X--------XXXXXXX.X-----------------------------------
----------------------------X,X-X,,AH,,HH,,X--------X.......X-----------------------------------
----------------------------X,X-X.,,,,,,,A.A--------X,XXXXXXX-----------------------------------
----------------------------X,X-XA,,A..A,,.X--------X.X-----------------------------------------
----------------------------X,X-X...,,,HA..X--------X,X-----------------------------------------
----------------------------X,X-X,XAXXXXXXXH--------X.X-----------------------------------------
----------------------------X,X-XtX-------XXXXX-----X.X-----------------------------------------
----------------------------X,X-X.X------X,,,,,X----X.X-----------------------------------------
----------------------------X,X-XXX-----X,.XXX,.X---X.X-----------------------------------------
----------XXXXXXXX----------X,X---------X,X---X,X---X.X-----------------------------------------
----------X..,...X----------X,X---------X,X---X,X---X,X-----------------------------------------
----------X..X.XXX----------X,X---------X.X---X,X---X,X-----------------------------------------
----------XXXXtXXXXXXXXXXXXXX+XXXXXXXXXXX+X---X,X--XX,X-----------------------------------------
-------------XT,,,,,,,,.....XT...XWXX,,,X.X---XX.XXX,.X-----------------------------------------
-------------X.,,,,,,,,.....X....X.XX,,,X.X----X,,,,.X------------------------------------------
-------------XXXXXXXXXXX....X....X.XX,,,X.X-----XXXXX-------------------------------------------
XXXXXXXXXXXXXXXXXXXXXXX-X...X....X+XX...X+X-----------------------------------------------------
XA.AA.HX,..,...X.,...,X-X...X....X,XX...X,X-----------------------------------------------------
XA.AA.HXX,,,,,,X,,...,X-X...X....+........X-----------------------------------------------------
X......XX,,....+.....,X-X...X....+........X-----------------------------------------------------
XA.AA.H,,.,....XXXX++,X-X...X....+.,,,,,,,X-----------------------------------------------------
X......,,.,....X--W..TX-X...X....X,XXXXX::X--XXXXXXXXXXXXX--------------------------------------
XA.AA.HXX,,....XXXXXXXXXX...XXXXXX,XX,,...X--X..........,X--------------------------------------
X......XXXXXXXX+.......,.....XXXXX,XX,,,,,XXXX..........,X--------------------------------------
XA.AA.HX------X........,.....,+............:XX..........,X--------------------------------------
XA.AA.HX------X+XXX+XX+XXXXXXXX,,...........XX..........,X--------------------------------------
X......XXXXXXXX+XXX+XX+XXXXXXXX.,.........,,,,..........,X--------------------------------------
XA.AA.HXX:......XX,.XX.XX,,,,XX.,.........,,,,..........,X--------------------------------------
X......XX.......:X,.XX......,XX.,..,,,,,..,,,,..........,X--------------------------------------
XA.AA.HXX...:...XX,.XX......,XX,,..,...,..,,,,..........,X--------------------------------------
X......XX.......:XX.XX,,,....++....,...,<.,,XX..........,X--------------------------------------
XA.AA.HXX.......XX,,XX,.,....XX....,.W.,..XXXX..........,X--------------------------------------
X......,W...::..:X,,XX,,,.:,,XX...,,,,,,,.X--X..........,X--------------------------------------
XA.AA.HXXXXXXXXXXXXXXXXXXXXXXXXXXXXXXXXXXXX--XXXXXXXXXXXXX--------------------------------------
XttAA.HX----------------------------------------------------------------------------------------
X.tAA.HX----------------------------------------------------------------------------------------
XXXXXXXX----------------------------------------------------------------------------------------
------------------------------------------------------------------------------------------------
