---------------------------------------------------,XX----------------------------------------------------
------------------------------------------------,XXX-X----------------------------------------------------
----------------------------------------------XXX,..XX----------------------------------------------------
-------------------------------------------XXX,,..XX------------------------------------------------------
----------------------------------------,XX,,...XX--------------------------------------------------------
-------------------------------------,XXX,,..XXX----------------------------------------------------------
-----------------------------------XXX..,..XX-------------------------------------------------------------
--------------------------------XXX....,.XX:XXXXXXXXXXXX:-------------------------------------------------
------------------------------XX......,.X-X..,.E.,,,,,.EX-------------------------------------------------
-----------------------------X.......,..X-X.,,...,,,,+,.XX------------------------------------------------
----------------------------X.......,,.XXXX,E,,,,,,..+.,HX------------------------------------------------
--------------------------XX.......,,.XX+E,..,....,..+..+X------------------------------------------------
-------------------------X........,,..XX+E,..,....,.A+.E+X------------------------------------------------
------------------------X........,,..X-X+.,..,....,..+..,X------------------------------------------------
-----------------------X.........,..X--XHEX..,....,..+..XX------------------------------------------------
----------------------X..........,.X------X,,,,,,,,..+,EHX------------------------------------------------
--------------------XX...........,.X------X.,,...,,,,+,.XX------------------------------------------------
-------------------X.............,X-------X:.,...,,E,,..:-------------------------------------------------
------------------X..............,X-------XXXX,,,XXXXXXXX-------------------------------------------------
-----------------X...............,X-XXXXXXXXXX+++XXXXXXXXXXXXXXXXXX---------------------------------------
----------------X...............,,X-X.......X......E,A,.......,...XXXX------------------------------------
--------------XX................,.X-X...E...X.......,.,...E...,E..,,EH------------------------------------
-------------X..................,.XXX.,,,,..X....E..,A,.......,...XX,X------------------------------------
------------X...................,.XXK.,..,..X,XXXXXXXXX,,XXXXXX...,,.X------------------------------------
-----------X....................,.XX,.,..,..X,X---XH.,....,,.XX.:.,,EA------------------------------------
----------X.....................,.XX:.,..,..XEX---X,,...E...,X:...,,.X------------------------------------
--------XX......................,.XXK.,..,..X,X--XX........E.XX...,,EX------------------------------------
-------X........................,.XXX.,..,..X,X--X:..........:X...,,.X------------------------------------
------X.........................,.X-X.,,,,..X,X---X,,.......,XX...,,EX------------------------------------
-----X..........................,.X-X.......,EX---X..,....,,.X:...,,.X------------------------------------
----X...........................,.X-XXX,XXXXXXX---XXXXXXXXX,XXX...XX.A------------------------------------
--XX............................,..X:XX+XX----------XXXXXXX,XXX...XX,X------------------------------------
-X..............................,..XX..,,X--------XX......XA,,+...,,EH------------------------------------
X...............................,..XX....X------XX.....E..X+XXX...XXXX------------------------------------
X...............................,..,,E.E.XX---XX.........AX..HX...X---------------------------------------
X...............................,..,,,...XK--X............X.AHX+++X---------------------------------------
X..........,,,,,,...............,..,,E.E.X--X.............XXXXX+++XXX-------------------------------------
X........,,..,,,,,..............,..XX,...X-X.,............XX:,A.E.,..:------------------------------------
X......,,..,,,,,,,,,............,..XXA,.AX-X,,..E...,,,,.XX,,,.....,..X-----------------------------------
X......,.,,.......,,,...........,..XXXXXXXXX,,,....,.XX.X-X,......,,..X-----------------------------------
X......,.,..,,,,,..,.,..........,..X--XXXXX,,,,...,..:..H-X.,XX..AXX..X-----------------------------------
X......,,..,.<..,,..,,..........,..X-X....,,,,,...,XX.E.:-X..XH,,,XH,.X-----------------------------------
X.....,.,.,.....,,,.,,,,,,,,,,,,,,,XX.....,,,,,...,XX...XXX...,.E.,.,.XXXXX-XXX---------------------------
X.....,.,.,.,,,.,,,.....,,,.,,,....,,.....,,,,,...,......+,...,...,.,.,,..XX...>--------------------------
X.....,.,.,.,:,<,,,.....,,,.,,,....,,..W..,,,,,.:.,......+,...,...,.,.,,..,+.:.>--------------------------
X.....,.,.,.,,,.,,,.,,,,,,,,,,,,,,,XX.....,,,,,...,.E....+,...,...,..,,,..XX...X---------X----------------
X.....,.,.,.....,,,.,,,,,,,,,,,,,,,X-X....,,,,,...,XX...XXX.,,H...,H.EXXXXX-XXX--------XX.X---------------
X......,,..,.<..,,..,,.........,...X-X....,,,,,...,XX...:-X.,XX,,,AX.,XXXXXXXXXX------X...X---------------
X......,,,..,,,,,..,,,.........,...X--XXXXX,,,,...,,.:X.H-X,.XX...XX..XE.......,X---XX.....X--------------
X......,.,,.......,,.,.........,...X------XX,.,.....,XX.XXX,,E........X........,X-XX........X-------------
X.......,,.,,,,,,,,,,..........,...X-------X,,.....E..,,..X,,,,,......,.........,X........XX--------------
X.........,..,,,,,,............,...X-------X.,............X:.A..,,...,...........,,......X----------------
X..........,,,,,,..............,...X--------X.............X-XXX+++XX,............,,....XX-----------------
X..............................,...X--------X.............X---X+++XXA...........,.,,.XX-------------------
-X.............................,...X---------X...........AX---X...XX............,..,X---------------------
-X.............................,...X----------XX..........X---X.,,XX...........,...,X---------------------
--X............................,...X------------XXX.......X--X:,..XX...........,..,.,X--------------------
--X............................,...X--------XXXXXXXXX,,,XXXXXXX+..XX..........,...,..X--------------------
--X............................,...X--------X:.E,...,...,...AXX.++XX..........,...,..,XX------------------
---X...........................,...X--------X...,...,....,...XX...XX.........,...,...,.,X-----------------
---X...........................,...X-----XXXX..,....,....,...++...XX.........,...,....,.,X----------------
----X..........................,...X-----X.HX,,.....,....,...++...XX+,,,,...,...,.....,...XX--------------
----X..........................,....X----XX,X......,......,..++.E.XX+,.,,..,...,......,....,X-------------
----X..........................,....X----XX,X......,......,..XX...XX+,E.,..,..,.......,.....,X------------
-----X.........................,....X--XXXA.,......,.....XX,AXX...XX+,,,,.,...,.......,......,X-----------
-----X.........................,....X--XE,..,......,...,,XX,XXX...XX+++++.,...,.......,.......,X----------
------X.........................,...X--XXX..,......X,,,......XX...XX...E..,..,.......,.........X----------
------X.........................,....X---X,,X...:..X..E......XX.,,XX..E..,...,.......,..........X---------
------X.........................,....X---X,,X......,.........X:,..XX.....,...,.......,..........,X--------
-------X.........................,...X---X,,X.....,......E...XX,..XX.....,...,.......,...........,X-------
-------X.........................,....X--X,,X.....,..........XX.,,XX.....,...,......,.............X-------
--------X........................,....X--X,,X....,..E..E.....XX.E.XX.....,...,......,..............X------
--------X.........................,...X--X,,X....,..........HXX...XX.....,...,......,...............X-----
---------XX.......................,...X--X,,X...,.........E,,XX...XX....,...,......,................X-----
-----------X......................,...X--XE.X...XX........,..XX.A.XX....,...,.....,,................X-----
------------XX....................,....X-X..,.E.X...E....,...XX,,,XXH...,...,.XX,,...................X----
--------------X....................,...X-XA.,...,.H......,..:XX+++XXXXXXX,,,XX--XX...................X----
---------------XX..................,...X-XXXXXXXXXX,,,,,,,XXXXX,,,XX:---X...X-----X..................X----
-----------------X.................,...X----------X......,X-X.,.....X---X...X------X.................X----
------------------XX................,..X----------X......,XX.:,...E.X---X.E.X-------X................X----
--------------------XX..............,..X----------X.E..E..XX..,....AX---X...XX------X................X----
----------------------X.............,...X---------X......EXX,,......XXXXX...,.XX-----X................X---
-----------------------XX............,..X---------X.......XX........,,,.,...,...XXXXXX................X---
-------------------------X...........,..X---------X.E....E++......E.,,,..,..,.AE,.H.XXX...............X---
--------------------------XX..........,.X---------XA.,,,.AXX........,,,..A,.XX...,..X-X...............X---
----------------------------X..........,.XX-------XXXXXXXXXX........XXXXXXXX--X..,..X--X..............X---
-----------------------------XX.........,..XX--------------X.E,,,,.AX---------XE.EXX---X..............X,--
-------------------------------X.........,...XX------------X..,.W,..X----------X...X----X..............X--
--------------------------------XX........,....X------------X.,..,..:----------X.,,X----X..............X--
----------------------------------XX.......,,...XX-----------XXXXXXXX-----------X,..X----X.............X--
------------------------------------XXXX....,,,...XX----------------------------X..EX----X.............X--
----------------------------------------XXXX..,,,...XX--------------------------XE.E.X----X............X--
--------------------------------------------XXXX,,,...X--------------------------XE.,X----X............X,-
-----------------------------------------------,XXXX,.X--------------------------X,,.X----X.............X-
---------------------------------------------------,XX---------------------------X...X-----X............X-
---------------------------------------------------------------------------------X....X----X...........,X-
----------------------------------------------------------------------------------X...X----X...........X--
----------------------------------------------------------------------------------X..XX-----X.........X---
----------------------------------------------------------------------------------XXX-------X........,X---
--------------------------------------------------------------------------------------------X.......,X----
--------------------------------------------------------------------------------------------X.......X-----
---------------------------------------------------------------------------------------------X.....X------
---------------------------------------------------------------------------------------------X....,X------
---------------------------------------------------------------------------------------------X....X-------
---------------------------------------------------------------------------------------------X...X--------
---------------------------------------------------------------------------------------------X..X---------
----------------------------------------------------------------------------------------------X,X---------
----------------------------------------------------------------------------------------------XX----------
----------------------------------------------------------------------------------------------X-----------
----------------------------------------------------------------------------------------------------------
