-------------------------------------------------XXXX----------
-------------------------------------------------XH,X----------
----------------------------------------XXXXXXXXXX,,X----------
----------------------------------------X..,,,,,,X,XX----XX----
----------------------------------------X,,,,,,,,,...X--XX-XX--
----------------------------------------X:....,,,,...X-X..X,-X-
---------------------------X------------X,,..........XX....XX--
-------------------------XXXX-----------:,,.,,,E,,,..X...,,.X-X
---XXXX---------XXXXXXXXX....XXXX-------X,..,.,.,.,..,.,,,,,XXX
--X....XXXX----X.....,.....,,,,,XX------X...,.,.,.,..,.,,,,,,,X
--:.......X----X.....,.....,,,,,X:------X...,.,.,.,..,.,,E,,X,X
-X........X----X..X...,.XXXXX,,,XX------X...,.,.,.,..,.,,,,,XXX
-X........X----X.X-X..XX-----XX,X-------XE..,.,.,.,..X...,,.X-X
X.,,,+++,,,X---X.X-X.X--------X.X-------X...,,,.,,,.X-X....XX--
X.,.,X-X,.,X---X.X-X.X-XXXXX:X,,,:XXXXX-X..E........X--X..X,-X-
-X,,,XXX,,:X---X.X-X.X-XX....,,,,,,...X-X...........X---XXXXX--
--X........X---X.X-X.X--X...........X,X-XX,XXXXX+XXX------X----
--X.......X---XX.X-X:X--X............,X--X,XX-XX.XXXX:XX-------
---X....XXXXXXX.,X-X.X--X......,,,,...X--X,,,XXA.,,,,,,X-------
----X,,X-X,,E,...X-XWX--X......,A,,...X-X...:XX.,,,,,,,X-------
----XX,XXXE.,,H..X-X.X-XX......,,,,...XXX...,XX,.,,,.,,X-------
----X,,,XX,,,,...X-X.X-XXX.....,,,,..++.,....XX,,,>>,,,X-------
----X,,,XXE.EX,,.X-XHXX.,,,,,........++.,...,XX,,,>>,,,X-------
----X,,,XX,,,X..,X-X.XX.,,,,,........++.,...,XX,,.,.,,,X-------
----X...XX,.E,...X-X.XX,.,,,.......XX.XXX....XX.,,,,.,,X-------
----X...XXE,,,,.EX-XAXX,.X...X.....XX,X-X...,XX..,,,,,.X-------
----X...XX...,,.,XX...,,X,...,.....,..X-X...,X-X...,...:-------
----X:..XX,,EXX,E.....X,XXXXXXXXXXXXXXXX-X,,,XXXXXXXXXXXXXX----
----X...XX,.,X,......XX:.+.X..<...,..<,X-X.,,..X..XX..X..:X----
----X...XXE,E,,W.....XXXXX.X......,...,X-X,,,.,,.E,,..,..,X----
----X..,XXXXXXXXXXXXXX---X,X......,,,,,X-X,,,.,,,:,,..,..,X----
----X..,XXXXXXXXXXXXXXX--X............HX-X.,,..,,,,,..,..,X----
----X..,.........,+H.WX--X............,X-X.,,..,,.,,..,..,X----
----X..,..........,+.EXXXX.............XXX.,,..,,.,,..,..,X----
----X..,...........,++XA.X,............WXX.,,..,,.,,..,..,X----
----X..,..........H.,+X..+.,,..........,XX.,,..,,:,,..,..,X----
----X..,.............,XH.X.<.,,......,<XXX.,,.,,..,,..,E..X----
----X..,..........H...XXXXXXXXXXX,,XXXXXXX.,,E,,..,,,,,..,X----
----X..,......................XX...XX.,.,X:XXXXXXXXX,XXXX:X----
----XT.,....:.........................,.,XXXXXXXXXXX,XXX-------
----X..,...........H..................,.,.....,,...,,,,X-------
---X...,...............................,.,,,,,,,,,.,,,,XXXEXXX-
---X...,............H..................,.:....,,.,.,,,,,ttt.EX-
---X...,......................E.........,,,,,,,,,.,,,,,,t.t..X-
---X...,..............H....................,,.,,.,.....,ttt.EX-
---X...,...................................,,.:,.,....,,.....X-
---X...,................H.H................,,++:,.,,,,.,.E..EX-
---X...,...................................,,+,.,......,.....X-
---X...,...................................,,+,.,..,A,,,.E..EX-
---X...,..........E........................,,+,.,..,,,,,.....X-
---X..,............................,,......,,+,,,..,,:,,.....X-
---X..,...........................,.,W,,...,,.::...,,,,,.E..EX-
---X..,...........................,,..,,,,.,,.,,.....,.,ttt..X-
---X..,.E........................,.,..X.,,.,,.,,.......,t.t.EX-
---X..,..........................,,.,,X.,,.,,.,,.......,ttt..X-
---X..,.........................,,.XX,,,,,,,,.,XXXX..XXXX.E.EX-
---X..,..........................,,.,,X,,,,,..,X--X,,X---XXX.X-
---X..,..........................,,...X.,,....,XXXX,,XXX----XX-
---X..,...........................,,..,,,,.....E......:X-------
---X..,...........................,.,,,,..............,X-------
---X..,..............,.............,,................,.X-------
---X...,............:.,.............................,..X-------
---X...,....:.....,,...,,..........................,...X-------
----X...,........,.......,.............:...........,...X-------
----X...,.......,.........,.......................,....X-------
-----X...,...:..,......:..,......................,E....X-------
-----X...,.......,........,.....................,......X-------
------X...,......,..E.....,.....................,......X-------
------X...,......,........,....E...............,.......X-------
-------X...,......,.......,...................,.........X------
-------X...,......,,....T.,...................,.........X------
--------X...,.......,,...,,..................,..........X------
--------X...,.........,,,...................,...........X------
---------X...,.............................,............X------
---------X...,.............................,.......E....X------
----------X...,...........................,.............X------
----------X...,..........................,..XXXXXXX.....X------
-----------X...,....E......:............,...XXXXXXX.....X------
-----------X...,........................,...XX:..HX.....X------
------------X...,,,,,,,,,,,,,,,,,,,,,,,,...EXX..:.X.....X------
------------X...............................XXE...X.....X------
-------------X..............................XX....X....X-------
-------------X.E............................XXW.:.X...X--------
--------------X.............................XXX,XXX..X---------
--------------X.............................XXX,XXX.X----------
---------------XXXXXXXXXXXXXXXXXXXXX.........E...E..X----------
------------------------------------XXXX...........X-----------
----------------------------------------XXX.......X------------
-------------------------------------------XXXX..X-------------
-----------------------------------------------XX--------------
