----------------XXXXXXXXX--------------------------------------------------------------------------------------
----------------XE.E.E.EX--------------------------------------------------------------------------------------
----------------X.......X--------------------------------------------------------------------------------------
----------------XE.E.E.EX--------------------------------------------------------------------------------------
----------------X.......X--------------------------------------------------------------------------------------
----------------XE.E.E..X--------------------------------------------------------------------------------------
----------------X......EX--------------------------------------------------------------------------------------
----------------XE......X--------------------------------------------------------------------------------------
----------------X..E.E.EX--------------------------------------------------------------------------------------
----------------X.......X--------------------------------------------------------------------------------------
----------------X.E..E.EX--------------------------------------------------------------------------------------
----------------X.......X--------------------------------------------------------------------------------------
----------------XE.E....X--------------------------------------------------------------------------------------
----------------X.....E.X--------------------------------------------------------------------------------------
----------------X.......X--------------------------------------------------------------------------------------
----------------XE.E....X--------------------------------------------------------------------------------------
----------------X.......X--------------------------------------------------------------------------------------
----------------X.E.EE.EX--------------------------------------------------------------------------------------
----------------X.......X--------------------------------------------------------------------------------------
----------------XEE.E.EEX--------------------------------------------------------------------------------------
------XXXX------X.......X--------------------------------------------------------------------------------------
-XXXXX.E..XX----XE.EE.E.E--------------------------------------------------------------------------------------
-XE.E....E..X---X.......X--------------------------------------------------------------------------------------
-XE....E.....XX-X.EE.E.EX--------------------------------------------------------------------------------------
-X..E....E..E,,XXE.E....X--------------------------------------------------------------------------------------
X.E..........,,XX....E.EX--------------------------------------------------------------------------------------
X...E..E.....,,XX.......X--------------------------------------------------------------------------------------
X.........E.E,,XX.E..E.EX--------------------------------------------------------------------------------------
-XE....E.....,,XX.......X--------------------------------------------------------------------------------------
-X..E....E..E,,XXE.E.E.EX--------------------------------------------------------------------------------------
--X..........,,XX.......X--------------------------------------------------------------------------------------
---X...E.E..E,,XXE.E.E.EX--------------------------------------------------------------------------------------
----X,,,,,,,,,,XX.......X--------------------------------------------------------------------------------------
----X,,,,,,,,,,XXE.E.E.EX--------------------------------------------------------------------------------------
-----XXXXXXXXXXXX.......X--------------------------------------------------------------------------------------
----------------X.......X--------------------------------------------------------------------------------------
----------------X.E.E..EX--------------------------------------------------------------------------------------
----------------X,,,,,,,X--------------------------------------------------------------------------------------
----------------XtttttttX--------------------------------------------------------------------------------------
----------------X.......X--------------------------------------------------------------------------------------
----------------XXXXXXXXX--------------------------------------------------------------------------------------
---------------------------------------------------------------------------------------------------------------
-------------------------------------------XXXXX---------------------------------------------------------------
------------------------------------------:X,,,XHX-------------------------------------------------------------
--------------------------XXX-------------H....,,XXX-----------------------------------------------------------
------------------------XX.,.X------------H......,.X-----------------------------------------------------------
-----------------------X,.,:,X---XXXXXXXXXX,,,,..,.X-----------------------------------------------------------
----------------------X.,.,,..X--X......E.....,..,.X-----------------------------------------------------------
---------------XXX----X,.,,,,,.X-X............,.AXXX-----------------------------------------------------------
---------------XTX---X..,,,,...X-X............,..X-------------------------------------------------------------
---------------X,X-XXX,,,X,,,,,,XX,,,,,,,,....XXX:-------------------------------------------------------------
---------------XAX-X.....,......XX.....,,,,...X------------XXXXX-----------------------------------------------
---------------XHX-X,,E,,,......XX,,,,,,,,,...X------------X,,,XXXXXXX-----------------------------------------
---------------XHXXX,...,,......XX....T..,,...X-----------XH.E...,,,,,X----------------------------------------
---------------XAXX,,.E.,,..,,,.,,...,,,.,,...X---------XX,,,,,,.,,,,,,X---------------------------------------
---------------XAXXX,...,,..,.,.,,..:,.,.,,.E.XXXX-----X.,.,,,,,.,,,,,,,X--------------------------------------
---------------XHX-X,...,X..,,,.XX,,.,.,.,,...XX,XX----X.E.,..,E.XXXX,,,X--------------------------------------
---------------XHX-:,..E,X......XX,,.,.,.,,...,,,AX----X.,.,,,,,.X---XX.,X-------------------------------------
---------------XHXXX,...,X..,,,.,,,,.,.,.,,...,..,XX---X.,,,,,,,.X----X,,X-------------------------------------
---------------XAXX,,...,X..,.,.,,,,.,.,.,,...,..,,X---X.........X-----X,X-------------------------------------
---------------XtXXX,A,,,X..,,,.,,,,.,,,.,,...,..,XX---XA......AAXXXXXXX,X-------------------------------------
---------------X.X-X,,...X......,,.......,,...,..HX----XXXX,,,XXXX:.HH...X-------------------------------------
---------------XXX-XXX,,,X..,,,.,,,,E,E,E,,...H,,,X---XXXXX,,,XXXXX......X-------------------------------------
---------------------X...X..,.,.,t........XXXXXX,XX---XH..,...,..XX......X-------------------------------------
---------------------X...X..,,,.XX,,XXXXXX-----XXX----X...,..,...,,.....AX-------------------------------------
---------------------X...X......XX,,XXXXXXXXXXXXXXXXX-X...,..,...,,.....AX-------------------------------------
---------------------X,,,X..,,,..,,,.,+..,,,,,,,..E.EXX...,..,.E.,,....,,X-------------------------------------
------------------XXXX...X.E,.,..,.,.,+..,..T..,.....,,.:.,.,....,,....,.X-------------------------------------
------------------X..,,,,X..,,,..,,,:,+..,,,,,,,.E..E,,...,.,....,,.E..,.X-------------------------------------
------------------XE.,,.,X.A.........XX..............,,...,..,...,,....,.X-------------------------------------
------------------XHA,,,,XXXXXXXXXXXXXXXXXXXXXXXX,,,.,,...,..,...,,....,.X-------------------------------------
------------------X..,.....+.....XHHX-XXHHXXXX:XX,.,.,,...,..,...,,....,.X-------------------------------------
------------------XE.,.....+.,,,E,..X-X..,.....XX,.,.,,...,.E,...,,.T..,.X-------------------------------------
------------------XXXX....+..,.,.XXHXX...,,,,,,XX,.,.,,...,..,...,,....,.X-------------------------------------
---------------------X,,XXXX.,.,EXAHXX<,.,,,.,,+,,.,.,,...,..,...,,....,.X-------------------------------------
--------------------XX....XX.:.,.XXHXX<,<,,,,,,+,,.,.,,..,..,.:..,,..E.,.X-------------------------------------
--------------------X,E...,,.,,,.,HHXX,,.,,,,,,+,,.,.,,..,..,....,,....,.X-------------------------------------
--------------------X,....XX.....XX+XX<..,,,,,,XX,.,.,,..,..,....,,...W,.X-XXXXXXXXX---------------------------
--------------------XA,A,..X.....XX+X-X..,,,,,,XX,.:.,,..,..,....,,...XXXX-X..H.EH.X---------------------------
----------------XXXXXXXXXXXXXX,,,+XWX-X..,.....XX,.,.,,..,..,....,,...X----X......EX---------------------------
---------------X.,...,,,,,E.X....XXXX-XXHHXXXX:XX,,,.,,...,..,...,,..EX----XE.E.E.HX---------------------------
---------------X.,,,,,,,,,..,....XXXX-XXXXXXXXXXX....,,...,.E,...,,...XXXXXX,,,,..EX---------------------------
---------------X..EH.,A..,..,....XA.A-X.E,,,,,,,.....,,...,..,...,,......,,,...,E.HX---------------------------
---------------X.....,.WA,..,....X.EX-X..,.....,.....,,...,..,...,,......,,,...,..EX---------------------------
---------------X.....,,,,,..,....X..X-X.E,,,,,,,.....,,..,...,.:.XX......,,,...,..HX----XXXXXXXXXXXHXX---------
---------------X..XXXXX.....X....,..K-X...........E.HXX..,..,....XX:.....,,,...,E.EX----X,,,,....E.E,X---------
---------------X..X---A....XX....,..X-X,,,XXXXXXXXXXX-X.,...,...HXXXXXXXXXXX,,,XXXXX----X,,,,..,,,,,,X---------
---------------X..XXXXXX,,XX.....,..X-XLLLX-----------XXX,,,XXXXXX--XXXXXXXX,,,X-------X,,,X,..,....,X---------
---------------X,,,A,AX..........,..X-X,,,XXXXXXXXXXXX:XX,,,XXX----X,,.AAAXX+++XXX-----X,,XX,,.,..E.,X---------
---------------X.....,X.........E,,,X-X............E...X....E.X----X,,.,.AX.....:X----X,,,XX,,.,....,X---------
---------------X,,...,,.......E..X..X-X................,......X----X,,E,.,,,,,...X----X,,,XXX,.,....,X-----XXXX
---------------X.,...,,.........,X..X-X.E..........E...X....E.X----X,,.E.,,,.,...XXXXXX,,,X:H..,....,X-----X..X
---------------X,,,,,,X........X:X..X-X...............:X.T..,,XXXX-X,,.,.,X,.,,,,,,..,,,,E.,,,,,....,XXXXXXX..X
---------------X.,....XXXX,,,XXXXX..X-XXXXXXXXXXX,,,XXXX...,.HXt.X-X,,.,T,,,.....,,.T,.T.,H,,,...T..E,LHLHL,.E>
---------------X.,..E........,,,,,..X--X,,,,,,,XX,,,X--X...,,,XtXXXX,,.,.,,,,,,E,,,..,,,,E.,,,,,....,XXXXXXX..X
---------------X.,...........,,,,,:.X--X,......XX,,,X--X...,.,X...XX,,.,.,XX,,X,XXXXXXX,,,X:X..,....,X-----X..X
---------------XXXXX,,...XXX.,...,..X--X,.E..,,XX,,,XXXXX,XXXXXH.HAX,,.,.,XX,,X,XXXXXXX,,,XXX.:,,,,,,X-----XXXX
-------------------X.,...X-X.,.E.,..X--X,..,,.....E...X......XXXXXAH...,.,.,.,...,A,.XX,,,XXH.......,X---------
-----------------XXX,,...XXX.,,,,,,,X--X,.E,.......,,,X......,.,.XXH..E,,,.,.,...,A,,XXX,,XX......E.,X---------
-----------------X.A......E...A,...,H--X,..,.......,.,X......,.,.XXH.......,.,...,.AWX-X,,,X,.......,X---------
------------------XXXXXXXXXXXXXXXXXXXXXX,..,.,,,,,.,.,X.E.E..,.,.X-X.......,.,,,,,.,,X-X.,,,,.......,X---------
-------------------------------XE....,XX,,XX.,,,,,.,.,X......XXX,X-X,,,XX,XX.....,A,.X--X.,,,...E.E.:X---------
---------------------------XXXXX.E.E.,XX..XX.,,,,,.,.,XX,,,XXX-X.X-X,,,XXXXX.....,A,.X---XX,,X,,,XXXXX---------
---------------------------X...E.....,XX..XX..HH...,.,XX,,,X.X-X.X-X,,,X---X....E,.,.XXXX--XXX,,,X-------------
---------------------------XE....E.E.,XX..XX,,,X...,,,XX...X,X-X.XXX,,,XX--XE....,H,XXXKX----X...XXXXXXXXXX----
---------------------------X.........,XXE.XX.E.,....H.XX,,,XEXX..XXH...HX--X.....,XXXXX,XX---X...X........X----
---------------------------XE..E.E...,XX...,...,,XXXXXXX,,,,,,,,.XXA....X--XH,,,,X---A..AX---X...,........,X---
---------------------------X.....E.E.,XXXXXX.E...X---X.,.......,.XX.....X---XX,,,XXXXX.A.X---X...,........,X---
---------------------------XE........,X----X...E.X---X.,.......,,XXAE..EX----XXXXXA..,E..X---X...X........,X---
---------------------------XE..E.E.E.,X----XA...AX---X.,......E,.XXA....X---------X.XX...X--X....X........,X---
---------------------------XXXXXXXXXXXX----X,,..HX---X.,,,,E,,,,,X-XXtXX-------XXXX,XX,,,XXX.....X........,X---
-------------------------------------------X.,...X---X.,.....A.AX---X.X--------XH...,.E..+....E..X........,X---
-------------------------------------------XXXX+X----X.E,XXX,,,X----XXX--------XH.E.,.....+......X........,X---
-----------------------------------------------------X..HX-X...X---------------XA.H.,..E.W+.....,.........,X---
-----------------------------------------------------XXXXX-XXXXX---------------XXXX,X.....:+..,,..........,X---
----------------------------------------------------------------------------------X.XX,,,XXXX,............,X---
----------------------------------------------------------------------------------XA.,E.AXX...............X----
----------------------------------------------------------------------------------XXXH..AXX..............,X----
----------------------------------------------------------------------------------XX-X...XX..............,X----
----------------------------------------------------------------------------------XX-HX,AXX..............,X----
--------------------------------------------------------------------------------------XKX-X..............,.X---
--------------------------------------------------------------------------------------XXX-X..............,.X---
------------------------------------------------------------------------------------------X..............,.X---
------------------------------------------------------------------------------------------X..............,.X---
------------------------------------------------------------------------------------------X..............,X----
------------------------------------------------------------------------------------------X..............,X----
------------------------------------------------------------------------------------------X..............,X----
------------------------------------------------------------------------------------------X..............,.X---
------------------------------------------------------------------------------------------X,,,,,,,,,,,,,,,.X---
------------------------------------------------------------------------------------------XXXXXXXXXXX.....X----
-----------------------------------------------------------------------------------------------------XXXXX-----
