--------------------------------------XXXXXXXXXXXXXXXXXXXXX----------------------------------------------
--------------------------------------X...................X----------------------------------------------
--------------------------------------X.,,,,,,,,,,,,,,,,,.X----------------------------------------------
--------------------------------------X.,...............,.X----------------------------------------------
--------------------------------------X.,...............,.X----------------------------------------------
--------------------------------------X.,...............,.X----------------------------------------------
--------------------------------------X.,...............,.X----------------------------------------------
--------------------------------------X.,...............,.X----------------------------------------------
--------------------------------------X.,...............,.X----------------------------------------------
--------------------------------------XXX,,,,,,,,,,,,,,,XXX----------------------------------------------
--------------------------------------XXX,,,,,,,,,,,,,,,XXXX---------------------------------------------
------------------------------------XX......................XX-------------------------------------------
----------------------------------XX..,,,,,,,,,,,,,,,,,,,,,...XXX----------------------------------------
----------------------------------X<..,.........A.........,...+WX----------------------------------------
------------------------X-------X>XX..,,,,,,,,,,,,,,,,,,,,,...XXX----------------------------------------
-----------------------X.X------XEX-XX......................XX-------------------------------------------
----------------------X...X-----XEX---X,,,,,,,,,,,,,,,,,,,XX---------------------------------------------
----------------------X....X----X.X---X,,,,,,,,,,,,,,,,,,,X----------------------------------------------
---------------------X.....X----XE.X--X...................X----------------------------------------------
--------------------X.......X---XE.X--X..,,...,,,,,...,,,.X-------XXXXXXX--------------------------------
-------------------X.........X--XH.X--X,,.,...,...,...,..,X-------X....HX--------------------------------
------------------X.......:...X-XLLX--X,,.,...,.K.,...,..,X-------X.XXXXX--------------------------------
-----------------X.............XXLLX-XX..,,...,...,...,,,.X-------X+X------------------------------------
-----------------X.............,...XXX,.......,,,,,.......XXXXXXXXX+XXX----------------------------------
----------------X..............,.H.LL.,...................+...,,,....,,XX--------------------------------
--------------XX...............,...LL.,...................+...,.....,.,:.X-------------------------------
------------XX.................,,..LL.,...................+.,,,.....,.,...X------------------------------
----------XX.....................,,LL.,...................,,,......,..,....XX----------------------------
--------XX.........................XXX,.........E.........XXXXXXXXX...,......X---------------------------
------XX.......:......A...........X--XX..,,...........,,,.X-------XH..,.......X--------------------------
----XX..........................XX----X,,.,...X,,,X...,..,X-------X...,......:X--------------------------
--XX...........................X------X,,.,...X...X...,..,X-------X...,.....E.X--------------------------
XX............................X-------X..,,..XX.H.XX..,,,.X-------XW..,.......X--------------------------
X....:......................XX--------X......XX...XX......X-------X...,......:X--------------------------
-X...................,,....X----------XXXXXXXXX,,,XXXXXXXXX-------X...,......X---------------------------
-X.................,,..,..X-----------------X:.....:X-------------XH..,.....X----------------------------
-X.......,,........,XX.,...X----------------X.......XXXXXXXXXXXXXXX...,....X-----------------------------
--X...,,,..,,.....,X--X,...X----------------X.......LL,,,,,,,,,,,,,+..,..XX------------------------------
--X...,......,....,.XX.,....X---------XXXXXXX.......LL,,,,,,,,,,,,,.+.,:X--------------------------------
--X...,.......,,...,..,,.....X--------X...,.........LL,,,,,,,,,,,,,..+,X---------------------------------
---X..,.........,E..,,........X-------X...,.........XXXXXXXXXXXXXXXXXXX----------------------------------
---X..,..........,,...........X-------X...,.........X----------------------------------------------------
---X..,............,...........X------X.,,,.........XXXXXXXXXXXXXXX--------------------------------------
----X..,,...........,,.........X------X.,,.......................:X--------------------------------------
----X....,,...........,........X------X.,,..,,,,,,,,,,,,,,,,,.....X--------------------------------------
-----X.....,...........,...:...X------X.,,..,...............,.....X---------------XX---------------------
-----X......,,.........,......X-------X.,,..,.,,,.......,,,.,.....X--------------X:.XX-------------------
-----X........,.........,.....X-------X.,,..,.,.,...A...,.,.,.....X-------------X.....XX-----------------
------X........,,.......,.....X-------+,,,..,.,,,.......,,,.,.....XXXXXXXXXXXXXX........X----------------
------X..:.......,.......,....X-------+.....,...............,.....,,,,,,,,,,,,,,........X----------------
------X........,,.,......,....X-----XX+.....,..A....A....A..,.E...,,,,,,,,,,,,,,....K.E.X----------------
-------X.....,,..,,.......,...X-----X.,.....,...............,.....,,,,,,,,,,,,,,........X----------------
-------X.....,XX.,,......,...X------XH,.....,.,,,.......,,,.,.....XXXXXXXXXXXXXX........X----------------
-------X....,X--X,.,....,....X------X.,.....,.,.,...A...,.,.,.....X-------------X.....XX-----------------
--------X...,.XX.,.,....,....X------XXX.....,.,,,.......,,,.,.....X--------------X:.XX-------------------
--------X....,..,,,....,..A..X--------+.....,...............,.....X---------------XX---------------------
-------X......,,,,....,......X------XX+.....,,,,,,,,,,,,,,,,,.....X--------------------------------------
-------X.......,.....,........X-----X.,...........................X--------------------------------------
------X.......,......,........X-----X.,,X++,,,X++,,,X++,,,X+X,,,X+X--------------------------------------
-----X.......,......,..........X----XH..X-X.H.X-X.H.X-X.H.X-X.H.X--------------------XXX-----------------
----X......,,......,...,,,,....X----XXXXX-XXXXX-XXXXX-XXXXX-XXXXX------------------XX...XXXX-------------
----X.....,........,...,X..,....X------------------------------------------------XX.........XXXX---------
---X......,.......,...,X-X.,....X----------------------------------------------XX...............XX-------
--X.......,.......,...,X--X,.....X-----------------------------XXXX----------XX..................X-------
--X.......,........,...,XX.,.....X-------------------------XXXX....XXXXX---XX.....................X------
---X.:...,.........,...,,,,,......X---------------------XXX.............XXX...............:.......X------
---X.....,.........,..............X-----------------XXXX...........................................X-----
---X.....,.........,.........:.....XXXXXXXXXXXXXXXXX...........................,,..................X-----
----X....,..........,........................................................,,..,.................X-----
----X....,..........,,.......................................................,.XX,..................X----
----X.....,...........,,,......,,,,,,,................A....,,...............,.XWX.,.......A.........X----
-----X....,..............,,,,,,.......,,,,,,.............,,..,.....:........,.XX..,.................X----
-----X.....,................................,,,..........,XX.,...............,,..,...................X---
------X....,,......................,,,.........,........,X--X,.................,,....................X---
------X......,,..................,,...,,........,,......,.XX.,.....................,,,,,,,............X--
------X..A.....,,..............,,.......,,........,......,..,,..................,,,......,.......A....X--
-------X.........,,...........,.....,,,,..,,.......,......,,................,,,,.........,............X--
-------X.......,,..,.........,......,X..,..,........,,................,,,,,,.............,.............X-
-------X.....,,..,.,........,......,X-X.,...,.........,,,.........,,,,...................,.............X-
--------X....,XX.,..,......,.......,X--X,...,............,,,...,,,......................,..,,,,.........X
--------X...,X--X,..,.....,.........,XX.,....,..............,,,.........................,..,.X.,......K.X
-------X....,.XX.,...,,..,..........,,,,,....,.........................................,..,.X-X.,......X-
------X......,..,,.....,,...................,..........................................,..,.X-X.,.E....X-
-----X........,,..........................,,..........................................,....,XX..,.....X--
---XX.......................,,,,,,,,,,,,,,.............................,,,............,....,,,,,......X--
--X..................A....,,.......................................,,,,...,...........,..............X---
-X.E..:.................,,.......................................,,........,..........,.............X----
XXXX....................,..........,,,,.......................,,,...........,.........,.............X----
----XXXXXX...............,.....,,,,....,,...................,,...............,........,............X-----
----------XXXXXX.........,.....,.........,................,,..............A...,,.....,,...........X------
----------------XXXXXX...,.....,..........,,............,,........,,,,..........,..,,.............X------
----------------------XXX.,....,............,,........,,..........,.X.,..........,,......:.......X-------
------------------------X.,...,....,,,,.......,,,,,,,,......:....,.X-X.,.........................X-------
------------------------X.,...,....,X..,...A.....................,.X-X.,......XXX...............X--------
------------------------X..,..,...,X-X.,...............X..........,XX..,.....X---XXXXXX........X---------
------------------------X..,..,...,X--X,..............X-XX........,,,,,.....X----------XXXXX...X---------
------------------------X..,...,...,XX.,......:......X----XX...............X----------------XXX----------
------------------------X..,...,...,,,,,............X-------XX............X------------------------------
-----------------------X...,...,...................X----------X..........X-------------------------------
-----------------------X...,....,.................X------------XX.......X--------------------------------
-----------------------X...,,,,,,...........A....X---------------XX....X---------------------------------
-----------------------X........................X------------------XX.X----------------------------------
-----------------------X.......................X---------------------X-----------------------------------
-----------------------XXXXXXXXXXXXXXXXXXXXXXXX----------------------------------------------------------
