---------XXXXX---------------------------------------------------------------------------------------------------------------------------------------------------------------------------------------------------------------
---------X....XXXXXXXXX------------------------------------------------------------------------------------------------------------------------------------------------------------------------------------------------------
---------X.............XXXXXXXXX---------------------------------------------------------------------------------------------------------------------------------------------------------------------------------------------
---------X......................XXXXXXXXX------------------------------------------------------------------------------------------------------------------------------------------------------------------------------------
---------X...............................XXXXXXXX----------------------------------------------------------------------------------------------------------------------------------------------------------------------------
---------X.......................................XXXXXX----------------------------------------------------------------------------------------------------------------------------------------------------------------------
---------X.............................................XXXXXX----------------------------------------------------------------------------------------------------------------------------------------------------------------
---------X......................................A............XXXXXXXX--------------------------------------------------------------------------------------------------------------------------------------------------------
---------X.....,,,,,,,,..............................................XXXXXXXXX-----------------------------------------------------------------------------------------------------------------------------------------------
---------X.....,H......,,,,,,,,,,,...................................,,,......XXXXX------------------------------------------------------------------------------------------------------------------------------------------
---------X.....,..................,,,,,,,,...........................,..,..A.....X-------------------------------------------------------------------------------------------------------------------------------------------
---------X.....,..,,,,,,,,,,..............,,,,,,,....................,..,..A....X--------------------------------------------------------------------------------------------------------------------------------------------
---------X.....,..,,,,,,,,,,.....................,,,,,,,,............,.,,.....XX---------------------------------------------------------------------------------------------------------------------------------------------
---------X.....,..,..E....,,..A..........................,,,,,,,,,,,,,,......X-----------------------------------------------------------------------------------------------------------------------------------------------
---------X.....,..,.....E.,,.........................................,,,,,,,X------------------------------------------------------------------------------------------------------------------------------------------------
---------X.....,..,...W...,,.................E.........................A..,,XXXXXXXXXXXXXXXXXXXXXXXXXXXXXXXXXXXXXXXXXXXX-----------------------------------------------------------------------------------------------------
---------X.....,..,.......,,..................,,,..E......................,H,.........H............H....................XXXXXXXXXXXXXXXXXXXXXXXXXXXXXXXXXXXXXXXXXXXXXXXXXXXXXXXXXXX------------------------------------------
---------X.....,..,..E..E.,,...........E....,,H..,.......................,,XXXXXXXXXXXXXXXXXXXXXXXXXXXX...............................,..,...,..,..,..,..,,,,,,,,,,,,,,,,,,,,,,,,.X------------------------------------------
---------X.....,..,...H...,,................,,,,,,.........................XX------------------XX------XXXXXXXXXXXXXXXXXXXXXXXXXXXXXXXXXXXXXXXXXXXXXXXXXXXXXXXXXXXXXXXXXXXXXXXXXX.X------------------------------------------
---------X.....,..,.......,,...............,.,...,,........................,.XXXXXXXX--------XX..XXXXXXXXXXXXXXXXXXXXXXXXXXXXXXXXXXXXXXXXXXXXXXXXXXXXXXXXXXXXXXXXXXXXXXXXXXXXXX-X.X------------------------------------------
---------X.....,..,,,,,,,,,,...............,.,E..,,.........E..............,.+.......XXXXXXXX+E..E,..............................................................E.E.,........X-XX-------------------------------------------
---------X.....,..,,,,,,,,,,...............,.,...,,........................,.+.E...E....A.:.XXX..XXXXXXXXXXXXXXXXX,,,,,,,,,,,,,,,,,,,,,,,,,,,,,XXXXXXXXXXXXXX,XXXXXXXX....E.EXXX-X-------------------------------------------
---------X.....,.................E.........,.,,,,.,....E............E......,.+..............X--XX----------------X.............................X------------X.X---X:XX.......X-X-X-------------------------------------------
---------X.....,............................,,A..,........................,.+....A.......,,.X--------------------X,,,,,,,,,,,,,,,,,,,,,,,,,,,,,X--------XXXXX,XXXXX..........X-X-X-------------------------------------------
---------X.....,..A...........................,,,.........................,.+..E...E.....,,HX--------------------X..................,,,,,,,,..:X--------X.........X....+++...X-X-X-------------------------------------------
---------X.....,..........................................................,.+............,,.X--------------------X.E..........,,,,,,...........X--------X,.......,X...++.++.EX-X-X-------------------------------------------
---------X.....,..........................................................XXXXX.............X--------------------X.......,,,,,.................XXXXXX---X.,,...,,.X.H.+.EK+..X-XX--------------------------------------------
---------X.....,.......................................................H..X----XXXX.....A.:.X--------------------X..,,,,,.........A.................X---X.H.,,,..HX...++.++.:XX.X--------------------------------------------
---------X.....,............E.....,,,,,..H..,,,...A...,,,.......XXXX......X--------XXXX.....X------------------XXX,,..............................E.X---X..,,.,,..X....+++...XX.X---XHXXXXX----------------------------------
---------X.....,..................,...,.....,.,.......,.,.......X---XXXX.X-------------XXXX.X------------------X............A.....H....A............X---X,,.....,,X..E..E..XXXX+X---X.,.,.X----------------------------------
---------X.....,..................,.,,,,,,,,,,,,,,,,,,,,,,,,,,,,XXX-----XX-----------------XX------------------XX.................................E.X---X.........XX.......XXXX,XXX-X,XXX,X----------------------------------
---------X.....,..................,.,.........................,.,..XXXX------------------------------------------X,.................................X--X............X:...E.XXH...HX-X.X-X.X----------------------------------
---------X.....,..................,,,.........................,,,.H....XXXX--------------------------------------X.,,,............A.................X--X............X......XX.ttt.X-X,X-X.X----------------------------------
---XXXX--X.....,........E...........,...........................,........,.XX------------------------------------X....,,,,..........................X--XX+++++++++XXXXXXX..XXEt.tEX-XEX-X.X----------------------------------
XXX....EXX.....,....................,+,,........................,........,...XXXXXXXXXXXXXXXX------------------+XX.E......,,,..................XXXXXX-XXX+++++++++XXX---X.:XX.ttt.X-X,X-X.X----------------------------------
X........,....,.....................,+.,..A............E........,........,...,.........XX.A.XXXXXXXXXXXXXXXXXX-+H,...........,,,..............:X------X,.,,..:...,.:XXXXXXXXX,,,,,X-X.X-X.X----------------------------------
X..XX...XX....,.....................,+,,........................,....E...,....,........XX...,,.E.E.A.AEH.E..AX-XXXXXXXXXXXXXXXXXXXXXXXXXXXXXXXXX------X:,,,,,..,,.H.XX.E.XXXX,,,,,XXX,X-X.X----------------------------------
X..X-XXX-X....,.....................,...........................,.......,.....,....E...,,..E,,.E.E....E.....AX----------------------------------------X...,,.,,,...XXXXXXXXE,,,,,,E,,EX-X.X----------------------------------
X,,X-----X....,..................,,.,...........................,.......,.....,........XX...,,..........H....X----------------------------------------X....XX.X..,,XXXXXXXX...ttt..,,.XXXLXX---------------------------------
X..X-----X....,.................,..,,.........................,,,.A.....,..A..,........XX...XXXXXXXXXXXXXXXXXX----------------------------------------XX...XXXXXX,.....A..,..:tTt:.,,.XX...X---------------------------------
X..X-----X....,..H..............,..,,.........................,.,.......,......,.......XX,,,XXXXXXXXXXXXXXXXXXXXXXXXXXXXXXXXXXXXXXXXXXXXXXXXXXXXXXXXXXXX...,XXXX,,,,,.....,.E.ttt..,,.XX..EXXXX------------------------------
X..X-----X....,................,.HXXXXXXXXX,,,,,XXXXX,,,,,XXXXXXXXXXXXXXXXXXXXXXXXXX,XXXX...,.,.,..++...E.,,,H,,,,H,,,,,,,H,,,,,,,,H,,,,,,H,,,,H,,,..++....,.,,.,,..,.....,......E.,,.XX....,EX------------------------------
X..X-----X....,................,..X-------X.....X---X.....X------------------------XHX--X.T.,.,.,.A++.E...,H,,,H,,,,,H,,,,,,,,H,,,,,,,,H,,,,,H,,,H,..++....,.,,H,,E.,.....,..E.E...,,.XXXTXXXXX------------------------------
X..X-----X,,,,,,,,,,,,,,,,,,,,,,..XXXXXXXXX,,,,,XXXXX,,,,,XXXXXXXXXXXXXXXXXXXXXXXXXX,XXXX...,.,.,..++.....,,,,,,,,,,,,,,,,,,,,,,,,,,,,,,,,,,,,,,,,,..++.....,,,.,,,,,.....,.......E,,.X-X.X----------------------------------
X...X----X....,.................,.,.,.........................,.,A......,..A...,.......XX,,,XXXXXXXXXXXXXXXXXXXXXXXXXXXXXXXXXXXXXXXXXXXXXXXXXXXXXXXXXXXX....XXXX,,,,,.....,.E..,HH.,,.X-X+X----------------------------------
X...X----X....,.H...............,..,,.........................,,,.......,.....,........XX...X---------------------------------------------------------XX....XXXX,,,.......,...,+T+,,,.X-XHX----------------------------------
X...X----X....,..................,,.,...........................,.......,.....,...E....XX...X-----------------------------------------------XXXXXXXXXXX.....XX....,XXXX+XXX.E.,EHA,,,.X-X+XX---------------------------------
X...X----X....,.....................,...........................,....E..,.....,........,,..EX-----------------------------------------------X.A......,,.....,,......X-----X..E,+HH,,,.X-X.,+---------------------------------
X...X----X....,.....................,,,,..W............E........,........,....,........XX...X-----------------------------------------------X.....E..,,:...,..,....:X-----+A...,,,A,,.X-X.XX---------------------------------
X...X----X....,.....................,+.,........................,........,...,.........XX.A.X-----------------------------------------------X........,,....,..,.....X-----X,,,,,,,,,,.X-X.XXX---------XX---------------------
X...X----X....,.....................,,,,........................,........,...XXXXXXXXXXXXXXXX-----------------------------------------------X........,,,,XX....,XXXXX---XXX,,,,,,,,,,.X-X.,..X-----XXX.HXXXXXX---------------
X...X----X....,.....................,...........................,H.......,.XX---------------------------------------------------------------X...XXXXXX,,,XXLLLL,X-------XH+..........AX-X.X..X---XX,,E.,++.,EX---------------
X...X----X.....,..................,,,.........................,,,......XXXX-----------------------------------------------------------------X...X----X...XXLLLLLX-------XXXX,,,,,,,XXHX-X.XX.EXXX,,,E,,.XXXX,X---------------
X...X----X.....,........E.........,.,.........................,.,..XXXX---------------------------------------------------------------------X...X----X.E.XXE...EX----------X.EE....XX.X-X.X-X..E,,,,..XXX--XEX---------------
X...X----X.....,..................,.,,,,,,,,,,,,,,,,,,,,,,,,,,,,XXX-----XX------------------------------------------------------------------X.E.X----X...XX.....X----------X....EE.XXXX-X,XXX...,,,XXXXX--XXHX---------------
X.<.X----X.....,..................,...,..H..,.,.......,.,.......X---XXXX.X------------------------------------------------------------------X...XXXXXX...XX:.A.:X----------XE.E...EX-X+XX.<.XX..,XXX...:XXXX,X---------------
X...X----X.....,..................,,,,,.....,,,.......,,,.......XXXX.....X------------------------------------------------------------------X..,.........XX.ttt.X----------XAEE.E.EX-X.XX.<.X-XXX-X:ttt..X-XEX---------------
X...X----X.....,.......................................................H..X-----------------------------------------------------------------X.,........A.XX.t.t.X----------X.......X-X.XX...X-XXX-X.tKt..X-X,X---------------
X.W.X----X.....,..........................................................XXXXXXXXXXXXXXXXXXX-----------------------------------------------X.,H...E.....XX.ttt.X----------X,,,,,,,X-X.,,WXXX-XAXX.:ttt:..XX,+---------------
X...X----X.....,..........................................................,.+............:..X-----------------------------------------------X,...........XX:...:X----------X:.....:X-X.XX.X---X.XX.E.E....XX+X---------------
-X..X----X.....,............E.............................................,.+........E.....HX-----------------------------------------------XXXXXXXXXXXXXXXXXXXXX----------X..,,,..X-X.XX+XX--X+XX.......X-X.X---------------
-X..X----X.....,..A...........................,,..........................,.+..E............X------------------------------------------------------------------------------X..,H,..X-XEXXHXXXXXE+-X.H..E.X-X.X---------------
-X..X----X.....,............................,,A.,,..................E.....,.+..........A....X------------------------------------------------------------------------------X..,,,..X-X.XX,XXH.X++-XX...,XX-X.X---------------
-X..X----X.....,............................,.,,.,........................,.+............,,.X------------------------------------------------------------------------------X.E...E.X-X.XX.XX..,.++HXXX,,,.XX.X---------------
-X..X----X.....,,,,,,,,,,,,,...............,.,..,.,.......................,.+.....A......,,HX------------------------------------------------------------------------------X..A.A..X-X.XX.XXXX,.,...XXX.E.XXEX---------------
-X..X----X.....,,,,,,,,,,,,,....E..........,,.E.,.,.......................,.+...........A,,.X-------------------------------------------------------------------------------XX...XX--X.,,E,.EXXEXXX..E....XX.X---------------
-X..X----X.....,,,.E..E..E,,...............,,...,.,.......................,.+...E....E......X-------------------------------------------------------------------------XXXE+EX-+++--XXX.,,.,.E.X.X--XX..E.EXX+X---------------
-X..X----X.....,,,..H.....,,...............,.,,,,.,..........E............,.+...............X-------------------------X-----------------------------------------------+...,.+------X...,,.,..AX,X----X....XX.X---------------
-X..X----X.....,,,....E..E,,...............,...H..,.......................,.+............:.HX------------------------X.X------------------------------------------XXXXX,X,XXXXXXXXXX...XX.X.E.X,X-----X+XX-XEX---------------
-X..X----X.....,,,.E......,,................,,,,,,..E.....................,.+...............X-----------------------X...X-----------------------------------------+E,H,...,.,...,E,,...XX.X..EX.XX----X,XX-X.X---------------
-X..X----X.....,,,........,,...........E..................................XXXXXXXXXXXXXXXXXXX------------------------X...X---------------------------------------XXXXXXXXXXXXXX,XXXX...XX,X.E.XH.EXX+X....XX,X---------------
-X..X----X.....,,,.E..E..E,,..............................................X------------------------------------------X....X--------------------------------------XAE,.....E..EX.XHXX...XX.X..EX.XX--+.EA.EXX.X---------------
-X..X----X.....,,,........,,.A...............E............................X-------------------------------------------X....X-------------------------------------X,,,..,,,...A,.XXXX...XX,X...X+X---+X....XX.X---------------
-X..X----X.....,,,,,,,,,,,,,............................................A.X--------------------------------------------X....X------------------------------------X.....,.,,,,.,.XT,,...,,EXH.EX.XXXXXXXXXXXX.X---------------
-X..X----X.....,,,,,,,,,,,,,...............................................X--------------------------------------------X.H..X-----------------------------------X.....,,,,,,.,.X,XX...XX,X.E.XE..,....E+.,,EX---------------
-X..X----X.....,H..........................................................X--------------------------------------------X.....X-------------------------------XXXX......E.E.,.X.+.++...XX,X...X,XXXXXXXXX.XXXX-----------XXX-
-X...X---X.....,,,,,,,,,,,,,,,,,,,,,,,,,,,,,,,,,,,,,,,,,,,,,,,,,,,,,,,,,,,,X---------------------------------------------X....X-----------------------------XXX,,...........,.XXXXXX...XX,X..EXEX-------XXX--------------XEX-
-X...X---X..................................................................X---------------------------------------------X....X----------------------------X.,E,...,,,,,,,,,.X...XX...,,EX.E.X.X-------X.X-------------X..X-
-X...X---X............................ttt....................................X---------------------------------------------X.A..X---------------------------XXX,,...,,A,XXXXXXX.E.,,...XX,X,,,XEX-------XEXXXXXXXXXXXXEXX.EXX
-X...X---X............................t.t.....................................XX-------------------------------------------X.....X--------------------------XAXXXX..,,,E,T,.,.,...,,...XX..X,,X.X-------X.,H,,..........,..HX
-X...X---X............................ttt.........A.............................X-------------------------------------------X.....X-------------------------XEXEXX..,,,,XXXXXXXX,XXX+XXXX..X+++EX-------X.XXXXXXXXXXXXXXX..XX
-X...X---X.......................................................................X-------------------------------------------X..A..X------------------------X....,.H,H,HHXHXHHXHHXXX.X---XX-X-X.X-------X.X-------------X.EX-
-X...X---X...........................XXXXXXXXXXXXXXXXXXXXXXXXXXXXXXXXXXXXX,XXXXXXXX-------------------------------------------X.....X-----------------------XE.AE,.,,,,,,,,,,,,,,,HXEX-----XEXX,X-------X.X--------------X.X-
-X...X---XXXXXXXXXXXXXXXXXXXXXXXXXXXX-----------------------------------X-X---------------------------------------------------X......X----------------------X....,...............,,,.X------X-X.XXXXX---X.X--------------XXX-
-X...XXXX---------------------------------------------------------------X-X---------XXXXXXXXXXXXXXXXXXXXXXX--------------------X..A...X---------------------XXXXXXttt........E...,HXEX-------X,.+++.XXXXX,XXXXXXXXXHX--------
-X.......XXXXXX--------------------------------------------------------X-X---------X.........A.A...A.....HX---------------------X......X-------------------------XtHt............,XX.X--------X+H.TELE,A,.,...,.,...X--------
-X.............XXXXXXXX------------------------------------------------X-X--------X...,.........ttt........X---------------------X.....X-------------------------X,,t............,HXXX--------X,,,..XXX,XXXXX,XXXXXEX--------
-X.....................XXXXXXXX---------------------------------------X-X--------X.A.,,.........tWt........X---------------------X......X------------------------XA......,,,,,,,,,X-----------XXXXXXX-X.X---X.X---X.X--------
-XXXXX.........................XXXXXXXX------------------------------X-X--------XA..,..,...A....ttt...E.....X---------------------X..E...X-----------------------XXXXXXXXX,,,,H,,,X-------------------X.XXXEX.XXXXX,X--------
------XXXXXXXX...................<...W.XXXXXXXX----------------------X-X-------X..,,...,...........E.....E..X----------------------X......X------------------------------X,,,,,,,,X-------------------X...,.,.,.,.,,X--------
--------------XXXXXXXXXXXXX....................XXXXXXXX-------------X-X-------XA.,.....,.....................X---------------------X......X------------------------------X...E..E.XXX-----------------X.XXXXX,XXX,,EX--------
---------------------------XXXXXXXXXXXX................XXXXXXXX-----XX------XX..,.,..E..,..A....E...E........X----------------------X...E..X-----------------------------X........,.X-----------------X.X---X.X-X.,.XX-------
---------------------------------------XXXXXXXX................XXXXX-X-----X...,.,>,....,....E.........E......XXX--------------------X......X----------------------------X.E....E.XXX-----------------X,X---X.XXX,XXtKX------
-----------------------------------------------XXXXXX..............HX-----X...,.,>>,....,........................XXXX-----------------X.....X----------------------------X........X-------------------X.X---XE,.,.XXtX-------
-----------------------------------------------------XXXXX....,XXX..X----X...,.,>.>.,....,....................A......XXX--------------X......X--------XXX--XXX-----------X,,,,....X-------------------X,X---X.XXXXX-X--------
----------------------------------------------------------XXX,X---XX----X..,,,,>..>..,...,.A...A..A.A...........A..A...X---------------X...E..X-------XTX--XHX-----------X..,,....X-------------------X.X---X.X--------------
---------------------------------------------------------XX...X--------X..,.,.>..>....,..,.........................,,,,X----------------X......X------XtXXXXEXXXXXXXXXXXXX,,,,..E.XXXXXXXXXXXXXXXXXXXXX,XXXXX,XXXXX----------
-------------------------------------------------------XX..E.X--------X..,.,.>...>....,...,................,,,,,,,,...,.X----------------X.....X------X.E..,.,......,....,+H,,....,...................,.,...,.,.EEX----------
------------------------------------------------------X.....X-------XXX.,.,.>....>.....,..,,,,,,,,,,,,,,,,,...........,.XXXXXXXXXXXXXXXXXX......X-----XXXXXXEXXXXXXXXXXXXX,,,,..E.XXXXXXXXX,XXXXXXXXXXX,XXXXXXXXXXX----------
----------------------------------------------------XX..E.EX--------XH,.,.,>.....>......,..,.........,HW..............,.,...A..A..A..AtTX-X...E..X---------XHX-X--X-----XX..,,....X-------XAX---------X.X--------------------
---------------------------------------------------XH..E.E.X--------XXX.,.,.>....>.....,..,,,,,,,,,,,,,,,,,...........,.XXXXXXXXXXXXXXXXX--X.....X---------XXX-X--XX---XXX,,,,....X-------XAX-------XXXEXXX------------------
---------------------------------------------------X......X-----------X..,.,.>...>.....,..,................,,,,,,,,...,.X-------------------X.....X-----------X.X-XAX--XXX.E....E.X-------X.X-------XE,.,HX------------------
---------------------------------------------------XXXXXXX-------------X..,.,.>..>....,..,.....A..A.A..............,,,,.X-------------------X......X----------X.X-X..XX.XX....E...X-------X.X-------XXXXXXX------------------
------------------------------------------------------------------------X..,,,,>..>..,...,.A..................A..A.A...X---------------------X......X--------X.AXX....X..,......E.X-------X.X--------------------------------
-------------------------------------------------------------------------X...,.,>.>.,....,.........E.................XXX----------------------X..H..X--------X.E.X....E..,.E......X-------X.X--------------------------------
--------------------------------------------------------------------------X...,.,>>.,...,........................XXXX-------------------------X......X-------X...X.X.....,...E....X-------X.X--------------------------------
---------------------------------------------------------------------------X...,.,>,....,....E.....E.E...E....XXX------------------------------X......X-----X-X..E.XX..E.,........X-------X,X--------------------------------
----------------------------------------------------------------------------XX.A,.,..E..,..A..................X---------------------------------X.....X-----X-XX...XX....,.:..E.,,XXXXXXXXX,XXXXXXXXXXX----------------------
------------------------------------------------------------------------------X..,.....,...............E.....X-----------------------------------X.....X----X-XX...X-X..XX......,.+.......,,......A.A.+----------------------
-------------------------------------------------------------------------------X..A,...,........E...E........X-----------------------------------X......X--X.X--X.X---X.XX....XXX,XXXXXXXXXXXXXXXXXXXXX----------------------
--------------------------------------------------------------------------------X...,..,...A................X-------------------------------------X......X-XEX---XX----XXXXXXtX-X,X------------------------------------------
---------------------------------------------------------------------------------X...,,.....................X--------------------------------------X.....XX..X---XX----XX---X.X-XEX------------------------------------------
----------------------------------------------------------------------------------X.A.,........A.A.A.....H.X----------------------------------------X.....X..X----X-----X---XXX-X.X------------------------------------------
-----------------------------------------------------------------------------------X.......................X----------------------------------------X......E.X------------------XHX------------------------------------------
------------------------------------------------------------------------------------XXXXXXXXXXXXXXXXXXXXXXX------------------------------------------X.......X------------------XXX------------------------------------------
------------------------------------------------------------------------------------------------------------------------------------------------------X.....X----------------------------------------------------------------
-------------------------------------------------------------------------------------------------------------------------------------------------------X....X----------------------------------------------------------------
-------------------------------------------------------------------------------------------------------------------------------------------------------X..A.X----------------------------------------------------------------
--------------------------------------------------------------------------------------------------------------------------------------------------------X...X----------------------------------------------------------------
---------------------------------------------------------------------------------------------------------------------------------------------------------X..X----------------------------------------------------------------
----------------------------------------------------------------------------------------------------------------------------------------------------------XX-----------------------------------------------------------------
----------------------------------------------------------------------------------------------------------------------------------------------------------XX-----------------------------------------------------------------
-----------------------------------------------------------------------------------------------------------------------------------------------------------X-----------------------------------------------------------------
-----------------------------------------------------------------------------------------------------------------------------------------------------------------------------------------------------------------------------
