---------------------------------------------X-----------------------------------------------------
-------------------------------------------XX,XX---------------------------------------------------
-----------------------------------------XX,,.,.X--------------------------------------------------
------------------------------------XXXXX.,,,<,,.XXXXXX--------------------------------------------
------------------------------------X.................X--------------------------------------------
------------------------------------X.,,,.........,,,.X--------------------------------------------
------------------------------------X.,.,.........,.,.X--------------------------------------------
------------------------------------X.,,,.........,,,.X--------------------------------------------
-----------------------------------X...................X-------------------------------------------
-----------------------------------X,..W...........W..,X-------------------------------------------
----------------------------------X,,........A........,.X------------------------------------------
----------------------------------X,,.......ttt.......,,X------------------------------------------
---------------------------------X,<,......At.tH......,<.X-----------------------------------------
----------------------------------X,,.......ttt.......,,X------------------------------------------
----------------------------------X.,........:........,.X------------------------------------------
-----------------------------------X...W...........W...X-------------------------------------------
------------------------------------X.................X--------------------------------------------
------------------------------------X.,,,.........,,,.X--------------------------------------------
------------------------------------X.,.,.........,.,.X--------------------------------------------
------------------------------------X.,,,.........,,,.X--------------------------------------------
------------------------------------X.................X--------------------------------------------
------------------------------------XXXXX.,,,<,,.XXXXXX--------------------------------------------
-----------------------------------------XX.,,,.X--------------------------------------------------
-------------------------------------------XX.XX---------------------------------------------------
---------------------------------------------X-----------------------------------------------------
---------------------------------------------------------------------------------------------------
---------------------------------------------------------------------------------------------------
---------------------------------------------------------------------------------------------------
---------------------------------------------------------------------------------------------------
---------------------------------------------------------------------------------------------------
---------------------------------------------------------------------------------------------------
---------------------------------------------------------------------------------------------------
---------------------------------------------------------------------------------------------------
XXXXXXXXXXXXXXXXXXXXXXXXXXXXXXXXXXXXXXXXXXXXXXX---XXXXXXXXXXXXXXXXXXXXXXXXXXXXXXXXXXXXXXXXXXXXXXXXX
X,,,,,,,,.,,,,,,,,,.,A.H.A,.,,,,,,,,,.,,,,,,,,X---XE....H...............,...,....................EX
X,,,,,,,,,,.......,,,.....,,,.......,,,,,,,,,,X---X.,,,,,,,,,,,,,,,,,,,,,.T.,,,,,,,,,,,,,,,,,,,,,.X
X,,H....,.,........,,.....,,........,.,....H,,X---X.,,,,,,.............,,...,,.............,,,,,,.X
X,,.....,.,.....T..,,.....,,..T.....,.,.....,,X---XA,,.................,,.E.,,.................,,AX
X,,..E..,.,........,,.....,,........,.,..E..,,X---X.,,........,,,,.....,,...,,......,,,........,,.X
X,,.....,,,,,,,,,,,,,.....,,,,,,,,,,,,,.....,,X---X.,,..ttt...,...,,,,,,,...,,,,,,,,..,...ttt..,,.X
X,,....A,.,.........,.....,.........,.,.....,,X---X.,,..t.t...,...,....,,...,,....,...,...t.t..,,.X
X,,,,,,,,,,.........,.....,.........,,,,,,,,,,X---XE,...ttt...,.E.,....,,...,,....,.E.,...ttt...,.X
X.,...,.,...........,.....,...........,.,...,.X---X.,.........,...,....,,,,,,,.:..,...,.........,.X
X,,,,,,,,...........,.....,...........,,,,,,,,X---X.,.........,...,,,,,,,,,,,,,,,,,...,.........,.X
X,....,....,,,......,..T..,.....,,,.....,....,X---X.,.........,...,.....,...,.....,...,.........,.X
X,....,....,H,......,.....,.....,H,.....,....,X---X.,.....,,,.,...,.....,...,.....,...,.,,,.....,.X
X,..E.,....,,,......,.....,.....,,,.....,.E..,X---X.,.....,.,.,...,.....,...,.....,...,.,.,.....,.X
X,....,.......,,,,,,,,,,,,,,,,,,,.......,....,X---X.,.,,,,,,,,,...,.....,.A.,.....,...,,,,,,,,,.,.X
X,....,.......,.................,.......,.A..,X---X.,.,A.H..,.,...,....,,...,,....,...,.,..H..,.,.X
X,,,,,,,,.....,.................,.....,,,,,,,,X---X.,.,.....,,,,,,,,,,,,,,,,,,,,,,,,,,,,,.....,.,.X
X.,...,.,.....,....A...A...A....,.....,.,...,.X---X.,.,.....,.,.,...................,.,.,..E..,.,.X
X,,,,,,,,.....,...,,,,,,,,,,,...,.....,,,,,,,,X---X.,.,.....,.,.,...E...............,.,.,.....,.,.X
X,,.....,.....,...,.,.....,.,...,.....,.....,,X---XE,.,.....,.,.,................E..,.,.,....A,.,EX
X,,.....,.....,...,,,,,,,,,,,...,.....,.....,,X---X.,.,.....,,,,,,,,,,,,,,,,,,,,,,,,,,,,,.....,.,.X
X,,H.E..,.....,...,.,..T..,.,...,.....,..E.H,,X---X.,.,.E...,.,........,,,,,,,........,.,A....,.,.X
X,,.....,.....,...,.,.....,.,...,.....,.....,,X---X.,.,...,,,,,...,,,...,...,.....,,,.,,,,,...,.,.X
X,,.....,.....,...,.,..:..,.,...,.....,.....,,X---X.,.,...,.......,H,...,...,.....,H,.....,...,.,.X
X,,,,,,,,.ttt.,...,.,.,,,.,.,...,.ttt.,,,,,,,,X---X.,.,...,.......,,,.,,,...,,,...,,,.....,...,.,.X
X.,...,.,.t.t.,...,.,.,.,.,.,...,.t.t.,.,...,.X---X.,.,...,...........,.,.W.,.,...........,...,.,.X
X,,,,,,,,.ttt.,...,.,.,,,.,.,...,.ttt.,,,,,,,,X---X.,.,...,.,,,,,,,,,,,,,...,,,,,,,,,,,,,.,...,.,.X
X,....,.......,...,.,.....,.,...,.......,....,X---X.,.,...,.,...,...,.,.,...,.,.,...,.E.,.,...,.,.X
X,....,.......,...,,,,,,,,,,,...,.......,....,X---X.,.,...,.,...,...,.,.,...,.,.,...,...,.,...,.,.X
X,..E.,.......,...,.,.....,.,...,.......,.E..,X---X.,.,...,.,...,...,.,.,...,.,.,...,...,.,...,.,.X
X,....,.......,...,,,,,,,,,,,...,.......,....,X---X.,.,...,.,...,,,,,,,,,.E.,,,,,,,,,...,.,...,.,.X
X,....,.......,........E........,.......,....,X---X.,.,...,.,...,.....,.,...,.,.....,...,.,...,.,.X
X,,,,,,,,.....,.................,.....,,,,,,,,X---X.,.,A..,,,...,.....,,,...,,,.,,,.,...,,,.E.,.,.X
X.,...,.,.....,........E........,.....,.,...,.X---XE,.,...,.,...,.......,...,...,.,.,...,.,...,.,.X
X,,,,,,,,.....,,,,,,,,,,,,,,,,,,,.....,,,,,,,,X---X.,.,...,.,...,.,,,,,,,,,,,,,,,,,.,.W.,.,...,.,.X
X,,,....,..,,,....E.,.....,E....,,,...,.....,,X---X.,.,A..,.,...,.,:..............,.,...,.,...,.,.X
X,,,....,..,H,......,..E..,.....,H,...,..E..,,X---X.,.,...,,,...,.,.......T.......,.,...,,,...,.,.X
X,,,A.E.,..,,,......,.....,.....,,,...,.....,,X---X.,.,...,,..T.,.,...............,.,....,,...,.,.X
X,,,....,...........,..W..,...........,...tt,,X---X.,.,...,,....,.,,,,,,,,,,,,,,,,,.,.T..,,...,.,.X
X,,,....,...........,.....,...........,..Ht.,,X---X.,.,...,,....,.,...,.,.,.,.,...,.,....,,...,.,.X
X,,,,,,,,...........,..A..,...........,,,,t,,,X---X.,.,..E,,.:..,,,...,,,,,,,,,...,,,....,,...,.,.X
X.,.,..............,,,,,,,,,,.............,.,.X---X.,.,...,,....,.,....,,...,,....,.,....,,...,.,.X
X.,,,.........,,,,,..........,,,,.........,,,.X---X.,,,...,,,,,,,,,....,,...,,....,,,,,,,,,...,,,.X
X.............,.,......W......,.,.............X---X.,.,...,,....,.,....,,...,,....,.,....,,...,.,.X
X.............,,,.....,,,.....,,,.............X---XK,.,H..,,..H.,.,...H,,.K.,,H...,.,.H..,,..K,.,AX
X.............,.......,.,.......,.............X---X.,.,...,,....,.,....,,...,,....,.,....,,...,.,.X
X.............,.......,,,.......,.............X---X.,,,...,,,,,,,,,....,,.E.,,....,,,,,,,,,..A,,,.X
X.............,.................,.............X---X.,.,...,,....,.,....,,...,,....,.,..:.,,...,.,.X
X.............,,,.............,,,.............X---X.,.,...,,....,,,...,,,,,,,,,...,,,....,,...,.,.X
X.............,.,,,,,,,,,,,,..,.,.............X---X.,.,...,,..E.,.,...,.,.,.,.,...,.,....,,...,.,.X
X.............,,,,,,,,,,,,,,,,,,,.............X---X.,.,.E.,,....,.,,,,,,,,,,,,,,,,,.,....,,...,.,.X
X.................,:,E...E,:,.................X---X.,.,...,,....,.,.......H.......,.,....,,...,.,EX
X...,,,,,,,.......,,,.....,,,.......,,,,,,,...X---XE,.,...,,,...,.,...............,.,.T.,,,...,.,.X
X...,,,,,,,.........,.....,.........,,,,,,,...X---X.,.,...,.,...,.,...............,.,...,.,...,.,.X
X...,,..,,,.........,.....,.........,,..,,,...X---X.,.,...,.,.T.,.,,,,,,,,,,,,,,,,,.,...,.,...,.,.X
X...,,.E,,,.........,.....,.........,,.E,,,...X---X.,.,...,.,...,.,.,...,...,.......,...,.,.E.,.,.X
X...,,,,,,,.........,.....,.........,,,,,,,...X---X.,.,E..,,,...,.,,,...,...,.......,...,,,...,.,.X
X...,,,,,,,.........,..A..,.........,,,,,,,...X---X.,.,...,.,...,......,,...,,......,...,.,...,.,.X
X...,,,,,,,.........,.....,.........,,,,,,,...X---X.,.,...,.,...,,,,,,,,,.E.,,,,,,,,,...,.,...,H,.X
X...................,.....,...................X---X.,.,...,.,...,...,.,.,...,.,.,...,...,.,...,.,.X
X.................,,,.....,,,.................X---X.,.,...,.,...,...,.,.,...,.,.,...,...,.,...,.,.X
X.................,:,.....,:,.................X---X.,.,...,.,:..,...,.,.,.W.,.,.,...,...,.,..A,.,.X
X.......,,,,,,,,,,,,,,,,,,,,,,,,,,,,,,,.......X---X.,.,...,.,,,,,,,,,,,,,...,,,,,,,,,,,,,.,...,.,.X
X.......,.,......,,,,,,,,,,,........,.,.......X---X.,.,...,............,,...,,............,...,.,.X
X.......,,,.,,,,,,,,,,,,,,,,,,,,,,,.,,,.......X---X.,.,...,.......,,,...,...,.....,,,.....,...,.,.X
X.......,...,E..................E.,...,.......X---X.,.,...,.......,H,...,...,.....,H,.....,...,.,.X
X.......,...,,,,,,,,,,,,,,,,,,,,,,,...,.......X---X.,.,...,,,,,...,,,.,,,...,,,...,,,.,,,,,...,.,.X
X.......,...,...,.,.........,.,...,...,.......X---X.,.,....B,.,.......,.,,,,,.,.......,.,B..E.,.,.X
X.......,...,...,,,.E.,,,.E.,,,...,...,.......X---X.,.,.....,,,,,,,,,,,,,,,,,,,,,,,,,,,,,.....,.,.X
X.......,...,...,.,...,.,...,.,...,...,.......X---X.,.,.....,.,.,...................,.,.,.....,.,.X
X.......,...,...,:,...,,,...,:,...,...,.......X---X.,.,.....,.,.,...................,.,.,.....,.,.X
X.......,...,...,.,....A....,.,...,...,.......X---X.,.,.....,.,.,...................,.,.,.....,.,.X
X.......,...,...,,,.........,,,...,...,.......X---X.,.,.....,,,,,,,,,,,,,,,,,,,,,,,,,,,,,...A.,.,.X
X.......,...,...,.,.........,.,...,...,.......X---X.,.,A...A,.,...,...,.,.E.,.,...,...,.,.....,.,.X
X.......,...,...,,,.,,,,,,,.,,,...,...,.......X---X.,.,,,,,,,,,.E.,...,,,...,,,...,.E.,,,,,,,,,.,.X
X.......,...,...,.,.,.....,.,.,...,...,.......X---X.,.....,.,.,...,.....,,,,,.....,...,.,.,.....,.X
X.......,...,...,:,.,.ttt.,.,:,...,...,.......X---X.,.....,,,.,..,,.....,...,.....,,..,.,,,.....,.X
X.......,...,...,.,.,.t.t.,.,.,...,...,.......X---X.,,........,..,,..E.,,LLL,,.E..,,..,........,,.X
X.......,,,.,...,,,.,.ttt.,.,,,...,.,,,.......X---X.,,ttt.....,..,,....,,LLLL,....,,..,.....ttt,,.X
X.......,.,.,...,.,.,..H..,.,.,...,.,.,.......X---X.,,t.t.....,...,.....,.A.,.....,...,.....t.t,,.X
XXXXXXXXXXXXXXXXXXXXXXXXXXXXXXXXXXXXXXXXXXXXXXX---X.,,ttt.....,.A.,....,,LLL,,....,.H.,.....ttt,,.X
--------------------------------------------------X.,,,,,,....,...,....,,LLLL,....,...,....,,,,,,.X
--------------------------------------------------X.,,,,,,,,,,,,,,,,,,,,,.H.,,,,,,,,,,,,,,,,,,,,,.X
--------------------------------------------------XE.A.................,B..B,,...................EX
--------------------------------------------------XXXXXXXXXXXXXXXXXXXXXXXLLLXXXXXXXXXXXXXXXXXXXXXXX
-----------------------------------------------------------------XXXXXXXXLLLXXXXXXXX---------------
-----------------------------------------------------------------XE.....BBBBB....E.X---------------
-----------------------------------------------------------------X.................X---------------
-----------------------------------------------------------------X.................X---------------
-----------------------------------------------------------------X.................X---------------
-----------------------------------------------------------------X.................X---------------
-----------------------------------------------------------------XE.E.E.E.E.E.E.E.EX---------------
-----------------------------------------------------------------X.................X---------------
-----------------------------------------------------------------X,,,,,,,,,,,,,,,,,X---------------
-----------------------------------------------------------------X.................X---------------
----------------------------------------------------------------X...................X--------------
----------------------------------------------------------------X...................X--------------
----------------------------------------------------------------X..,,...........,,..X--------------
---------------------------------------------------------------X..,..,.........,..,..X-------------
---------------------------------------------------------------X..,..,.........,..,..X-------------
---------------------------------------------------------------X..,..,.........,..,..X-------------
--------------------------------------------------------------X....,,...........,,....X------------
--------------------------------------------------------------X..........,,,..........X------------
--------------------------------------------------------------X.......,,,.,.,,,.......X------------
--------------------------------------------------------------X.....,,....,....,,.....X------------
--------------------------------------------------------------X.....,...,,.,,...,.....X------------
--------------------------------------------------------------X....,..,,.....,,..,....X------------
--------------------------------------------------------------X....,.,...,>>...,.,....X------------
--------------------------------------------------------------X...,..,..,...,..,..,...X------------
--------------------------------------------------------------X...,..,..,...,..,..,...X------------
---------------------------------------------------------------X.,...,.,.....,.,...,.X-------------
---------------------------------------------------------------X.,...,.,.....,.,...,.X-------------
----------------------------------------------------------------X...,...,,..,...,...X--------------
-----------------------------------------------------------------X..,.....,,....,..X---------------
------------------------------------------------------------------X.,...........,.X----------------
-------------------------------------------------------------------X,...........,X-----------------
--------------------------------------------------------------------XX..........X------------------
----------------------------------------------------------------------XX......XX-------------------
------------------------------------------------------------------------XXXXXX---------------------
