--------------------------------------------------XXXXXX--------------------
------------------------------------------------XX...,.,XX------------------
--------------------------------XXXXXX---XXXX--X:.,,..,,.X------------------
--------------------------------X.....XXX....XX.....,.,,,X------------------
-------------------------------X.......,..A...,......,,,,XXXXXXXXX----------
-------------------------------X......,.......,.......,,,.,.,,...X----------
------------------------------X.H.....,.E.E..,..E.....,.,,,.,,.H.X----------
-----------------------------XX.......,......,.......A.,,,..XX...X----------
-----------------------------X:,,......,....,,.......,,.,XXXXX,,XX----------
----------------------------X....,...,,,,,,,..,......,,,.X---X...X----------
----------------------------X:.WE.,,,.....,....,,,,,,..XX----X.,,X----------
----------------------------X.A...,......,....,....,....X----X.,,X--------X-
---------XXXXXXXXXXXXXXXX----X.....,.....,....,....,..:..X---X,,.:-----XXX-X
---------X......AE..E....X---X,,,,,,.....,....,.....,...X----X,,,X-----X,,X-
---------XXXXXXX.XXX+XXX.X---XH.....,....,,..,,.....,,,X-----X.,,X-----X,:,X
--------X.X----X.X-XHX-X.X---X....A.,,..,..,,.,....,....X----X.,,X-----X,,,X
--------XEX----X.XXXXXXX,XAX-X.......,,:,..,.,,,..,.....:X---X,,XX-----X,EXX
------XHX,XXA--X.XX,.,A....X-X...<....,,...,...,,,........X--X,,XX-----X,,XX
-----XH.....XA-X.XX,.,,,.:.XXX........,,..,.E..,.,.......X---X.E.X-----XHE.X
-----X.....:.X-X.XX,.,,,...,.,.<.T.<.W,,,,,...,...,.,,,,X----X...XXXXXXX...X
-----X,,.....X-X.XX,,,..E..XXX........,,,.E...,.H.,,.....X---X....,..,,....X
-----X.,,,...X-X.XX,,..W...X-X...<....,,..,...,..,......,X---X....,..,,..E.X
--XAXX,,.,,.EX-X.XXH....,A,X-X.......,,...,...,,.,.....,..X--X....X..XX....X
>X..XX..,E,,,X-X.XX..E.H,,,X-XH...:..,,,,..,,,..,......,..X--X...XX,XXXX...X
>,EA,L...W..,X:X.XX....,,,,X-X,,,,,,,....,,,....,.....,.W,,X-XE..XXAX--X...X
>,..XX.E....,XXX.XX:...,,,,X-X,....,......,.....,.....,.,.:X-X,,XXXAX--X,,XX
-X.HXX..,,,,,X-X.XXXX,XXXXXX-X,.A..,......,.....,......,A..X-X...XX,X--X...X
--XXXX,,,,,..X-X.X--X.X-----X.,A....,....,......,.....,,.E.X-X.,,XX,X--X,..X
-----XE,,,..,X-X..XX..X-----X.,.....,.....,,,,,,.,..,,..,..X-X.,,XXHX--X,,.X
-----X,,..,,.,X-XE.A.XX-----X:,..E...,...,....,..,.,....,,.X-X,,.:X.X-X:,W,X
-----XA...,,,.HX--XXX--------X,.......,..,...,....,...:...,X-X,,,XX,X--X,,.X
-----XXAE,.,,,.,X-------------X,..E....,,,...,,...,........X-X.,,XXAX--X,,.X
------XXXXH.,,,.HX------------X.,....,,..,,,,..,E.,........X-X.,,XXAXXXX,..X
----------X,.,,,.,X----------X..,..,,......,....,,.........X-X,,XXX.t.XX,,XX
-----------XH.,,,.HX---------XE.,,,,:...,,,,,.E.,,.......:X--X,,XX-XXXXX,,XX
------------X,.,,,.,X------XX.,,.,..,,,,.....,,,..,.......X--X...X-XH--X...X
-------------XH.,,,.XX--XXX...,.:.,...,.......,...,.......X--X...XXXXXXX...X
--------------X,.,.,..XX..X...,...,...,......,.....,.....X---X....,..,,....X
---------------X,..,...,..,,,.,...,..,........,.....,....X---X.A..,..,,.E..X
----------------XX,...,...,..,,..,.,,,....E...,.....,...X----X....X..XX....X
-----------------X...,.,.,.....,,....,...:.....,,,,,,,,.,X---X...XXXXXXXXXX-
------------------XX,,,,,,.....,...,,,.......,,...,....,..X--X...X----------
-------------------X...,.,..A..,..,..,..E...,....,.....,.X---X,,XX----------
-------------------X..,...,....,,,...,......,...,,....,,.X---X.,,X----------
--------------XXXXXXX,,,..,....,,....,....,,,.,,.,...,..,XXXXX,,,X----------
-------------XX.....,.,,...,,.,..,...,,,,,,..,..A.,,,...,,..,,...X----------
-------------HX..:EW,,,,,,,,.,...,.,,...,....,....,.,...,,.E,,...X----------
--------------X:....,,,.,..,.,..E.,.....,....,..H..,....,,..,,...X----------
--------------X..,XXX,..,,.,,,....,.....,.....,...,...E.,XXXXX,,.X----------
--------------X,,,X-X.,,..,.,,..,,,,,.,,,.E...,.A,,.....,X---X.,,X----------
--------------X,,XX-X.A.,,...,,,.....,..,.....,,,..,,..,.X---X,,XX----------
--------------X,,XXX:...,..E...,.....,..,...,,..,....,,...X--X,,XX----------
--------------X...XX..:.,.....,...,,,...,...,...,.....,.A.X--X..HX----------
--------------XE..X-XX..,.....X...,.,....,.,....,...E.,...X--X...X----------
--------------X...X---XXXX...X-X:,...,,,,,,.,...,.....,.:.X--X...X----------
--------------X...X-------XXX---XX...,,H,,..,....XX...,H.X---X...X----------
--------------X...X--------------X...,,,,,...,..X--XXXXXX----X...X----------
--------------X.E.X---------------XXXX,,,XX..XXX-------------X...X----------
--------------X...X------------------X.W.X-XX----------------X...X----------
--------------X,,XXXXXXXXXXXXXXXXXXXXX,,,XXXXXXXXXXXXXXXXXXXXX,,XX----------
--------------X...,...,...,,......H,.,...,.,,.......,...,...,,E..X----------
--------------X.A.,..,,,,.,,....E..,,,...,,,,...A...,..E,,,.,,.W.X----------
--------------XE..,.,,,,,,,,.E.....,,,.:..,,,.......,.,,,E,,,,..:X----------
--------------XXXXXXXX:XXXXXXXXXXXXXXXXXXXXXXXXXXXXXXXXX:XXXXXXXXX----------
----------------------X---------------------------------X-------------------
