-------------------------------------------------XXXXXXXXXXXXXXXXXXX-------------------------------------------------
-------------------------------------------------X..,...,..,...,...XXXXXXXXXX----------------------------------------
-----------------------------------------XXXX----X.E,.E.,.E,.E.,.E.X........X----------------------------------------
-----------------------------------------Xt.X----X..,...,..,...,...X.E..E.E.X----------------------------------------
-----------------------------------------X..X----Xtt,ttt,ttttttttttX........X----------------------------------------
-----------------------------------------X.X-----X.................X.E..E.E.X----------------------------------------
-----------------------------------------X.X-----XXXXXXXXXXXXXXXXXXX........X----------------------------------------
-----------------------------------------X.X-----------------------XX,,,,,,,X----------------------------------------
-------XXXXXXXXXXXXXXXXXXXXXXXXXXXXXXXXXXX,XXXXXXXXXXXXXXXXXXXXXXXXX,,,,,,,,XXXXXXXXXX-------------------------------
-------X,,,,,,,,,,,,,,,,,,,,,,,,,,,,,,,,,,,,,,,,,,,,,,,,,,,,,,,,,,,,,,,,,,,,,,,,,,,,,X-------------------------------
-------X,................................,,,........................................,X-------------------------------
-------X,................................,.,........................................,X-------------------------------
-------X,................................,,,........................................,X-------------------------------
-------X,...........................................................................,X-------------------------------
-------X,...................................,,,.....................................,X-------------------------------
-------X,...................................,.,.....................................,X-------------------------------
-------X,...................................,,,.....................................,X-------------------------------
--XXXXXX,...........................................................................,X-------------------------------
--X<A.,,,.....................................,,,...................................,X-------------------------------
--X...,,,.....................................,.,...................................,X-------------------------------
--X<A.,,,.....................................,,,...................................,X-------------------------------
--X...,,,..................XXX...........XXXX..........................XXXXXX.......,X-------------------------------
--X<:.,,,..................XXX,,,,,,,,,,,XXXX,...,,,,,,,,,....XX.......XXXXXX.......,X-------------------------------
--X...,,,.........,,,.....,.,.................,..,:AWWA.H,....XX..,,,..XAAXXX.......,X-------------------------------
--X<A.,,,.........,.,,,,,,..,..............TW.XX,,,,,,,,,,,,,,XX,,,.,...,E.XX.......,X-------------------------------
--X...,,,.........,,,.....,.,...H....H.....W.:XX..............,,..,,,...,..XX.......,X-------------------------------
--X...,,,..........,.......XXX.XXXX.XXXX.XXXXXXX..............,,.H.,.....,XXX.......,X-------------------------------
--X,,.,,,..........,.......XXX,XXXX,XXXX,XXXXXXX..............,,.A.,.......XX.......,XXXXXXXXX-----------------------
--X.W,X,,..........,..........................................L,..W,...,,,,,,..,,,,.,,..,,,,..X----------------------
--X,,XXX,..........,..........................................XX...,...,....,..,H.,.,,..,,,,..X----------------------
--Xt.X-X,..........,..........................................XXt:W,...,,,,,,..,,,,.,,..XXL,..X----------------------
--XXXX-X,..........,..........................................XX.X.,...,,,,,,.......,XXXXXXXX,X----------------------
-------X,..........,.........................................XXXXXXXXXXX....,.......,X-----XX,X----------------------
-------X,..........,.........................................XXXXXXXXXXX....,.......,X-----X..X----------------------
-------X,..........,...........XXX,,,,,,,,,,,,,,,,,,,,,XXX....XX,,,,...,..E.,.......,X----XX..XXXXXXXXXXXXXXXXXXXXXX-
-------X,........XXXLLXX.......X-X..........A..........X-X....XX,:,,...,....,.......,X----X,...,,....t.............X-
-------X,........XXX,,XX.......XXX,,,,A,,,,,,,,,,,A,,,,XXX......W..,...,,,,,,.......,X----XW.,,,,....t,,,,,,,,,,,,AX-
-------X,..........,..XX.......,.,.....................,.,.........,................,X----X..,.,,.E..t,E....E...E,AX-
-------X,..........,.WXX.......,.,.......A.....A.......,.,.........,................,X----XX.,,,,....t,..........,.X-
-------X,.......,,,,W.XX.......,.,..........A..........,.,.....E...,................,X-----XX..,,....t,..........,.XX
-XXXXXX.,....XXXE..,.:XX.......,.,.....................,.,..E......,................,X-----XX..,,....t,,,,,,,,,,,,.,X
-X...X,.,....XXX.H.,AXXX.......,.A....A...........A....A.,.........,................,X-----X...,,....t,..........,.XX
>,...,,.,...,.XX.E.,.XXX.......,.,.....................,.,.........,................,X-----X.,,,,.E..t,E....E...E,.X-
>....,,.,...,.XKXX.XX-XXX......,.,..........A.......A..,.,.......E.,,,,,,,..........,X-----X.,.,,....t,..........,.X-
X....,,.,...,.XXXXXXXXXXX......,.,A..............T.....,.,...E.....,,,,,,,..........,X-----X.,,,,....t,,,,,,,,,,,,.X-
X,...,,.,....,...XX,..XX.......,.,........,,,,,........,.,.........,....,,..........,X-----X...XX...XX...XX...XX...X-
-XX,XXX.,.....,,,..,,,XX.......,.,........,,,,,........,.,.....E...,....,,..........,XXXXXXX..XXXXXXXXXXXXXXXXXXXXXX-
-XX.X--X,..........,,,XX.......,A,..A...A.,,T,,.A...A..,A,.........,....,,,.........,,...t.X,,X----------------------
-X..X--X,........XXX..XX.......,.,........,,,,,........,.,.........,....,A,.........,XXX..XX,,X----------------------
-X..X--X,........XXX:WXX.......,.,........,,,,,........,.,...E..E..,....,H,.........,X--X,XX,,X----------------------
-XX,X--X,..........,H.XX.......,.,..........W.......A..,.,.........,....,,,.........,X-X..XX,,X----------------------
-X...XXX,..........,...........,.,.A........A..........,.,.........,................,X-X..,,,,X----------------------
-Xt....,,..........,...........,.,.....................,.,.........,................,X-X..,,,.X----------------------
-XXXXXXX,..........,...........,.A....A...........A....A.,..E......,................,X--XXXXXX-----------------------
-------X,..........,...........,.,.....................,.,.....E...,................,X-------------------------------
-------X,.........,............,.,......A...A..A.......,.,.........,................,X-------------------------------
-------X,........,.............,.,.....................,.,...E.....,................,X-------------------------------
-------X,.......,..............,.,.....................,.,.........,................,X-------------------------------
-------X,.......,.,,,..,,..,,..XXX,,,,A,,,,,,,,,,,A,,,,XXX.........,................,X-------------------------------
-------X,.......,,,.,..,,..H,..X-X.......T..A..........X-X.........,................,X-------------------------------
-------X,.......,,,,,..,,..,,..XXX,,,,,,,,,,,,,,,,,,,,,XXX..XXXXX..,................,X-------------------------------
-------X,.......,,,.....................................,,,XXXXXX,,,................,X-------------------------------
-------X,.......,,,.....................................,E.EX-XX,,,,,...............,X-------------------------------
-------X,.......,,,.....................................XXH.XX.......,,.............,X-------------------------------
-------X,.......,,,....................................XXXXXXXE........,,...........,X-------------------------------
-------X,.......,,,....................................XXAEXX............,..........,X-------------------------------
-------X,.......,,,.,,.................................XX..,,.:..........,..........,X-------------------------------
-------X,.......,,,.,,.................................XXEE,,W...........,..........,X-------------------------------
-------X,.......,..................XX..................XX,,,,.W..........,..........,X-------------------------------
-------X,.......,..............XXXXXXXXXX..............XX................,..........,X-------------------------------
-------X,........,.............XXXXXXXXXX.............,..................,..........,X-------------------------------
-------X,.........,,,..........WW:XXX.:WW............,............,,,....,..........,X-------------------------------
-------X,.........,.,,,,,,,,,,,,,,XXX,,,,,,,,,,,,,,,,.............,.,....,..........,X-------------------------------
-------X,.........,,,.H....,......,W,...............,.............,,,..,,.,.........,X-------------------------------
-------X,............,.H.T.,......,,,...............,....,,,,,,......,,,,..,........,X-------------------------------
-------X,.............,....,........................,....X,,,XX....,,..,W..,........,X-------------------------------
-------X,..............,,,,,........................,,,,XXXE,XX,,,,....H.A.,........,X-------------------------------
-------X,...............................................XXX..XX....,.......,........,X-------------------------------
-------X,...............................................XXEE.EX.....,,,,,,,,........,X-------------------------------
-------X,...............................................XXXKXXX.....................,X-------------------------------
-------X,...............................................X-XXX-X.....................,X-------------------------------
-------X,...............................................XXXXXXX.....................,X-------------------------------
-------X,...........................................................................,X-------------------------------
-------X,...........................................................................,X-------------------------------
-------X,...........................................................................,X-------------------------------
-------X,...........................................................................,X-------------------------------
-------X,...........................................................................,X-------------------------------
-------X,...........................................................................,X-------------------------------
-------X,...........................................................................,X-------------------------------
-------X,,,,,,,,,,,,,,,,,,,,,,,,,,,,,,,,,,,,,,,,,,,,,,,,,,,,,,,,,,,,,,,,,,,,,,,,,,,,,X-------------------------------
-------XXXXXXXX,,,,,,,,,,,,XXXXXXXXXXX,XXXXXXXXXXXXXXXXXXXXXXXXXXXXXXXXXXXXXXXXXXXXXXX-------------------------------
--------------X,,,,,,,,,,,,XX--------X.X-----------------------------------------------------------------------------
--------------X.E.E..E.E..E.X--------X.X-----------------------------------------------------------------------------
--------------X.............X-------X-XX-----------------------------------------------------------------------------
--------------X.............X-------X-XX-----------------------------------------------------------------------------
--------------X.E.E..E.E..E.X-------XX-X-----------------------------------------------------------------------------
--------------X.............X-------XXXX-----------------------------------------------------------------------------
--------------XXXXXXXXXXXXXXX----------------------------------------------------------------------------------------
