----------------------------------XXXXXXXXXXXXXXXXXXX----------------------------------------------------
----------------------------------X.................X----------------------------------------------------
----------------------------------X.................X----------------------------------------------------
----------------------------------X.................X----------------------------------------------------
----------------------------------X.................X----------------------------------------------------
----------------------------------X.................X----------------------------------------------------
----------------------------------X.....,,,,,,,.....X----------------------------------------------------
----------------------------------X....,.......,....X----------------------------------------------------
----------------------------------X...:.<..<.<.:,...X----------------------------------------------------
----------------------------------X...,.........,...X----------------------------------------------------
----------------------------------X...,....<....,...X----------------------------------------------------
----------------------------------X...:.........,...X----------------------------------------------------
----------------------------------X...,........:,...X----------------------------------------------------
----------------------------------X....,...A...,....X----------------------------------------------------
----------------------------------X.....,,,,,,,.....X----------------------------------------------------
----------------------------------X.......,.,.......X----------------------------------------------------
----------------------------------X.......,,,.......X----------------------------------------------------
----------------------------------X.......,.,.......X----------------------------------------------------
----------------------------------X.......,,,.......X----------------------------------------------------
----------------------------------X.......,.,.......X----------------------------------------------------
----------------------------------X.......,,,.......X----------------------------------------------------
----------------------------------X.......,.,.......X----------------------------------------------------
----------------------------------X.......,,,.......X----------------------------------------------------
----------------------------------X.......,E,.......X----------------------------------------------------
----------------------------------X.......,,,.......X----------------------------------------------------
----------------------------------X.......,.,.......X----------------------------------------------------
----------------------------------X.,,,,,,,,,,,,,,,.X-------------XXXXXXXXXXXXXXXXXXXXXXXXXXXXXXXXXXXXXXX
----------------------------------X,....E..........,X-------------X.....................................X
----------------------------------X...........E.....X-------------X.....................................X
----------------------------------X........E........X-------------X.....................................X
------------------------------XEXXX.................X-------------X.....................................X
------------------------------X.E.,.................X-------------X.....................................X
------------------------------X,XXX.................X-------------X.....................................X
------------------------------X.X-X.................X-------------X...........................,,,,,,,...X
------------------------------X.X-XXXXXXXXXXXXXXX,XXX-------------X.............ttt...........,.....,...X
------------------------------X.X---------------X:X---------------X.............t.t...........,..K..,...X
------------------------------X,XEXXXXXXXXXXXXXXX,XXXXXXXXXXXXXXX-X.............ttt...........,..A..,...X
------------------------------X.........X...,...............,.WAX-X...........................,.....,...X
XXXXXXXXXXXXXXXXXXXXXXX-XXXXX-X.........X.A.,E..,,,........E,...XXX,,,,.......................,..E..,...X
X.....................X-X...X-X..E......X.A.,..,..,.........,...+.+.A.,.......................,.....,...X
X.............,,,,,,,,XXXE..X-X.........X...,,,...,...,,,,,,,.H.XXX...,.......................,,,.,,,...X
X.............,...HH.H+.LA..X-XE........+.........,...,A.AA.....X-X,..,.........................,.,.....X
X.............,.,,,,,,XXX...X-X.........X...,,,,..,...,,,,,,,...X-X.,.,.........................,.,.....X
X.............,.,.....X-X.A.X-X.........X...,...,,,.........,...X-X.,.,.........................,.,.....X
X.............,.,.....X-X..EXXXXX+XXXXXXXXXXXXXXXXXXXXXXXXXXXXXXX-X.,.,.........................,.,.....X
X.............,.,.....X-X..........X------------------------------X.,.,.........................,.,.....X
X.....,,,,,,,,,.,.....X-X..........X------------------------------X.,.,.........................,.,.....X
X.....,.........,.....X-X..........X------------------------------X.,.,.........................,.,.....X
X.....,.........,.....X-X..........X------------------------------X.,.,.........................,.,.....X
X.....,....E....,.....X-X..........X------------------------------X.,.,.........................,.,.....X
X.....,.........,.....X-X.E......E.X------------------------------X.,..,............,,,.........,.,.....X
X.....,.........,.....X-X..........X------------------------------X.,.E,...........,...,.......,E.,.....X
X.....,,,,,,,,,,,.....X-XXXXXXXXXXXX------------------------------X.,...,,,,,,,,,,,..A..,,,,,,,..A,.....X
X.....................X-------------------------------------------X.,A...............T............,.....X
X.....................X-------------------------------------------X.,,,,,,,,,,,,,,......,,,,,,,,,,,.....X
X.....................X-------------------------------------------X...............,....,...........E....X
X.....................X-------------------------------------------X................,,,,.................X
X.....................X-------------------------------------------X.....................................X
X.....................XXXXXXXXXXXXXXXXXXXXXXXXXXXXXXXXXXXXXXXXXXXXX.....................................X
X.....................,.,...,...,...,.........W.:.,A.A.AA.A..A..+.L.....................................X
X.....................XXXXXXXXXXXXXXXXXXXXXXXXXXXXXXXXXXXXXXXXXXXXX.....................................X
X.....................X-------------------------------------------X.....................................X
X.E.................E.X-------------------------------------------XXXXXXXXXXXXXXXXXXXXXXXXXXXXXXXXXXXXXXX
X.....................X----------------------------------------------------------------------------------
XXXXXXXX++XXXXXXXXXXXXX----------------------------------------------------------------------------------
-------X++XXX--------------------------------------------------------------------------------------------
------X.....X--------------------------------------------------------------------------------------------
------X.....X--------------------------------------------------------------------------------------------
------X....X---------------------------------------------------------------------------------------------
-------X..X----------------------------------------------------------------------------------------------
--------X>-----------------------------------------------------------------------------------------------
