-------------------------:XXXXXXXXXXXXXXXX
-------------------------X....:......<..<X
-------------------------X...........,...X
-------------------------X...........<.<.X
-------------------------X...........,,,,X
-------------------------X...............X
-------------------------X...............X
--++++X------------------X...............X
X:X,W,X:X----------------X...............X
X.,...,.X----------------X...............X
X,,...,,X----------------X...............X
X..,,,,.X----------------X...............X
X..,E,,.X----------------X...............X
X.,,H,,.X----------------X.........E.....X
X.,...,.XXXXXXXXXXXXXXXXX,..........::::,X
X.,...,.,+......,,.....,+,..........:,,:,X
X.,...,.XX......X,.....XX,..........:,::,X
X.,...,.XX......X::,:::XX,..........::::,X
X,,..H,EXX....:.XX,,,,,X-X..........,,,,,X
XE,H..,,XX......XX,,,E,X-:..............:X
X,,.,.,.XXH,H,H,XXXXXXXX-XXXXXXXXXXX,XXXXX
X.,,H,,.XX,,,,,,X------------------XHX----
X.,.,.,.XX.E.E,.X------------------X+X----
X.,...,.XXXXXXXXX------------------:.X----
X.,...,.X-------------------------X-X-----
XE,H,H,EX----------------------XXXX-X-----
X,,.,.,,X--------------XXXXXXXX.E..X------
X.,,,,,.XXXXXXXXXXXXXXX.........XXXX------
X...,...,,...E......,,....XXXXXX----------
X..,:,..XXXXXXXXXXX..XXXXX----------------
XXXXXXXXX----------X.X--------------------
--------------------XX--------------------
--------------------EX--------------------
--------------------XX--------------------
--------------------XX--------------------
--------------------EX--------------------
-----------------XXXXXXXX-----------------
-----------------X,....,X-----------------
-----------------X,....,X-----------------
-----------------X.,,,,.X-----------------
-----------------X:E..E:X-----------------
-----------------XXXXXXXX-----------------
