---------------------------------XXXXXXXXXXXXXXXXXXXXXXXXXXXXXXXXXXXXXXXXXXXX-------------------------
---------------------------------X...,,,XH................,,H,............E.X-------------------------
---------------------------------X......,.................,..,..............X-------------------------
---------------------------------X...E..,.................,..,..............X-------------------------
---------------------------------X....H.,..................,..,.....:.......X-------------------------
---------------------------------X....H.,:..E.......:......,..,.............X-------------------------
---------------------------------X....H.,..................,...,............X-------------------------
---------------------------------X......,...................,,..,,..........X-------------------------
---------------------------------X....H,X.....................,...,.........X-------------------------
---------------------------------X...,,.XH.....................,...,........X-------------------------
---------------------------------X.,,...XXX,,,,,XXXX............,,..,.......X-------------------------
---------------------------------X,.....,.,.....,.XX..............,.,.......X-------------------------
---------------------------------X.......,.......,,,........E.....,..,..E...X-------------------------
------------------------------->XLL......,.......,,,...............,.,......X-------------------------
------------------------------->,LL......,.......,,,...............,.,......X-------------------------
-------------------------------XXLL......,.......,XX...............,..,.....X-------------------------
---------------------------------X,.....,.,.....,.XX................,.,.....X-------------------------
---------------------------------X.,,...XXX,,,,,XXXX..........:.....,..,....X-------------------------
---------------------------------X...,,.XH...........................,.,....X-------------------------
---------------------------------X.....,X............................,.,....X-------------------------
---------------------------------X......,............................,.,....X-------------------------
------------------------------XXXX.E..E.,...E.......................E,.,....X-------------------------
------------------------------X.,,......,............................,.,....X-------------------------
------------------------------AE,,......,................E...........,.,....X-------------------------
-----------XHX----------------XXXX......,............................,..,...X-------------------------
-----------X+X-------------------X......,.............................,.,...X-------------------------
XXXXXXXXXXXX,XXXXXXXXXXXXXXX-----X...,,,XH............................,.,:..X-------------------------
X..,W....,..<.........,,....X----X,,,,,,XXXXXXXXXXXXXXXX....A.........,.,...X-------------------------
X..,.....,............,,....X----X......X----X:X--------XXXXXX,,,,XX..,.,...X-------------------------
X..,.....,<.:<........,,.X..XXAXXX,,,,,,XXXXXX,XXXXXXXXXXXXXXX,,,,XX..,.,...X-------------------------
X..,.....,............,,X-X.AXX...........,,,...,,,,,,,,,,,,,......,.E,.,...X-------------------------
X..,.....,..<.........,,X-X..,,...........,,,...,,,,,,,,,,,,,.E....,..,.,...X-------------------------
X..,.....,............,,.X..E,,...........,,,...,,,,,,,,,,,,,.......,.,.,...X--------XXXXXXXXX--------
X..,.....,............,,.....,,...........,,,..XX,,,,,:,,,,,,.......X.,.,...X------XX,A....A.,XX------
X..,.....,............,,.....XX...........,,,..XX,,,,,,,,,,HXX,,,,,,X.,..,..X----XX..,,,,,,,,,..X-----
X..,.....,............,,....XXX:..........,,,...............X.......X..,.,..X---XX+.............:X----
X..,.....,............,,....X-XX..........,,,...............,.......,..,.,..X---X,,+...E........E.XX--
X..,.....,............,,....X-X...........,,,E....:,,,,,,:,.,.......,..,E,..X--X.,,XXX,,,,,,XXX.....X-
X..,.....,............,,....X-X...........,,,.....,,,,,,,,,.,.......,..,.,:.X-X...,XXX,,,,,,XXX....A,X
X..,.....,............,,....XXX...........,,,.....,,.....,,.,.......X..,W,..XX.....XX,,...,,HXX....,.X
X..,.....,....:.......,,....,+,...........,,,.....,,.....,,.,.......XXX,,,XXXX......+,.....,.,,..E.,.X
X..,.....,............,,....,+,...........,,,.....,,.,,,.,,.,.......,.......XX...E..,..,,,..,,,....,.X
X..,.....,............,,....,+,......E....,,,.E...,,.,,,.,,.,.......,.......,L......,..,TW,.,,H.:..,.X
X..,.....,............,,....,+,...........,,,.....,,.,H,.,,.,.E.....,.......,L......,..,.,..,,,....K.X
X..,.....,............,,....,+,...........,,,.....,,.,.,.,,.,.......,.......,L...E..+,..,..,.,,....,.X
X..,.....,............,,....,+,...........,,,.....,,.,,,.,,.,.......XXX,,,XXXX......+,,...,,.,,..E.,.X
X..,.....,............,,....,+,...........,,,.....,,.....,,.,.......X..,H,...X.....XX..,,,..HXX....,.X
X..,.....,............,,....XXX...........,,,.....,,.....,,.,.......,..,.,.E.XX...,XXX,,,,,,XXX....A.X
X..,.....,............,,....X-X...........,,,E....:,,,,,,:,.,.......,..,.,...XX...,XXX,,,,,,XXX....,,X
X..,.....,............,,....X-X...........,,,.....,,,,,,,,,.,.......,..,.,...X-X.,,+...E........E...X-
X..,.....,............,,....X-X:..........,,,...............,.......,..,E,...X--X.,+............:.XX--
X..,.....,............,,....XXXX..........,,,..............HX.......X..,.,...X---X+..............X----
X..,.....,............,,.....XX...........,,,..XX,,,,,:,,,,,XX,,,,,,X..,.,...X----X..,A,,,,,A,..X-----
X..,.....,...:........,,.X...,,...........,,,..XX,,,,,,,,,,,,.......,..,.,...X-----XX,.......,XX------
X..,.....,............,,X-X..,,...........,,,...,,,,,,,,,,,,,.E.....,..,.,:..X-----XXXXXXXXXXX--------
X..,.....,............,,X-X.E,,...........,,,...,,,,,,,,,,,,,......,...,.,...X-XXXXXXXXXXX------------
X..,.....,............,,.X..AXA...........,,,...,,,,,,,,,,,,,......X...,.,...X-XtttttttttX------------
X..,.....,............,,....XXXXXX,,,,,,XXXXXX:XXXXXXXXXXXXXXX,,,XXX...,..,..X-X........tX------------
X..,.....,.............,,,,,X----X,,..,,X----XXX-------------X...XA.....,.,..X-X........tX------------
X..,.....,..................X----X..,,..XHXXXXXXXXXXXXXXXXXHXX...X.E....,..,.X-XttEttEtttX------------
X..,.....,..................XXX--X.,.,,.X.........A.........XX...X.......,.,.X-X.........X------------
X..,.....,...............:.....XXX,....,X..............E....XX.,,X.......,.,.X-X.........X------------
X..,.....,.....................HXX.....HX..:................XX,..X....:..,.,.X-XE.E.E.E.EX------------
X..,.....,......................,,.....H,...............E...,,...X........,.,X-X.........X------------
X..,.....,......................,,.....H,.........,.........,,...X........,.,X-X.E.E.E.E.X------------
X..,.....,......................,,......,.......,,.,,.......,,...X........,.,X-X.........X------------
X..,.....,......................,,.....H,.....,:..:,.,......,,...X........E.,X-X.E.E.E.E.X------------
X..,.....,......................XX......X.....,.,,.,,,......XX,,.X........,.,X-X.........X------------
X..,.....,......................XX,,..,,X....,..,..,,.,.:...XX,,,X......E.,.,X-XE.E.E.E.EX------------
X..,.....,......................XX..,,..X....,.:..H.:,,.....XX,,,X........,.,X-XXXXXXXXXXX------------
X..,.....,......................XX.,.,,.X...E,.,....,,,.....XX,,,X........,W,X------------------------
X..,.....,......................XX,....,X.....,.,,,,,,......XX.,,XX,,X++XXXXXX------------------------
X..,.....,......................XX......X.....,,..:,:,......XX,..XX..X--------------------------------
X..,.....,......................,,......,.......,,.,,..A....,,.E.XX..X--------------------------------
X..,.....,......:...............,,......,.........,.........,,...XX..X--------------------------------
X..,.....,......................,,......,...................,,...XX..X--------------------------------
X..,.....,......................,,......,...................,,...XX..X--------------------------------
X..,.....,......................XX......X...................XX,,.XX..X--------------------------------
X..,.....,......................XX,,..,,X....E.....:........XX,,,XX..X--------------------------------
X..,.....,....................,,XX..,,..X...................XX,,,XX..X--------------------------------
X..,.....,...................,,,XX.,.,,.X...................XX,,,XX..X--------------------------------
X..,.....,...................,,,++,....,X...................XX.,,XX..X--------------------------------
X..,.....,...................,,,XX.....HX...................XX,..XX..X--------------------------------
X..,.....,...................,,,XX......,........E....E.....,,...XX..X--------------------------------
X..,.....,....................,,XX.....H,...................,,E..XX..X--------------------------------
X..,.....,..................:...XX.....H,...................,,...XX..X--------------------------------
X..,.....,......................XX.....H,...................,,...XX..X--------------------------------
X..,.....,.....................HXX......X....:..............XX,,.XX..X--------------------------------
X..,.....,,,,,,,,,,,,,XXXXXXXXXXXX.....,X...................XX,,,XX..X--------------------------------
X..,..................XXXXXXXXXXXX,..,,.X..............E....XX,,,XX,,X--------------------------------
X..,.:...............+....,,,...++.,,,..X...................XX,,,XX..X--------------------------------
X..,................XXXXXXXXXXXXXX,...,,X...................XX.,,XX.EX--------------------------------
X..,,,,,,,,,,,,,,,,XXXXXXXXXX----X......X........E..........XX,..XX..X--------------------------------
XXXXXXXXXXXXXXXXXXX-XE.E.Et.X----X......,...................,,...XX..X--------------------------------
--------------------X.....ttX----X......,...................,,...XX..X--------------------------------
--------------------X.......X----X.E....,...................,,...XX..X--------------------------------
--------------------XE..E..EX----X....E.,.................:.,,...XX.EX--------------------------------
--------------------X.......X----X.....,X...................XX,,.XX..X--------------------------------
--------------------XttE.E.EX----X...,,.XH,.................XX,,,XX..X--------------------------------
--------------------XXXXXXXXX----X.,,...XXXXXX,,,......A....XX,,,XX..X--------------------------------
--------------------------XX-----X,.....XXXXXX,,,,..........XX,,,XX..X--------------------------------
-------XXXXXXXXXBBBXXXXXXXXXXXXXX,......XXK,.....,,.........XX.,,XX..X--------------------------------
------H...,...............,...,L.,......XX.,.,,,...,..:.....XX,..XX..X--------------------------------
-----X....,.....E.T.......,...,L.,......XX.,.,.,...,........,,...XX..X--------------------------------
-----X....,...............,...,L.,......XX.,.,H,...X......E.,,...XXE.X--------------------------------
-----X....,......BB.BB.BB.,...XXXX....E.XX.,.,.,.,,X........,,...XX..X--------------------------------
-----B....,...BB.,,,,XXX,,,,,,X--XE.....XX.,.,,,.,.,..E.....,,...XX..X--------------------------------
-----X....,..B.,,.,,.XXX.....HX--X......XX.,E....,.,.......AXX,,,XX..X--------------------------------
-----X....,.B,,...,,..........X--X......XX,,,,...,,XX,,,,,,XXX...,,..X--------------------------------
-----X....,B,.....,,.E........XX-X......XX,,,,,,,,,XX,,,,,,XXX...,,..X--------------------------------
-----X....XX......,,..........,.XX......,,,,,,.....,,,,....,,,E..,,..X--------------------------------
-----X...BXX......,,..........,.XX......,,,,,,.....,,,,.....,,...XX.:X--------------------------------
-----X.E.B,......,..,.........,.XX......,,,,,,.....,,,,.....XX...XXXXX--------------------------------
-----X...B,......,K.,.........XX-X......XX,,,,,,,,,XXXXXXXXXXX...X------------------------------------
-----X....,......,..,.........X--X......XX..E....:.X---------X...X------------------------------------
-----B....,.......,,....E.....X---XX:,XX-A.........X-XXXXXXXXX...X------------------------------------
-----X..T.,.................XXXXXX-XXXX--X,,,,,,,,,X-XE..E.,,,...X------------------------------------
-----X....,................,.X...X-------X.....,.,.X-X.....,.,...X------------------------------------
-----X....,...............,.,E...X-------XXXXXXX+XXX-X.E...,,,...X------------------------------------
-----X....,...E..........,.E....HX-------------XEX---X...E.,.,...X------------------------------------
-----X..E.,..............,,.....HX-XXXXX-------X,X---X.....A.,...X------------------------------------
-----X....,.............,,E.....HX-XH.HX-------X,X---XAA,H,,.,...X------------------------------------
-----X.:.B,............,.E......HX-X,,,X-------X,X---X.......,...X------------------------------------
-----X...BXX..........,..........X-X,,,XXXXXXXXX,XXXXX,,,,,,,,...X------------------------------------
-----X...BXX.........X...........XXX......+..E,..................X------------------------------------
-----X....BB,B,,,,,,XH...........,.,......+...,..................X------------------------------------
-----X.........,....XX...........,.,......+...,..................X------------------------------------
-----XB........,....L,...........,.,...E..+...,..................X------------------------------------
------XB.....E.,....L,...........XXX......+...,.................:X------------------------------------
-------XXXXXXXXXXXXXXXXXXXXXXXXXXX-XXXXXXXXXXXXXXXXXXXXXXXXXXXXXXX------------------------------------
